avorta	a'vort'a
avortaj	a'vort'a'j
avorto	a'vort'o
avortoj	a'vort'o'j
avortojn	a'vort'o'j'n
avorton	a'vort'o'n
abako	abak'o
abakon	abak'o'n
abandonas	abandon'as
abandoni	abandon'i
abandonis	abandon'is
abandonita	abandon'it'a
abandonitaj	abandon'it'a'j
abaso	abas'o
abasida	abas'id'a
abasidoj	abas'id'o'j
abato	abat'o
abatoj	abat'o'j
abaton	abat'o'n
abateja	abat'ej'a
abatejo	abat'ej'o
abatejoj	abat'ej'o'j
abatejon	abat'ej'o'n
abatino	abat'in'o
abatinoj	abat'in'o'j
abatinujo	abat'in'uj'o
abdiki	abdik'i
abdikis	abdik'is
abdiko	abdik'o
abdikon	abdik'o'n
abdomena	abdomen'a
abdomenaj	abdomen'a'j
abdomenan	abdomen'a'n
abdomeno	abdomen'o
abdomenon	abdomen'o'n
abela	abel'a
abelan	abel'a'n
abelo	abel'o
abeloj	abel'o'j
abelojn	abel'o'j'n
abelon	abel'o'n
abelbredado	abel'bred'ad'o
abelbredistoj	abel'bred'ist'o'j
abelmanĝuloj	abel'manĝ'ul'o'j
abelreĝino	abel'reĝ'in'o
abelujo	abel'uj'o
abelujoj	abel'uj'o'j
abelujon	abel'uj'o'n
abelardo	abelard'o
aberacio	aberaci'o
aberacioj	aberaci'o'j
abia	abi'a
abio	abi'o
abioj	abi'o'j
abiojn	abi'o'j'n
abion	abi'o'n
abidozo	abidoz'o
abisma	abism'a
abismo	abism'o
abismoj	abism'o'j
abismojn	abism'o'j'n
abismon	abism'o'n
abituro	abitur'o
abiturienta	abiturient'a
abiturientaj	abiturient'a'j
abiturientan	abiturient'a'n
abiturientoj	abiturient'o'j
ablacio	ablaci'o
ablativo	ablativ'o
abnegacio	abnegaci'o
aboco	aboc'o
abocon	aboc'o'n
abocolibro	aboc'o'libr'o
aboli	abol'i
abolis	abol'is
abolo	abol'o
abolon	abol'o'n
abolita	abol'it'a
abolicii	abolici'i
aboliciis	abolici'is
abolicio	abolici'o
abolicion	abolici'o'n
aboliciado	abolici'ad'o
aboliciante	abolici'ant'e
aboliciita	abolici'it'a
aboliciitaj	abolici'it'a'j
abomena	abomen'a
abomenaj	abomen'a'j
abomenan	abomen'a'n
abomenas	abomen'as
abomene	abomen'e
abomeni	abomen'i
abomenis	abomen'is
abomeno	abomen'o
abomenon	abomen'o'n
abomenaĵo	abomen'aĵ'o
abomenaĵoj	abomen'aĵ'o'j
abomenaĵojn	abomen'aĵ'o'j'n
abomeninda	abomen'ind'a
abomenindaj	abomen'ind'a'j
abomenindajn	abomen'ind'a'j'n
abomenindan	abomen'ind'a'n
abomeninde	abomen'ind'e
abomenindaĵo	abomen'ind'aĵ'o
abonas	abon'as
aboni	abon'i
abonis	abon'is
abono	abon'o
abonoj	abon'o'j
abonojn	abon'o'j'n
abonon	abon'o'n
abonu	abon'u
abonado	abon'ad'o
abonanto	abon'ant'o
abonantoj	abon'ant'o'j
abonantojn	abon'ant'o'j'n
abonantaro	abon'ant'ar'o
abonantaron	abon'ant'ar'o'n
abonhelpa	abon'help'a
abonintoj	abon'int'o'j
aborigenoj	aborigen'o'j
abortas	abort'as
aborti	abort'i
abortis	abort'is
aborto	abort'o
abortoj	abort'o'j
abortojn	abort'o'j'n
aborton	abort'o'n
abortigo	abort'ig'o
abortigon	abort'ig'o'n
abrikoto	abrikot'o
abrikotoj	abrikot'o'j
abrikotojn	abrikot'o'j'n
abrikotujoj	abrikot'uj'o'j
abrupta	abrupt'a
abruptaj	abrupt'a'j
abruptajn	abrupt'a'j'n
abruptan	abrupt'a'n
abrupte	abrupt'e
abruptis	abrupt'is
absceso	absces'o
abscesoj	absces'o'j
absciso	abscis'o
absido	absid'o
absidoj	absid'o'j
absidon	absid'o'n
absoluta	absolut'a
absolutaj	absolut'a'j
absolutajn	absolut'a'j'n
absolutan	absolut'a'n
absolute	absolut'e
absoluto	absolut'o
absoluton	absolut'o'n
absoluteco	absolut'ec'o
absolutismo	absolut'ism'o
absolutismon	absolut'ism'o'n
absolvas	absolv'as
absolvi	absolv'i
absolvis	absolv'is
absolvo	absolv'o
absolvon	absolv'o'n
absolvita	absolv'it'a
absorba	absorb'a
absorbas	absorb'as
absorbi	absorb'i
absorbis	absorb'is
absorbo	absorb'o
absorbos	absorb'os
absorbus	absorb'us
absorbado	absorb'ad'o
absorbante	absorb'ant'e
absorbiĝas	absorb'iĝ'as
absorbiĝis	absorb'iĝ'is
absorbiĝo	absorb'iĝ'o
absorbilo	absorb'il'o
absorbiloj	absorb'il'o'j
absorbita	absorb'it'a
absorbitaj	absorb'it'a'j
absorbite	absorb'it'e
abstinas	abstin'as
abstini	abstin'i
abstinis	abstin'is
abstino	abstin'o
abstinado	abstin'ad'o
abstinadon	abstin'ad'o'n
abstinulo	abstin'ul'o
abstrakta	abstrakt'a
abstraktaj	abstrakt'a'j
abstraktajn	abstrakt'a'j'n
abstraktan	abstrakt'a'n
abstrakte	abstrakt'e
abstrakti	abstrakt'i
abstraktado	abstrakt'ad'o
abstraktadoj	abstrakt'ad'o'j
abstraktadojn	abstrakt'ad'o'j'n
abstraktadon	abstrakt'ad'o'n
abstraktaĵo	abstrakt'aĵ'o
abstraktaĵoj	abstrakt'aĵ'o'j
abstraktaĵojn	abstrakt'aĵ'o'j'n
abstrakteco	abstrakt'ec'o
absurda	absurd'a
absurdaj	absurd'a'j
absurdajn	absurd'a'j'n
absurdan	absurd'a'n
absurde	absurd'e
absurdo	absurd'o
absurdon	absurd'o'n
absurdaĵo	absurd'aĵ'o
absurdaĵoj	absurd'aĵ'o'j
absurdaĵojn	absurd'aĵ'o'j'n
absurdaĵon	absurd'aĵ'o'n
absurdeco	absurd'ec'o
absurdecon	absurd'ec'o'n
abunda	abund'a
abundaj	abund'a'j
abundajn	abund'a'j'n
abundan	abund'a'n
abundas	abund'as
abunde	abund'e
abundis	abund'is
abundo	abund'o
abundon	abund'o'n
abundos	abund'os
abundeco	abund'ec'o
abundecon	abund'ec'o'n
abundega	abund'eg'a
abundegaj	abund'eg'a'j
abundegajn	abund'eg'a'j'n
abundegan	abund'eg'a'n
abundegas	abund'eg'as
abundege	abund'eg'e
abundego	abund'eg'o
abutmentoj	abutment'o'j
acera	acer'a
acero	acer'o
aceroj	acer'o'j
acerba	acerb'a
acerban	acerb'a'n
acetacido	acet'acid'o
acetaldehido	acet'aldehid'o
acetata	acet'at'a
acetato	acet'at'o
acetaton	acet'at'o'n
acetono	aceton'o
acida	acid'a
acidaj	acid'a'j
acidajn	acid'a'j'n
acidan	acid'a'n
acide	acid'e
acido	acid'o
acidoj	acid'o'j
acidojn	acid'o'j'n
acidon	acid'o'n
acideco	acid'ec'o
acidecon	acid'ec'o'n
acidigita	acid'ig'it'a
acidiĝo	acid'iĝ'o
aĉa	aĉ'a
aĉaj	aĉ'a'j
aĉajn	aĉ'a'j'n
aĉan	aĉ'a'n
aĉas	aĉ'as
aĉe	aĉ'e
aĉaĵo	aĉ'aĵ'o
aĉaĵojn	aĉ'aĵ'o'j'n
aĉaĵon	aĉ'aĵ'o'n
aĉega	aĉ'eg'a
aĉulo	aĉ'ul'o
aĉuloj	aĉ'ul'o'j
aĉeta	aĉet'a
aĉetas	aĉet'as
aĉeti	aĉet'i
aĉetis	aĉet'is
aĉeto	aĉet'o
aĉetoj	aĉet'o'j
aĉetojn	aĉet'o'j'n
aĉeton	aĉet'o'n
aĉetos	aĉet'os
aĉetu	aĉet'u
aĉetus	aĉet'us
aĉetadas	aĉet'ad'as
aĉetadi	aĉet'ad'i
aĉetadis	aĉet'ad'is
aĉetado	aĉet'ad'o
aĉetadon	aĉet'ad'o'n
aĉetaĵojn	aĉet'aĵ'o'j'n
aĉetanta	aĉet'ant'a
aĉetantaj	aĉet'ant'a'j
aĉetante	aĉet'ant'e
aĉetanto	aĉet'ant'o
aĉetantoj	aĉet'ant'o'j
aĉetantojn	aĉet'ant'o'j'n
aĉetanton	aĉet'ant'o'n
aĉetata	aĉet'at'a
aĉetataj	aĉet'at'a'j
aĉetcentro	aĉet'centr'o
aĉetebla	aĉet'ebl'a
aĉeteblaj	aĉet'ebl'a'j
aĉeteblas	aĉet'ebl'as
aĉetinta	aĉet'int'a
aĉetinte	aĉet'int'e
aĉetintus	aĉet'int'us
aĉetita	aĉet'it'a
aĉetitaj	aĉet'it'a'j
aĉetitajn	aĉet'it'a'j'n
aĉetitan	aĉet'it'a'n
aĉetite	aĉet'it'e
aĉetontoj	aĉet'ont'o'j
aĉetpovo	aĉet'pov'o
aĉetpovon	aĉet'pov'o'n
aĉetumi	aĉet'um'i
adama	adam'a
adamo	adam'o
adamon	adam'o'n
adapta	adapt'a
adaptaj	adapt'a'j
adaptajn	adapt'a'j'n
adaptan	adapt'a'n
adaptas	adapt'as
adapti	adapt'i
adaptis	adapt'is
adapto	adapt'o
adaptoj	adapt'o'j
adaptojn	adapt'o'j'n
adapton	adapt'o'n
adaptos	adapt'os
adaptu	adapt'u
adaptado	adapt'ad'o
adaptadon	adapt'ad'o'n
adaptaĵo	adapt'aĵ'o
adaptaĵoj	adapt'aĵ'o'j
adaptanta	adapt'ant'a
adaptante	adapt'ant'e
adaptata	adapt'at'a
adaptataj	adapt'at'a'j
adaptebla	adapt'ebl'a
adapteblaj	adapt'ebl'a'j
adaptigi	adapt'ig'i
adaptiĝas	adapt'iĝ'as
adaptiĝi	adapt'iĝ'i
adaptiĝis	adapt'iĝ'is
adaptiĝo	adapt'iĝ'o
adaptiĝoj	adapt'iĝ'o'j
adaptiĝojn	adapt'iĝ'o'j'n
adaptiĝon	adapt'iĝ'o'n
adaptiĝos	adapt'iĝ'os
adaptiĝu	adapt'iĝ'u
adaptiĝus	adapt'iĝ'us
adaptiĝado	adapt'iĝ'ad'o
adaptiĝema	adapt'iĝ'em'a
adaptiĝkapableco	adapt'iĝ'kapabl'ec'o
adaptilo	adapt'il'o
adaptiloj	adapt'il'o'j
adaptita	adapt'it'a
adaptitaj	adapt'it'a'j
adaptitajn	adapt'it'a'j'n
adaptitan	adapt'it'a'n
adaptite	adapt'it'e
adekvata	adekvat'a
adekvataj	adekvat'a'j
adekvatajn	adekvat'a'j'n
adekvatan	adekvat'a'n
adekvate	adekvat'e
adena	aden'a
adeno	aden'o
adepto	adept'o
adeptoj	adept'o'j
adeptojn	adept'o'j'n
adheras	adher'as
adheri	adher'i
adheris	adher'is
adhero	adher'o
adheron	adher'o'n
adherado	adher'ad'o
adherante	adher'ant'e
adiaŭ	adiaŭ
adiaŭa	adiaŭ'a
adiaŭan	adiaŭ'a'n
adiaŭas	adiaŭ'as
adiaŭe	adiaŭ'e
adiaui	adiaŭ'i
adiaŭi	adiaŭ'i
adiauis	adiaŭ'is
adiaŭis	adiaŭ'is
adiauo	adiaŭ'o
adiaŭo	adiaŭ'o
adiaŭoj	adiaŭ'o'j
adiaŭon	adiaŭ'o'n
adiaŭos	adiaŭ'os
adiaŭu	adiaŭ'u
adiaŭante	adiaŭ'ant'e
adiaŭinte	adiaŭ'int'e
adicias	adici'as
adicii	adici'i
adiciis	adici'is
adicio	adici'o
adicion	adici'o'n
adiciu	adici'u
adiciado	adici'ad'o
adjekto	adjekt'o
adjektiva	adjektiv'a
adjektivaj	adjektiv'a'j
adjektivan	adjektiv'a'n
adjektive	adjektiv'e
adjektivo	adjektiv'o
adjektivoj	adjektiv'o'j
adjektivojn	adjektiv'o'j'n
adjektivon	adjektiv'o'n
adjudikado	adjudik'ad'o
adjunkta	adjunkt'a
adjutanto	adjutant'o
administra	administr'a
administraj	administr'a'j
administrajn	administr'a'j'n
administran	administr'a'n
administras	administr'as
administre	administr'e
administri	administr'i
administris	administr'is
administro	administr'o
administron	administr'o'n
administros	administr'os
administru	administr'u
administrada	administr'ad'a
administrado	administr'ad'o
administradoj	administr'ad'o'j
administradon	administr'ad'o'n
administranta	administr'ant'a
administrante	administr'ant'e
administranto	administr'ant'o
administrantoj	administr'ant'o'j
administrantojn	administr'ant'o'j'n
administranton	administr'ant'o'n
administrantaro	administr'ant'ar'o
administrata	administr'at'a
administrataj	administr'at'a'j
administrejo	administr'ej'o
administrejoj	administr'ej'o'j
administristo	administr'ist'o
administristoj	administr'ist'o'j
administrita	administr'it'a
administritaj	administr'it'a'j
administritajn	administr'it'a'j'n
administritan	administr'it'a'n
administrokutimoj	administr'o'kutim'o'j
administracia	administraci'a
administraciaj	administraci'a'j
administraciajn	administraci'a'j'n
administracian	administraci'a'n
administracie	administraci'e
administracio	administraci'o
administracioj	administraci'o'j
administraciojn	administraci'o'j'n
administracion	administraci'o'n
admira	admir'a
admiras	admir'as
admire	admir'e
admiri	admir'i
admiris	admir'is
admiro	admir'o
admiron	admir'o'n
admiros	admir'os
admiru	admir'u
admirado	admir'ad'o
admirante	admir'ant'e
admiranto	admir'ant'o
admirantoj	admir'ant'o'j
admirantojn	admir'ant'o'j'n
admirantaron	admir'ant'ar'o'n
admirata	admir'at'a
admirataj	admir'at'a'j
admirinda	admir'ind'a
admirindaj	admir'ind'a'j
admirindajn	admir'ind'a'j'n
admirindan	admir'ind'a'n
admirinde	admir'ind'e
admirita	admir'it'a
admiritaj	admir'it'a'j
admiralo	admiral'o
admiraloj	admiral'o'j
admiraleco	admiral'ec'o
admona	admon'a
admonaj	admon'a'j
admonas	admon'as
admoni	admon'i
admonis	admon'is
admono	admon'o
admonoj	admon'o'j
admonojn	admon'o'j'n
admonon	admon'o'n
admonu	admon'u
admonante	admon'ant'e
adobe	adob'e
adobo	adob'o
adoboj	adob'o'j
adoleska	adolesk'a
adoleskaj	adolesk'a'j
adolesko	adolesk'o
adoleskanto	adolesk'ant'o
adoleskantoj	adolesk'ant'o'j
adoleskantojn	adolesk'ant'o'j'n
adoleskanteco	adolesk'ant'ec'o
adoleskantino	adolesk'ant'in'o
adoleskantinoj	adolesk'ant'in'o'j
adoleskeco	adolesk'ec'o
adoleskojaroj	adolesk'ojar'o'j
adoleskulo	adolesk'ul'o
adoleskuloj	adolesk'ul'o'j
adolfo	adolf'o
adolta	adolt'a
adoltaj	adolt'a'j
adolto	adolt'o
adoltoj	adolt'o'j
adopta	adopt'a
adoptaj	adopt'a'j
adoptas	adopt'as
adopte	adopt'e
adopti	adopt'i
adoptis	adopt'is
adopto	adopt'o
adoptoj	adopt'o'j
adopton	adopt'o'n
adoptos	adopt'os
adoptu	adopt'u
adoptus	adopt'us
adoptado	adopt'ad'o
adoptanta	adopt'ant'a
adoptante	adopt'ant'e
adoptanto	adopt'ant'o
adoptantoj	adopt'ant'o'j
adoptita	adopt'it'a
adoptitaj	adopt'it'a'j
adoptitajn	adopt'it'a'j'n
adoptitan	adopt'it'a'n
adoptite	adopt'it'e
adoras	ador'as
adori	ador'i
adoris	ador'is
adoro	ador'o
adoron	ador'o'n
adoros	ador'os
adoru	ador'u
adorado	ador'ad'o
adoradon	ador'ad'o'n
adorante	ador'ant'e
adoranto	ador'ant'o
adorantoj	ador'ant'o'j
adorantojn	ador'ant'o'j'n
adoranton	ador'ant'o'n
adorata	ador'at'a
adorataj	ador'at'a'j
adorejo	ador'ej'o
adorinda	ador'ind'a
adorita	ador'it'a
adoritaj	ador'it'a'j
adrenalino	adrenalin'o
adresas	adres'as
adresi	adres'i
adresis	adres'is
adreso	adres'o
adresoj	adres'o'j
adresojn	adres'o'j'n
adreson	adres'o'n
adresu	adres'u
adresado	adres'ad'o
adresaro	adres'ar'o
adresaroj	adres'ar'o'j
adresarojn	adres'ar'o'j'n
adresaron	adres'ar'o'n
adresato	adres'at'o
adresatoj	adres'at'o'j
adresebla	adres'ebl'a
adresiĝas	adres'iĝ'as
adresita	adres'it'a
adresitaj	adres'it'a'j
adresitan	adres'it'a'n
adresito	adres'it'o
adresspaco	adres'spac'o
adsorbi	adsorb'i
adsorbado	adsorb'ad'o
adsorbitaj	adsorb'it'a'j
adstringa	adstring'a
adultis	adult'is
adulto	adult'o
adultoj	adult'o'j
adultado	adult'ad'o
adventa	advent'a
advento	advent'o
adventistoj	advent'ist'o'j
adverba	adverb'a
adverbaj	adverb'a'j
adverban	adverb'a'n
adverbo	adverb'o
adverboj	adverb'o'j
adverbojn	adverb'o'j'n
adverbon	adverb'o'n
adversaj	advers'a'j
advokata	advokat'a
advokato	advokat'o
advokatoj	advokat'o'j
advokatojn	advokat'o'j'n
advokaton	advokat'o'n
advokatejo	advokat'ej'o
advokatfirmaoj	advokat'firma'o'j
advokatino	advokat'in'o
aera	aer'a
aeraj	aer'a'j
aerajn	aer'a'j'n
aeran	aer'a'n
aere	aer'e
aeren	aer'e'n
aero	aer'o
aeroj	aer'o'j
aeron	aer'o'n
aeramaso	aer'amas'o
aeramasoj	aer'amas'o'j
aerarmea	aer'arme'a
aerarmeo	aer'arme'o
aerarmeoj	aer'arme'o'j
aerarmeon	aer'arme'o'n
afrika	afrik'a
afrikaj	afrik'a'j
afrikajn	afrik'a'j'n
afrikan	afrik'a'n
afriko	afrik'o
afrikon	afrik'o'n
afrikano	afrik'an'o
afrikanoj	afrik'an'o'j
afrikanojn	afrik'an'o'j'n
afrikanon	afrik'an'o'n
afrikazia	afrik'azi'a
afrikdevena	afrik'de'ven'a
afrikdevenaj	afrik'de'ven'a'j
afrikobrazila	afrik'o'brazil'a
afrikobrazilaj	afrik'o'brazil'a'j
afrikusona	afrik'uson'a
afrikusonanoj	afrik'uson'an'o'j
afrikansa	afrikans'a
afrikansan	afrikans'a'n
afrikato	afrikat'o
afrikatoj	afrikat'o'j
afrodita	afrodit'a
afrodito	afrodit'o
afroditon	afrodit'o'n
aga	ag'a
agaj	ag'a'j
agan	ag'a'n
agas	ag'as
age	ag'e
agi	ag'i
agis	ag'is
ago	ag'o
agoj	ag'o'j
agojn	ag'o'j'n
agon	ag'o'n
agos	ag'os
agu	ag'u
agus	ag'us
agada	ag'ad'a
agadan	ag'ad'a'n
agadas	ag'ad'as
agadi	ag'ad'i
agadis	ag'ad'is
agado	ag'ad'o
agadoj	ag'ad'o'j
agadojn	ag'ad'o'j'n
agadon	ag'ad'o'n
agados	ag'ad'os
agadu	ag'ad'u
agadkampo	ag'ad'kamp'o
agadkampoj	ag'ad'kamp'o'j
agadkampojn	ag'ad'kamp'o'j'n
agadkampon	ag'ad'kamp'o'n
agadmaniero	ag'ad'manier'o
agadplano	ag'ad'plan'o
agadplanon	ag'ad'plan'o'n
agadprogramo	ag'ad'program'o
agadraporton	ag'ad'raport'o'n
aganta	ag'ant'a
agantaj	ag'ant'a'j
agantan	ag'ant'a'n
agante	ag'ant'e
aganto	ag'ant'o
agantoj	ag'ant'o'j
agantojn	ag'ant'o'j'n
aganton	ag'ant'o'n
agema	ag'em'a
agemaj	ag'em'a'j
ageme	ag'em'e
agemo	ag'em'o
agemon	ag'em'o'n
aginta	ag'int'a
agintus	ag'int'us
agmaniero	ag'manier'o
agmanieroj	ag'manier'o'j
agmanieron	ag'manier'o'n
agaca	agac'a
agacas	agac'as
agaci	agac'i
agacis	agac'is
agaciĝema	agac'iĝ'em'a
agacitaj	agac'it'a'j
agapo	agap'o
agaragaro	agaragar'o
agata	agat'a
agato	agat'o
agavo	agav'o
agendo	agend'o
agendon	agend'o'n
agento	agent'o
agentoj	agent'o'j
agentojn	agent'o'j'n
agenton	agent'o'n
agentbazita	agent'baz'it'a
agentbazitaj	agent'baz'it'a'j
agentejo	agent'ej'o
agentejoj	agent'ej'o'j
agentejojn	agent'ej'o'j'n
agentejon	agent'ej'o'n
agita	agit'a
agitaj	agit'a'j
agitas	agit'as
agiti	agit'i
agitis	agit'is
agitado	agit'ad'o
agitadon	agit'ad'o'n
agitanto	agit'ant'o
agitantoj	agit'ant'o'j
agitiĝas	agit'iĝ'as
agitiĝis	agit'iĝ'is
agitiĝo	agit'iĝ'o
agitiĝon	agit'iĝ'o'n
agitita	agit'it'a
agititaj	agit'it'a'j
agla	agl'a
aglaj	agl'a'j
aglo	agl'o
agloj	agl'o'j
aglojn	agl'o'j'n
aglon	agl'o'n
aglomera	aglomer'a
aglomerado	aglomer'ad'o
aglomeraĵo	aglomer'aĵ'o
aglomeraĵoj	aglomer'aĵ'o'j
aglomerita	aglomer'it'a
aglomeritaj	aglomer'it'a'j
aglutina	aglutin'a
aglutinaj	aglutin'a'j
agnoskas	agnosk'as
agnoski	agnosk'i
agnoskis	agnosk'is
agnosko	agnosk'o
agnoskoj	agnosk'o'j
agnoskojn	agnosk'o'j'n
agnoskon	agnosk'o'n
agnoskos	agnosk'os
agnosku	agnosk'u
agnoskus	agnosk'us
agnoskado	agnosk'ad'o
agnoskante	agnosk'ant'e
agnoskata	agnosk'at'a
agnoskataj	agnosk'at'a'j
agnoskigi	agnosk'ig'i
agnoskita	agnosk'it'a
agnoskitaj	agnosk'it'a'j
agnoskitajn	agnosk'it'a'j'n
agnoskitan	agnosk'it'a'n
agnoskite	agnosk'it'e
agnostika	agnostik'a
agnostikismo	agnostik'ism'o
agnozio	agnozi'o
agonias	agoni'as
agoniis	agoni'is
agonio	agoni'o
agonion	agoni'o'n
agonianta	agoni'ant'a
agoro	agor'o
agordas	agord'as
agordi	agord'i
agordis	agord'is
agordo	agord'o
agordoj	agord'o'j
agordojn	agord'o'j'n
agordon	agord'o'n
agordu	agord'u
agordado	agord'ad'o
agordadoj	agord'ad'o'j
agordadon	agord'ad'o'n
agordanta	agord'ant'a
agordante	agord'ant'e
agordata	agord'at'a
agordataj	agord'at'a'j
agordebla	agord'ebl'a
agordeblaj	agord'ebl'a'j
agordita	agord'it'a
agorditaj	agord'it'a'j
agra	agr'a
agro	agr'o
agroj	agr'o'j
agrojn	agr'o'j'n
agron	agr'o'n
agrego	agr'eg'o
agregon	agr'eg'o'n
agregado	agr'eg'ad'o
agregaĵo	agr'eg'aĵ'o
agregaĵoj	agr'eg'aĵ'o'j
agregaĵojn	agr'eg'aĵ'o'j'n
agregaĵon	agr'eg'aĵ'o'n
agrabla	agrabl'a
agrablaj	agrabl'a'j
agrablajn	agrabl'a'j'n
agrablan	agrabl'a'n
agrablas	agrabl'as
agrable	agrabl'e
agrablis	agrabl'is
agrablo	agrabl'o
agrablon	agrabl'o'n
agrablaĵo	agrabl'aĵ'o
agrablaĵoj	agrabl'aĵ'o'j
agrablaĵojn	agrabl'aĵ'o'j'n
agrableco	agrabl'ec'o
agrablecon	agrabl'ec'o'n
agrablega	agrabl'eg'a
agrabligi	agrabl'ig'i
agrafo	agraf'o
agrafoj	agraf'o'j
agregas	agreg'as
agregi	agreg'i
agresa	agres'a
agresaj	agres'a'j
agresis	agres'is
agreso	agres'o
agresoj	agres'o'j
agreson	agres'o'n
agresanto	agres'ant'o
agresantoj	agres'ant'o'j
agresema	agres'em'a
agresemaj	agres'em'a'j
agresemajn	agres'em'a'j'n
agreseman	agres'em'a'n
agreseme	agres'em'e
agresemo	agres'em'o
agresemon	agres'em'o'n
agresemulo	agres'em'ul'o
agresita	agres'it'a
agrikultura	agrikultur'a
agrikulturaj	agrikultur'a'j
agrikulturajn	agrikultur'a'j'n
agrikulturan	agrikultur'a'n
agrikulture	agrikultur'e
agrikulturo	agrikultur'o
agrikulturoj	agrikultur'o'j
agrikulturon	agrikultur'o'n
agrikulturado	agrikultur'ad'o
agrikulturaĵoj	agrikultur'aĵ'o'j
agrikulturisto	agrikultur'ist'o
agrikulturistoj	agrikultur'ist'o'j
agronomo	agronom'o
agronomiaj	agronom'i'a'j
agronomio	agronom'i'o
agha	aĝ'a
aĝa	aĝ'a
aĝaj	aĝ'a'j
aĝajn	aĝ'a'j'n
aĝan	aĝ'a'n
aĝas	aĝ'as
aĝe	aĝ'e
aĝis	aĝ'is
agho	aĝ'o
aĝo	aĝ'o
aĝoj	aĝ'o'j
aĝojn	aĝ'o'j'n
aĝon	aĝ'o'n
aĝos	aĝ'os
aha	aha
ahura	ahura
aĥila	aĥil'a
aĥilo	aĥil'o
aĥilon	aĥil'o'n
aidosa	aidos'a
aidosaj	aidos'a'j
aidoso	aidos'o
aidoson	aidos'o'n
akacia	akaci'a
akacio	akaci'o
akacioj	akaci'o'j
akada	akad'a
akadaj	akad'a'j
akademia	akademi'a
akademiaj	akademi'a'j
akademiajn	akademi'a'j'n
akademian	akademi'a'n
akademie	akademi'e
akademio	akademi'o
akademioj	akademi'o'j
akademion	akademi'o'n
akademiano	akademi'an'o
akademianoj	akademi'an'o'j
akademiulo	akademi'ul'o
akademiuloj	akademi'ul'o'j
akademiulojn	akademi'ul'o'j'n
akademiulon	akademi'ul'o'n
akademiularo	akademi'ul'ar'o
akaparas	akapar'as
akapari	akapar'i
akaparis	akapar'is
akaparo	akapar'o
akaroj	akar'o'j
akcela	akcel'a
akcelan	akcel'a'n
akcelas	akcel'as
akceli	akcel'i
akcelis	akcel'is
akcelo	akcel'o
akceloj	akcel'o'j
akcelojn	akcel'o'j'n
akcelon	akcel'o'n
akcelos	akcel'os
akcelu	akcel'u
akcelus	akcel'us
akcelado	akcel'ad'o
akceladoj	akcel'ad'o'j
akceladojn	akcel'ad'o'j'n
akceladon	akcel'ad'o'n
akcelanta	akcel'ant'a
akcelante	akcel'ant'e
akcelata	akcel'at'a
akceliĝas	akcel'iĝ'as
akcelilo	akcel'il'o
akceliloj	akcel'il'o'j
akcelilojn	akcel'il'o'j'n
akcelilon	akcel'il'o'n
akcelita	akcel'it'a
akcelitaj	akcel'it'a'j
akcelitan	akcel'it'a'n
akcenta	akcent'a
akcentaj	akcent'a'j
akcentas	akcent'as
akcente	akcent'e
akcenti	akcent'i
akcentis	akcent'is
akcento	akcent'o
akcentoj	akcent'o'j
akcentojn	akcent'o'j'n
akcenton	akcent'o'n
akcentado	akcent'ad'o
akcentadon	akcent'ad'o'n
akcentante	akcent'ant'e
akcentata	akcent'at'a
akcentita	akcent'it'a
akcentitaj	akcent'it'a'j
akcentsilabo	akcent'silab'o
akcentsilaboj	akcent'silab'o'j
akcepta	akcept'a
akceptas	akcept'as
akcepti	akcept'i
akceptis	akcept'is
akcepto	akcept'o
akceptoj	akcept'o'j
akcepton	akcept'o'n
akceptos	akcept'os
akceptu	akcept'u
akceptus	akcept'us
akceptadis	akcept'ad'is
akceptado	akcept'ad'o
akceptadon	akcept'ad'o'n
akceptanta	akcept'ant'a
akceptantaj	akcept'ant'a'j
akceptante	akcept'ant'e
akceptanto	akcept'ant'o
akceptantoj	akcept'ant'o'j
akceptata	akcept'at'a
akceptataj	akcept'at'a'j
akceptebla	akcept'ebl'a
akcepteblaj	akcept'ebl'a'j
akcepteblajn	akcept'ebl'a'j'n
akcepteblan	akcept'ebl'a'n
akcepteblas	akcept'ebl'as
akcepteble	akcept'ebl'e
akcepteblo	akcept'ebl'o
akcepteblon	akcept'ebl'o'n
akceptebleco	akcept'ebl'ec'o
akceptejo	akcept'ej'o
akceptejon	akcept'ej'o'n
akceptema	akcept'em'a
akceptemaj	akcept'em'a'j
akcepteman	akcept'em'a'n
akceptemo	akcept'em'o
akceptigi	akcept'ig'i
akceptiĝas	akcept'iĝ'as
akceptiĝi	akcept'iĝ'i
akceptiĝis	akcept'iĝ'is
akceptinda	akcept'ind'a
akceptinta	akcept'int'a
akceptinte	akcept'int'e
akceptisto	akcept'ist'o
akceptita	akcept'it'a
akceptitaj	akcept'it'a'j
akceptitajn	akcept'it'a'j'n
akceptitan	akcept'it'a'n
akceptite	akcept'it'e
akceptota	akcept'ot'a
akcesora	akcesor'a
akcesoraj	akcesor'a'j
akcesorajn	akcesor'a'j'n
akcesoran	akcesor'a'n
akcesoraĵo	akcesor'aĵ'o
akcesoraĵoj	akcesor'aĵ'o'j
akcesoraĵojn	akcesor'aĵ'o'j'n
akcia	akci'a
akciaj	akci'a'j
akcian	akci'a'n
akcio	akci'o
akcioj	akci'o'j
akciojn	akci'o'j'n
akcion	akci'o'n
akciaro	akci'ar'o
akciofirmaoj	akci'o'firma'o'j
akcioinformo	akci'o'inform'o
akciulo	akci'ul'o
akciuloj	akci'ul'o'j
akciulojn	akci'ul'o'j'n
akcidenta	akcident'a
akcidente	akcident'e
akcidento	akcident'o
akcidentoj	akcident'o'j
akcidentojn	akcident'o'j'n
akcidenton	akcident'o'n
akcipitro	akcipitr'o
akcipitroj	akcipitr'o'j
akcipitredoj	akcipitr'ed'o'j
akcizo	akciz'o
akĉento	akĉent'o
akĉentoj	akĉent'o'j
akĉentojn	akĉent'o'j'n
akĉenton	akĉent'o'n
akean	ake'a'n
akeo	ake'o
akeno	aken'o
akira	akir'a
akiras	akir'as
akiri	akir'i
akiris	akir'is
akiro	akir'o
akiroj	akir'o'j
akirojn	akir'o'j'n
akiron	akir'o'n
akiros	akir'os
akiru	akir'u
akirus	akir'us
akirado	akir'ad'o
akiradon	akir'ad'o'n
akiraĵo	akir'aĵ'o
akiraĵon	akir'aĵ'o'n
akiranta	akir'ant'a
akirantaj	akir'ant'a'j
akirante	akir'ant'e
akiranto	akir'ant'o
akirebla	akir'ebl'a
akireblaj	akir'ebl'a'j
akireblas	akir'ebl'as
akiriĝas	akir'iĝ'as
akirinta	akir'int'a
akirintaj	akir'int'a'j
akirinte	akir'int'e
akirita	akir'it'a
akiritaj	akir'it'a'j
akiritajn	akir'it'a'j'n
akiritan	akir'it'a'n
akirite	akir'it'e
aklamas	aklam'as
aklamis	aklam'is
aklamo	aklam'o
aklamado	aklam'ad'o
aklamita	aklam'it'a
aklamitaj	aklam'it'a'j
akno	akn'o
aknoj	akn'o'j
akolito	akolit'o
akolitoj	akolit'o'j
akomodas	akomod'as
akomodi	akomod'i
akomodo	akomod'o
akomodiĝas	akomod'iĝ'as
akomodiĝi	akomod'iĝ'i
akompana	akompan'a
akompanaj	akompan'a'j
akompanan	akompan'a'n
akompanas	akompan'as
akompane	akompan'e
akompani	akompan'i
akompanis	akompan'is
akompano	akompan'o
akompanoj	akompan'o'j
akompanon	akompan'o'n
akompanos	akompan'os
akompanu	akompan'u
akompanus	akompan'us
akompanadis	akompan'ad'is
akompanado	akompan'ad'o
akompananta	akompan'ant'a
akompanantaj	akompan'ant'a'j
akompanante	akompan'ant'e
akompananto	akompan'ant'o
akompanantoj	akompan'ant'o'j
akompanantojn	akompan'ant'o'j'n
akompananton	akompan'ant'o'n
akompanantaro	akompan'ant'ar'o
akompanantino	akompan'ant'in'o
akompanata	akompan'at'a
akompanataj	akompan'at'a'j
akompanate	akompan'at'e
akompanita	akompan'it'a
akompanitaj	akompan'it'a'j
akompanitajn	akompan'it'a'j'n
akompanite	akompan'it'e
akorda	akord'a
akordaj	akord'a'j
akordan	akord'a'n
akordas	akord'as
akorde	akord'e
akordi	akord'i
akordis	akord'is
akordo	akord'o
akordoj	akord'o'j
akordojn	akord'o'j'n
akordon	akord'o'n
akordigas	akord'ig'as
akordigi	akord'ig'i
akordigis	akord'ig'is
akordigo	akord'ig'o
akordigon	akord'ig'o'n
akordigado	akord'ig'ad'o
akordigebla	akord'ig'ebl'a
akordigeblaj	akord'ig'ebl'a'j
akordigita	akord'ig'it'a
akordigitaj	akord'ig'it'a'j
akordiĝas	akord'iĝ'as
akordiĝi	akord'iĝ'i
akordiĝis	akord'iĝ'is
akordiĝo	akord'iĝ'o
akordiĝos	akord'iĝ'os
akordiĝema	akord'iĝ'em'a
akordiono	akordion'o
akordionon	akordion'o'n
akra	akr'a
akraj	akr'a'j
akrajn	akr'a'j'n
akran	akr'a'n
akras	akr'as
akre	akr'e
akreco	akr'ec'o
akrecon	akr'ec'o'n
akrega	akr'eg'a
akregaj	akr'eg'a'j
akrigas	akr'ig'as
akrigi	akr'ig'i
akrigis	akr'ig'is
akrigo	akr'ig'o
akrigos	akr'ig'os
akrigita	akr'ig'it'a
akrigitaj	akr'ig'it'a'j
akrigitan	akr'ig'it'a'n
akriĝas	akr'iĝ'as
akriĝis	akr'iĝ'is
akreo	akre'o
akreoj	akre'o'j
akreditas	akredit'as
akreditis	akredit'is
akredito	akredit'o
akrediton	akredit'o'n
akreditaĵoj	akredit'aĵ'o'j
akreditaĵojn	akredit'aĵ'o'j'n
akreditita	akredit'it'a
akredititaj	akredit'it'a'j
akrido	akrid'o
akridoj	akrid'o'j
akridojn	akrid'o'j'n
akrobata	akrobat'a
akrobataj	akrobat'a'j
akrobatan	akrobat'a'n
akrobato	akrobat'o
akrobatoj	akrobat'o'j
akrobataĵo	akrobat'aĵ'o
akrobataĵoj	akrobat'aĵ'o'j
akrobataĵojn	akrobat'aĵ'o'j'n
akrobataĵon	akrobat'aĵ'o'n
akronimo	akronim'o
akronimoj	akronim'o'j
akropolo	akropol'o
akropolon	akropol'o'n
aksa	aks'a
aksaj	aks'a'j
aksajn	aks'a'j'n
aksan	aks'a'n
akse	aks'e
akso	aks'o
aksoj	aks'o'j
aksojn	aks'o'j'n
akson	aks'o'n
aksela	aksel'a
akselo	aksel'o
akseloj	aksel'o'j
aksioma	aksiom'a
aksiomo	aksiom'o
aksiomoj	aksiom'o'j
aksiomojn	aksiom'o'j'n
aksiomon	aksiom'o'n
aksono	akson'o
aksonoj	akson'o'j
akto	akt'o
aktoj	akt'o'j
aktojn	akt'o'j'n
akton	akt'o'n
aktisto	akt'ist'o
aktujo	akt'uj'o
aktiva	aktiv'a
aktivaj	aktiv'a'j
aktivajn	aktiv'a'j'n
aktivan	aktiv'a'n
aktivas	aktiv'as
aktive	aktiv'e
aktivi	aktiv'i
aktivis	aktiv'is
aktivo	aktiv'o
aktivoj	aktiv'o'j
aktivojn	aktiv'o'j'n
aktivos	aktiv'os
aktivadas	aktiv'ad'as
aktivadi	aktiv'ad'i
aktivadis	aktiv'ad'is
aktivado	aktiv'ad'o
aktivadoj	aktiv'ad'o'j
aktivadojn	aktiv'ad'o'j'n
aktivadon	aktiv'ad'o'n
aktivaĵo	aktiv'aĵ'o
aktivaĵoj	aktiv'aĵ'o'j
aktivaĵojn	aktiv'aĵ'o'j'n
aktivaĵon	aktiv'aĵ'o'n
aktiveco	aktiv'ec'o
aktivecoj	aktiv'ec'o'j
aktivecojn	aktiv'ec'o'j'n
aktivecon	aktiv'ec'o'n
aktiviga	aktiv'ig'a
aktivigas	aktiv'ig'as
aktivigi	aktiv'ig'i
aktivigis	aktiv'ig'is
aktivigo	aktiv'ig'o
aktivigon	aktiv'ig'o'n
aktivigu	aktiv'ig'u
aktivigante	aktiv'ig'ant'e
aktivigantoj	aktiv'ig'ant'o'j
aktivigita	aktiv'ig'it'a
aktivigitaj	aktiv'ig'it'a'j
aktivigitan	aktiv'ig'it'a'n
aktivigite	aktiv'ig'it'e
aktiviĝas	aktiv'iĝ'as
aktiviĝis	aktiv'iĝ'is
aktiviĝo	aktiv'iĝ'o
aktivismo	aktiv'ism'o
aktivismon	aktiv'ism'o'n
aktivisto	aktiv'ist'o
aktivistoj	aktiv'ist'o'j
aktivula	aktiv'ul'a
aktivulo	aktiv'ul'o
aktivuloj	aktiv'ul'o'j
aktivulojn	aktiv'ul'o'j'n
aktivulon	aktiv'ul'o'n
aktivulgrupoj	aktiv'ul'grup'o'j
aktivulino	aktiv'ul'in'o
aktora	aktor'a
aktoran	aktor'a'n
aktoras	aktor'as
aktori	aktor'i
aktoris	aktor'is
aktoro	aktor'o
aktoroj	aktor'o'j
aktorojn	aktor'o'j'n
aktoron	aktor'o'n
aktorado	aktor'ad'o
aktoradon	aktor'ad'o'n
aktoraro	aktor'ar'o
aktoraroj	aktor'ar'o'j
aktorino	aktor'in'o
aktorinoj	aktor'in'o'j
aktorinojn	aktor'in'o'j'n
aktorinon	aktor'in'o'n
aktuala	aktual'a
aktualaj	aktual'a'j
aktualajn	aktual'a'j'n
aktualan	aktual'a'n
aktualas	aktual'as
aktuale	aktual'e
aktualo	aktual'o
aktualaĵoj	aktual'aĵ'o'j
aktualaĵojn	aktual'aĵ'o'j'n
aktualeco	aktual'ec'o
aktualecon	aktual'ec'o'n
aktualigas	aktual'ig'as
aktualigi	aktual'ig'i
aktualigis	aktual'ig'is
aktualigo	aktual'ig'o
aktualigata	aktual'ig'at'a
aktualigita	aktual'ig'it'a
aktualigitaj	aktual'ig'it'a'j
akumula	akumul'a
akumulaj	akumul'a'j
akumulan	akumul'a'n
akumulas	akumul'as
akumuli	akumul'i
akumulis	akumul'is
akumulo	akumul'o
akumulado	akumul'ad'o
akumulatoro	akumul'ator'o
akumulatoroj	akumul'ator'o'j
akumulatoron	akumul'ator'o'n
akumuligita	akumul'ig'it'a
akumuligitaj	akumul'ig'it'a'j
akumuligitan	akumul'ig'it'a'n
akumuliĝas	akumul'iĝ'as
akumuliĝi	akumul'iĝ'i
akumuliĝis	akumul'iĝ'is
akumuliĝo	akumul'iĝ'o
akumulilo	akumul'il'o
akumuliloj	akumul'il'o'j
akumulilon	akumul'il'o'n
akumulita	akumul'it'a
akumulitaj	akumul'it'a'j
akupunkturo	akupunktur'o
akurata	akurat'a
akurataj	akurat'a'j
akuratajn	akurat'a'j'n
akuratan	akurat'a'n
akuratas	akurat'as
akurate	akurat'e
akurateco	akurat'ec'o
akuratecon	akurat'ec'o'n
akustika	akustik'a
akustikaj	akustik'a'j
akustikajn	akustik'a'j'n
akustikan	akustik'a'n
akustike	akustik'e
akustiko	akustik'o
akustikon	akustik'o'n
akuŝis	akuŝ'is
akuŝo	akuŝ'o
akuŝon	akuŝ'o'n
akuŝejo	akuŝ'ej'o
akuŝigis	akuŝ'ig'is
akuŝistino	akuŝ'ist'in'o
akuŝistinoj	akuŝ'ist'in'o'j
akuta	akut'a
akutaj	akut'a'j
akutajn	akut'a'j'n
akutan	akut'a'n
akute	akut'e
akuzaj	akuz'a'j
akuzas	akuz'as
akuzi	akuz'i
akuzis	akuz'is
akuzo	akuz'o
akuzoj	akuz'o'j
akuzojn	akuz'o'j'n
akuzon	akuz'o'n
akuzos	akuz'os
akuzu	akuz'u
akuzus	akuz'us
akuzado	akuz'ad'o
akuzanta	akuz'ant'a
akuzante	akuz'ant'e
akuzanto	akuz'ant'o
akuzantoj	akuz'ant'o'j
akuzanton	akuz'ant'o'n
akuzata	akuz'at'a
akuzataj	akuz'at'a'j
akuzato	akuz'at'o
akuzita	akuz'it'a
akuzitaj	akuz'it'a'j
akuzito	akuz'it'o
akuzitoj	akuz'it'o'j
akuzitojn	akuz'it'o'j'n
akuziton	akuz'it'o'n
akuzativa	akuzativ'a
akuzativaj	akuzativ'a'j
akuzativan	akuzativ'a'n
akuzativo	akuzativ'o
akuzativoj	akuzativ'o'j
akuzativon	akuzativ'o'n
akva	akv'a
akvaj	akv'a'j
akvajn	akv'a'j'n
akvan	akv'a'n
akve	akv'e
akvi	akv'i
akvo	akv'o
akvoj	akv'o'j
akvojn	akv'o'j'n
akvon	akv'o'n
akvaro	akv'ar'o
akveca	akv'ec'a
akvecan	akv'ec'a'n
akveja	akv'ej'a
akvejo	akv'ej'o
akvejoj	akv'ej'o'j
akveroj	akv'er'o'j
akvujo	akv'uj'o
akvujoj	akv'uj'o'j
akvujon	akv'uj'o'n
akvumas	akv'um'as
akvumi	akv'um'i
akvumis	akv'um'is
akvumos	akv'um'os
akvumu	akv'um'u
aldona	al'don'a
aldonaj	al'don'a'j
aldonajn	al'don'a'j'n
aldonan	al'don'a'n
aldonas	al'don'as
aldone	al'don'e
aldoni	al'don'i
aldonis	al'don'is
aldono	al'don'o
aldonoj	al'don'o'j
aldonojn	al'don'o'j'n
aldonon	al'don'o'n
aldonos	al'don'os
aldonu	al'don'u
aldonus	al'don'us
altiradis	al'tir'ad'is
altirado	al'tir'ad'o
altiranta	al'tir'ant'a
altirante	al'tir'ant'e
altirata	al'tir'at'a
altirataj	al'tir'at'a'j
altranĉado	al'tranĉ'ad'o
altrudata	al'trud'at'a
altrudita	al'trud'it'a
altruditaj	al'trud'it'a'j
alvenadis	al'ven'ad'is
alvenado	al'ven'ad'o
alvenanta	al'ven'ant'a
alvenantaj	al'ven'ant'a'j
alvenantajn	al'ven'ant'a'j'n
alvenantan	al'ven'ant'a'n
alvenante	al'ven'ant'e
alvenanto	al'ven'ant'o
alvenantoj	al'ven'ant'o'j
alvenigas	al'ven'ig'as
alvenigi	al'ven'ig'i
alvenigis	al'ven'ig'is
alveninta	al'ven'int'a
alvenintaj	al'ven'int'a'j
alvenintajn	al'ven'int'a'j'n
alveninte	al'ven'int'e
alveninto	al'ven'int'o
alvenintoj	al'ven'int'o'j
alvenintojn	al'ven'int'o'j'n
alvenita	al'ven'it'a
alvenitaj	al'ven'it'a'j
alvenonta	al'ven'ont'a
alvenontaj	al'ven'ont'a'j
alveturigi	al'vetur'ig'i
alveturigis	al'vetur'ig'is
alvojaĝanta	al'vojaĝ'ant'a
alvojaĝantaj	al'vojaĝ'ant'a'j
alvokado	al'vok'ad'o
alvokadoj	al'vok'ad'o'j
alvokanta	al'vok'ant'a
alvokante	al'vok'ant'e
alvokanto	al'vok'ant'o
alvokantoj	al'vok'ant'o'j
alvokata	al'vok'at'a
alvokataj	al'vok'at'a'j
alvokiĝo	al'vok'iĝ'o
alvokiĝon	al'vok'iĝ'o'n
alvokita	al'vok'it'a
alvokitaj	al'vok'it'a'j
alvokite	al'vok'it'e
alica	alic'a
alico	alic'o
alicon	alic'o'n
amura	amur'a
amuro	amur'o
anjo	anj'o
anjon	anj'o'n
antaŭ	antaŭ
antaŭa	antaŭ'a
antaŭaj	antaŭ'a'j
antaŭajn	antaŭ'a'j'n
antaŭan	antaŭ'a'n
antaŭas	antaŭ'as
antaŭe	antaŭ'e
antaŭen	antaŭ'e'n
antaŭhieraŭ	antaŭ'hieraŭ
antaŭi	antaŭ'i
antaŭis	antaŭ'is
antaŭo	antaŭ'o
antaŭon	antaŭ'o'n
antaŭu	antaŭ'u
antaŭaĵo	antaŭ'aĵ'o
antaŭaĵoj	antaŭ'aĵ'o'j
antaŭanoncas	antaŭ'anonc'as
antaŭanoncis	antaŭ'anonc'is
antaŭanta	antaŭ'ant'a
antaŭantaj	antaŭ'ant'a'j
antaŭante	antaŭ'ant'e
antaŭanto	antaŭ'ant'o
antaŭantoj	antaŭ'ant'o'j
antaŭata	antaŭ'at'a
antaŭdankas	antaŭ'dank'as
antaŭdankon	antaŭ'dank'o'n
antaŭdecidita	antaŭ'decid'it'a
antaŭdiras	antaŭ'dir'as
antaŭdiri	antaŭ'dir'i
antaŭdiris	antaŭ'dir'is
antaŭdiro	antaŭ'dir'o
antaŭdiroj	antaŭ'dir'o'j
antaŭdirojn	antaŭ'dir'o'j'n
antaŭdiron	antaŭ'dir'o'n
antaŭdirus	antaŭ'dir'us
antaŭdirado	antaŭ'dir'ad'o
antaŭdirante	antaŭ'dir'ant'e
antaŭdiristo	antaŭ'dir'ist'o
antaŭdirita	antaŭ'dir'it'a
antaŭdiritaj	antaŭ'dir'it'a'j
antaŭdirite	antaŭ'dir'it'e
antaŭenira	antaŭ'e'n'ir'a
antaŭeniras	antaŭ'e'n'ir'as
antaŭeniri	antaŭ'e'n'ir'i
antaŭeniris	antaŭ'e'n'ir'is
antaŭeniro	antaŭ'e'n'ir'o
antaŭeniron	antaŭ'e'n'ir'o'n
antaŭeniros	antaŭ'e'n'ir'os
antaŭeniru	antaŭ'e'n'ir'u
antaŭenkuras	antaŭ'e'n'kur'as
antaŭenkuris	antaŭ'e'n'kur'is
antaŭenmarŝo	antaŭ'e'n'marŝ'o
antaŭenmarŝon	antaŭ'e'n'marŝ'o'n
antaŭĝojas	antaŭ'ĝoj'as
antaŭĝojis	antaŭ'ĝoj'is
antaŭĝojo	antaŭ'ĝoj'o
antaŭĝuas	antaŭ'ĝu'as
antaŭĝuis	antaŭ'ĝu'is
antaŭiras	antaŭ'ir'as
antaŭiri	antaŭ'ir'i
antaŭiris	antaŭ'ir'is
antaŭita	antaŭ'it'a
antaŭitaj	antaŭ'it'a'j
antaŭjuĝa	antaŭ'juĝ'a
antaŭjuĝo	antaŭ'juĝ'o
antaŭjuĝoj	antaŭ'juĝ'o'j
antaŭjuĝojn	antaŭ'juĝ'o'j'n
antaŭjuĝon	antaŭ'juĝ'o'n
antaŭkalkuli	antaŭ'kalkul'i
antaŭkalkulis	antaŭ'kalkul'is
antaŭkalkulo	antaŭ'kalkul'o
antaŭkalkulon	antaŭ'kalkul'o'n
antaŭkongreso	antaŭ'kongres'o
antaŭkongresoj	antaŭ'kongres'o'j
antaŭpagi	antaŭ'pag'i
antaŭpagis	antaŭ'pag'is
antaŭpago	antaŭ'pag'o
antaŭpagon	antaŭ'pag'o'n
antaŭparolo	antaŭ'parol'o
antaŭparoloj	antaŭ'parol'o'j
antaŭparolon	antaŭ'parol'o'n
antaŭscias	antaŭ'sci'as
antaŭscii	antaŭ'sci'i
antaŭscio	antaŭ'sci'o
antaŭscion	antaŭ'sci'o'n
antaŭsentas	antaŭ'sent'as
antaŭsenti	antaŭ'sent'i
antaŭsentis	antaŭ'sent'is
antaŭsento	antaŭ'sent'o
antaŭsenton	antaŭ'sent'o'n
antaŭsigno	antaŭ'sign'o
antaŭsignoj	antaŭ'sign'o'j
antaŭsignojn	antaŭ'sign'o'j'n
antaŭsupozas	antaŭ'supoz'as
antaŭsupozis	antaŭ'supoz'is
antaŭsupozo	antaŭ'supoz'o
antaŭsupozoj	antaŭ'supoz'o'j
antaŭsupozojn	antaŭ'supoz'o'j'n
antaŭulo	antaŭ'ul'o
antaŭuloj	antaŭ'ul'o'j
antaŭulojn	antaŭ'ul'o'j'n
antaŭulon	antaŭ'ul'o'n
antaŭvespere	antaŭ'vesper'e
antaŭvespero	antaŭ'vesper'o
antaŭvidas	antaŭ'vid'as
antaŭvide	antaŭ'vid'e
antaŭvidi	antaŭ'vid'i
antaŭvidis	antaŭ'vid'is
antaŭvido	antaŭ'vid'o
antaŭvidon	antaŭ'vid'o'n
antaŭvidu	antaŭ'vid'u
antaŭzorgis	antaŭ'zorg'is
antaŭzorgo	antaŭ'zorg'o
antaŭzorgoj	antaŭ'zorg'o'j
antaŭzorgojn	antaŭ'zorg'o'j'n
antikva	antikv'a
antikvaj	antikv'a'j
antikvajn	antikv'a'j'n
antikvan	antikv'a'n
antikve	antikv'e
antikvo	antikv'o
antikvaĵo	antikv'aĵ'o
antikvaĵoj	antikv'aĵ'o'j
antikvaĵojn	antikv'aĵ'o'j'n
antikvaĵisto	antikv'aĵ'ist'o
antikveca	antikv'ec'a
antikvecaj	antikv'ec'a'j
antikvece	antikv'ec'e
antikveco	antikv'ec'o
antikvecon	antikv'ec'o'n
antikvulo	antikv'ul'o
antikvuloj	antikv'ul'o'j
aoristo	aorist'o
aosta	aost'a
aosto	aost'o
apo	ap'o
apartena	aparten'a
apartenas	aparten'as
aparteni	aparten'i
apartenis	aparten'is
aparteno	aparten'o
apartenon	aparten'o'n
apartenos	aparten'os
apartenu	aparten'u
apartenus	aparten'us
apartenado	aparten'ad'o
apartenaĵo	aparten'aĵ'o
apartenaĵoj	aparten'aĵ'o'j
apartenanta	aparten'ant'a
apartenantaj	aparten'ant'a'j
apartenantajn	aparten'ant'a'j'n
apartenantan	aparten'ant'a'n
apartenante	aparten'ant'e
apartenantoj	aparten'ant'o'j
aparteneco	aparten'ec'o
apartenecon	aparten'ec'o'n
aparteninta	aparten'int'a
apenau	apenaŭ
apenaŭ	apenaŭ
apenaŭa	apenaŭ'a
apeninoj	apenin'o'j
aperas	aper'as
aperi	aper'i
aperis	aper'is
apero	aper'o
aperoj	aper'o'j
aperojn	aper'o'j'n
aperon	aper'o'n
aperos	aper'os
aperu	aper'u
aperus	aper'us
aperadas	aper'ad'as
aperadi	aper'ad'i
aperadis	aper'ad'is
aperado	aper'ad'o
aperadon	aper'ad'o'n
aperados	aper'ad'os
aperaĵo	aper'aĵ'o
aperaĵoj	aper'aĵ'o'j
aperaĵojn	aper'aĵ'o'j'n
aperaĵon	aper'aĵ'o'n
aperanta	aper'ant'a
aperantaj	aper'ant'a'j
aperantajn	aper'ant'a'j'n
aperantan	aper'ant'a'n
aperante	aper'ant'e
aperigas	aper'ig'as
aperigi	aper'ig'i
aperigis	aper'ig'is
aperigo	aper'ig'o
aperigon	aper'ig'o'n
aperigos	aper'ig'os
aperigu	aper'ig'u
aperigus	aper'ig'us
aperigita	aper'ig'it'a
aperigitaj	aper'ig'it'a'j
aperinta	aper'int'a
aperintaj	aper'int'a'j
aperintajn	aper'int'a'j'n
aperintan	aper'int'a'n
aperinte	aper'int'e
aperita	aper'it'a
aperonta	aper'ont'a
aperontaj	aper'ont'a'j
apiso	apis'o
aplaŭdas	aplaŭd'as
aplaŭdi	aplaŭd'i
aplaŭdis	aplaŭd'is
aplaŭdo	aplaŭd'o
aplaŭdoj	aplaŭd'o'j
aplaŭdojn	aplaŭd'o'j'n
aplaŭdon	aplaŭd'o'n
aplaŭdu	aplaŭd'u
aplaŭdado	aplaŭd'ad'o
aplaŭdadon	aplaŭd'ad'o'n
aplaŭdante	aplaŭd'ant'e
aplaŭdata	aplaŭd'at'a
aplaŭdita	aplaŭd'it'a
aplika	aplik'a
aplikaj	aplik'a'j
aplikajn	aplik'a'j'n
aplikas	aplik'as
apliki	aplik'i
aplikis	aplik'is
apliko	aplik'o
aplikoj	aplik'o'j
aplikojn	aplik'o'j'n
aplikon	aplik'o'n
aplikos	aplik'os
apliku	aplik'u
aplikus	aplik'us
aplikado	aplik'ad'o
aplikadoj	aplik'ad'o'j
aplikadon	aplik'ad'o'n
aplikaĵo	aplik'aĵ'o
aplikaĵoj	aplik'aĵ'o'j
aplikaĵojn	aplik'aĵ'o'j'n
aplikaĵon	aplik'aĵ'o'n
aplikaĵosoftvaroj	aplik'aĵ'o'softvar'o'j
aplikante	aplik'ant'e
aplikata	aplik'at'a
aplikataj	aplik'at'a'j
aplikatajn	aplik'at'a'j'n
aplikatan	aplik'at'a'n
aplikebla	aplik'ebl'a
aplikeblaj	aplik'ebl'a'j
aplikeblas	aplik'ebl'as
aplikebleco	aplik'ebl'ec'o
aplikeblecon	aplik'ebl'ec'o'n
aplikeco	aplik'ec'o
aplikiĝas	aplik'iĝ'as
aplikiĝi	aplik'iĝ'i
aplikiĝis	aplik'iĝ'is
aplikiĝo	aplik'iĝ'o
aplikiĝon	aplik'iĝ'o'n
aplikiĝoprogramistoj	aplik'iĝ'o'program'ist'o'j
aplikita	aplik'it'a
aplikitaj	aplik'it'a'j
aplikitajn	aplik'it'a'j'n
aplikitan	aplik'it'a'n
aplikite	aplik'it'e
aprila	april'a
aprile	april'e
aprilo	april'o
aprilon	april'o'n
aprilomajo	april'o'maj'o
apulio	apuli'o
apuso	apus'o
apusoj	apus'o'j
arabaisraela	arab'a'israel'a
aranĝas	aranĝ'as
aranĝi	aranĝ'i
aranĝis	aranĝ'is
arangho	aranĝ'o
aranĝo	aranĝ'o
aranĝoj	aranĝ'o'j
aranĝojn	aranĝ'o'j'n
aranĝon	aranĝ'o'n
aranĝos	aranĝ'os
aranĝu	aranĝ'u
aranĝus	aranĝ'us
aranĝado	aranĝ'ad'o
aranĝadon	aranĝ'ad'o'n
aranĝaĵo	aranĝ'aĵ'o
aranĝaĵoj	aranĝ'aĵ'o'j
aranĝaĵojn	aranĝ'aĵ'o'j'n
aranĝanta	aranĝ'ant'a
aranĝantaj	aranĝ'ant'a'j
aranĝante	aranĝ'ant'e
aranĝanto	aranĝ'ant'o
aranĝantoj	aranĝ'ant'o'j
aranĝata	aranĝ'at'a
aranĝataj	aranĝ'at'a'j
aranĝiĝis	aranĝ'iĝ'is
aranĝisto	aranĝ'ist'o
aranĝita	aranĝ'it'a
aranĝitaj	aranĝ'it'a'j
aranĝitajn	aranĝ'it'a'j'n
aranĝitan	aranĝ'it'a'n
aranĝite	aranĝ'it'e
aranĝitaĵo	aranĝ'it'aĵ'o
arestas	arest'as
aresti	arest'i
arestis	arest'is
aresto	arest'o
arestoj	arest'o'j
arestojn	arest'o'j'n
areston	arest'o'n
arestos	arest'os
arestu	arest'u
arestado	arest'ad'o
arestata	arest'at'a
arestejo	arest'ej'o
arestejoj	arest'ej'o'j
arestigis	arest'ig'is
arestiĝis	arest'iĝ'is
arestita	arest'it'a
arestitaj	arest'it'a'j
arestito	arest'it'o
arestitoj	arest'it'o'j
arestitojn	arest'it'o'j'n
arestiton	arest'it'o'n
arta	art'a
artaj	art'a'j
artajn	art'a'j'n
artan	art'a'n
arte	art'e
arto	art'o
artoj	art'o'j
artojn	art'o'j'n
arton	art'o'n
artaĵo	art'aĵ'o
artaĵoj	art'aĵ'o'j
artaĵojn	art'aĵ'o'j'n
artaĵon	art'aĵ'o'n
artdirektoro	art'direktor'o
artefarita	art'e'far'it'a
artefaritaj	art'e'far'it'a'j
artefaritajn	art'e'far'it'a'j'n
artefaritan	art'e'far'it'a'n
artefarite	art'e'far'it'e
artefariteco	art'e'far'it'ec'o
artefaritinteligenteca	art'e'far'it'inteligent'ec'a
arteco	art'ec'o
artekspozicioj	art'ekspozici'o'j
artfajraĵo	art'fajr'aĵ'o
artfajraĵoj	art'fajr'aĵ'o'j
artfajraĵojn	art'fajr'aĵ'o'j'n
artfajraĵon	art'fajr'aĵ'o'n
artformo	art'form'o
artgalerio	art'galeri'o
artgalerioj	art'galeri'o'j
artgalerion	art'galeri'o'n
arthistoria	art'histori'a
arthistorio	art'histori'o
arthistorion	art'histori'o'n
arthistoriisto	art'histori'ist'o
arthistoriistoj	art'histori'ist'o'j
artisma	art'ism'a
artismaj	art'ism'a'j
artisman	art'ism'a'n
artisme	art'ism'e
artista	art'ist'a
artistaj	art'ist'a'j
artistajn	art'ist'a'j'n
artistan	art'ist'a'n
artiste	art'ist'e
artisto	art'ist'o
artistoj	art'ist'o'j
artistojn	art'ist'o'j'n
artiston	art'ist'o'n
artistino	art'ist'in'o
artistinoj	art'ist'in'o'j
artkritikisto	art'kritik'ist'o
artkritikistoj	art'kritik'ist'o'j
artlaboro	art'labor'o
artlumo	art'lum'o
artverko	art'verk'o
artverkoj	art'verk'o'j
artverkon	art'verk'o'n
artefakto	artefakt'o
artefaktoj	artefakt'o'j
artefaktojn	artefakt'o'j'n
artefakton	artefakt'o'n
artemizia	artemizi'a
artemizio	artemizi'o
arteria	arteri'a
arteriaj	arteri'a'j
arterian	arteri'a'n
arterio	arteri'o
arterioj	arteri'o'j
arteriojn	arteri'o'j'n
arterion	arteri'o'n
arteza	artez'a
artifika	artifik'a
artifikaj	artifik'a'j
artifike	artifik'e
artifiko	artifik'o
artifikoj	artifik'o'j
artifikojn	artifik'o'j'n
artifikon	artifik'o'n
artika	artik'a
artikaj	artik'a'j
artikan	artik'a'n
artiko	artik'o
artikoj	artik'o'j
artikojn	artik'o'j'n
artikon	artik'o'n
artikuloj	artik'ul'o'j
artiklo	artikl'o
artikloj	artikl'o'j
artiklojn	artikl'o'j'n
artiklon	artikl'o'n
artikola	artikol'a
artikolo	artikol'o
artikoloj	artikol'o'j
artikolojn	artikol'o'j'n
artikolon	artikol'o'n
artikolaro	artikol'ar'o
artikoleto	artikol'et'o
artikoletoj	artikol'et'o'j
artikoletojn	artikol'et'o'j'n
artikoleton	artikol'et'o'n
artikulacia	artikulaci'a
artikulacio	artikulaci'o
artikulacioj	artikulaci'o'j
artikulacion	artikulaci'o'n
artileria	artileri'a
artileriaj	artileri'a'j
artilerian	artileri'a'n
artilerio	artileri'o
artilerion	artileri'o'n
artileriisto	artileri'ist'o
artileriistoj	artileri'ist'o'j
artileripafado	artileri'paf'ad'o
artiŝokoj	artiŝok'o'j
artrito	artr'it'o
artriton	artr'it'o'n
arturo	artur'o
arturon	artur'o'n
arundo	arund'o
asa	as'a
ase	as'e
aso	as'o
asoj	as'o'j
asojn	as'o'j'n
ason	as'o'n
asiago	as'i'ag'o
asama	asam'a
asamo	asam'o
asbesto	asbest'o
asbeston	asbest'o'n
ascenda	ascend'a
ascendas	ascend'as
ascendi	ascend'i
ascendis	ascend'is
ascendo	ascend'o
ascendon	ascend'o'n
ascendanta	ascend'ant'a
ascension	ascensi'o'n
asekura	asekur'a
asekuraj	asekur'a'j
asekurajn	asekur'a'j'n
asekuran	asekur'a'n
asekuras	asekur'as
asekuri	asekur'i
asekuris	asekur'is
asekuro	asekur'o
asekuroj	asekur'o'j
asekurojn	asekur'o'j'n
asekuron	asekur'o'n
asekurado	asekur'ad'o
asekurentrepreno	asekur'entrepren'o
asekurentreprenoj	asekur'entrepren'o'j
asekuristo	asekur'ist'o
asekuristoj	asekur'ist'o'j
asekurita	asekur'it'a
asekuritaj	asekur'it'a'j
asekurkompanio	asekur'kompani'o
asekurkontrakto	asekur'kontrakt'o
asekurkontrakton	asekur'kontrakt'o'n
asembla	asembl'a
asemblero	asembl'er'o
asembleroj	asembl'er'o'j
asemblea	asemble'a
asembleo	asemble'o
asembleoj	asemble'o'j
asembleojn	asemble'o'j'n
asembleon	asemble'o'n
aserta	asert'a
asertas	asert'as
aserti	asert'i
asertis	asert'is
aserto	asert'o
asertoj	asert'o'j
asertojn	asert'o'j'n
aserton	asert'o'n
asertos	asert'os
asertu	asert'u
asertus	asert'us
asertadis	asert'ad'is
asertado	asert'ad'o
asertanta	asert'ant'a
asertantaj	asert'ant'a'j
asertante	asert'ant'e
asertata	asert'at'a
asertate	asert'at'e
asertita	asert'it'a
asertitaj	asert'it'a'j
asertite	asert'it'e
asesoro	asesor'o
asfalta	asfalt'a
asfaltaj	asfalt'a'j
asfalto	asfalt'o
asfalton	asfalt'o'n
asfaltita	asfalt'it'a
asfaltitaj	asfalt'it'a'j
asignas	asign'as
asigni	asign'i
asignis	asign'is
asigno	asign'o
asignoj	asign'o'j
asignojn	asign'o'j'n
asignon	asign'o'n
asignus	asign'us
asignado	asign'ad'o
asignante	asign'ant'e
asignita	asign'it'a
asignitaj	asign'it'a'j
asignitajn	asign'it'a'j'n
asignitan	asign'it'a'n
asignite	asign'it'e
asimilas	asimil'as
asimili	asimil'i
asimilis	asimil'is
asimilo	asimil'o
asimilado	asimil'ad'o
asimiladon	asimil'ad'o'n
asimilanta	asimil'ant'a
asimilantaj	asimil'ant'a'j
asimilante	asimil'ant'e
asimiliĝi	asimil'iĝ'i
asimiliĝis	asimil'iĝ'is
asimiliĝo	asimil'iĝ'o
asimilita	asimil'it'a
asimilitaj	asimil'it'a'j
asimptota	asimptot'a
asimptotaj	asimptot'a'j
asimptote	asimptot'e
asira	asir'a
asiraj	asir'a'j
asiran	asir'a'n
asiro	asir'o
asiria	asir'i'a
asiriaj	asir'i'a'j
asirio	asir'i'o
asirion	asir'i'o'n
asirianoj	asir'i'an'o'j
asista	asist'a
asistas	asist'as
asisti	asist'i
asistis	asist'is
asisto	asist'o
asiston	asist'o'n
asistu	asist'u
asistado	asist'ad'o
asistadon	asist'ad'o'n
asistanto	asist'ant'o
asistantoj	asist'ant'o'j
asistantojn	asist'ant'o'j'n
asistanton	asist'ant'o'n
asistantino	asist'ant'in'o
asistata	asist'at'a
asiza	asiz'a
asizo	asiz'o
asketa	asket'a
asketaj	asket'a'j
asketajn	asket'a'j'n
asketan	asket'a'n
asketo	asket'o
asketoj	asket'o'j
asketismo	asket'ism'o
asketismon	asket'ism'o'n
askia	aski'a
askio	aski'o
asklepio	asklepi'o
askorbata	askorb'at'a
asocia	asoci'a
asociaj	asoci'a'j
asociajn	asoci'a'j'n
asocian	asoci'a'n
asocias	asoci'as
asocie	asoci'e
asocii	asoci'i
asociis	asoci'is
asocio	asoci'o
asocioj	asoci'o'j
asociojn	asoci'o'j'n
asocion	asoci'o'n
asociado	asoci'ad'o
asocianoj	asoci'an'o'j
asociante	asoci'ant'e
asociata	asoci'at'a
asociataj	asoci'at'a'j
asocieca	asoci'ec'a
asociiĝas	asoci'iĝ'as
asociiĝi	asoci'iĝ'i
asociiĝis	asoci'iĝ'is
asociiĝo	asoci'iĝ'o
asociita	asoci'it'a
asociitaj	asoci'it'a'j
asociitajn	asoci'it'a'j'n
asociitan	asoci'it'a'n
asociite	asoci'it'e
asonanco	asonanc'o
asparago	asparag'o
asparagoj	asparag'o'j
aspartamo	aspartam'o
aspekta	aspekt'a
aspektaj	aspekt'a'j
aspektan	aspekt'a'n
aspektas	aspekt'as
aspekte	aspekt'e
aspekti	aspekt'i
aspektis	aspekt'is
aspekto	aspekt'o
aspektoj	aspekt'o'j
aspektojn	aspekt'o'j'n
aspekton	aspekt'o'n
aspektos	aspekt'os
aspektu	aspekt'u
aspektus	aspekt'us
aspektanta	aspekt'ant'a
aspektantaj	aspekt'ant'a'j
aspektantan	aspekt'ant'a'n
aspektante	aspekt'ant'e
aspektigas	aspekt'ig'as
aspektigis	aspekt'ig'is
aspergas	asperg'as
aspergis	asperg'is
aspiras	aspir'as
aspiri	aspir'i
aspiris	aspir'is
aspiro	aspir'o
aspiroj	aspir'o'j
aspirojn	aspir'o'j'n
aspiron	aspir'o'n
aspirado	aspir'ad'o
aspiranta	aspir'ant'a
aspirantaj	aspir'ant'a'j
aspiranto	aspir'ant'o
aspirantoj	aspir'ant'o'j
aspirata	aspir'at'a
aspirino	aspirin'o
aspirinon	aspirin'o'n
aspra	aspr'a
asteracoj	aster'ac'o'j
asterio	asteri'o
asterisko	asterisk'o
asteroida	asteroid'a
asteroidaj	asteroid'a'j
asteroido	asteroid'o
asteroidoj	asteroid'o'j
asteroidojn	asteroid'o'j'n
asteroidon	asteroid'o'n
astmo	astm'o
astmon	astm'o'n
astra	astr'a
astro	astr'o
astroj	astr'o'j
astrojn	astr'o'j'n
astrobiologio	astr'o'biolog'i'o
astrofizika	astr'o'fizik'a
astrofizikaj	astr'o'fizik'a'j
astrofiziko	astr'o'fizik'o
astrofizikisto	astr'o'fizik'ist'o
astrofizikistoj	astr'o'fizik'ist'o'j
astrofizikiston	astr'o'fizik'ist'o'n
astrometrio	astr'o'metr'i'o
astronavigaciisto	astr'o'navigaci'ist'o
astroscienco	astr'o'scienc'o
astrologo	astr'olog'o
astrologoj	astr'olog'o'j
astrologia	astr'olog'i'a
astrologiaj	astr'olog'i'a'j
astrologio	astr'olog'i'o
astrologion	astr'olog'i'o'n
astraĥana	astraĥan'a
astraĥano	astraĥan'o
astrolabo	astrolab'o
astronaŭto	astronaŭt'o
astronaŭtoj	astronaŭt'o'j
astronaŭtojn	astronaŭt'o'j'n
astronaŭtiko	astronaŭt'ik'o
astronoma	astronom'a
astronomo	astronom'o
astronomoj	astronom'o'j
astronomojn	astronom'o'j'n
astronomon	astronom'o'n
astronomia	astronom'i'a
astronomiaj	astronom'i'a'j
astronomiajn	astronom'i'a'j'n
astronomian	astronom'i'a'n
astronomio	astronom'i'o
astronomion	astronom'i'o'n
astronomino	astronom'in'o
asturio	asturi'o
aŝkenaza	aŝkenaz'a
aŝkenazaj	aŝkenaz'a'j
aŝkenazo	aŝkenaz'o
aŝkenazoj	aŝkenaz'o'j
ashoka	aŝok'a
aŝoko	aŝok'o
ataka	atak'a
atakaj	atak'a'j
atakajn	atak'a'j'n
atakan	atak'a'n
atakas	atak'as
ataki	atak'i
atakis	atak'is
atako	atak'o
atakoj	atak'o'j
atakojn	atak'o'j'n
atakon	atak'o'n
atakos	atak'os
ataku	atak'u
atakus	atak'us
atakado	atak'ad'o
atakadon	atak'ad'o'n
atakanta	atak'ant'a
atakantaj	atak'ant'a'j
atakantajn	atak'ant'a'j'n
atakante	atak'ant'e
atakanto	atak'ant'o
atakantoj	atak'ant'o'j
atakantojn	atak'ant'o'j'n
atakanton	atak'ant'o'n
atakata	atak'at'a
atakataj	atak'at'a'j
atakebla	atak'ebl'a
atakema	atak'em'a
atakintaj	atak'int'a'j
atakinto	atak'int'o
atakintoj	atak'int'o'j
atakita	atak'it'a
atakitaj	atak'it'a'j
atakite	atak'it'e
ataksio	ataksi'o
atalanta	atalant'a
atanazio	atanazi'o
ataŝeo	ataŝe'o
ataŝeoj	ataŝe'o'j
atavismo	atavism'o
ateisma	ateism'a
ateismaj	ateism'a'j
ateisman	ateism'a'n
ateismo	ateism'o
ateismon	ateism'o'n
ateista	ateist'a
ateistaj	ateist'a'j
ateisto	ateist'o
ateistoj	ateist'o'j
ateistojn	ateist'o'j'n
ateliero	atelier'o
atelieroj	atelier'o'j
atelierojn	atelier'o'j'n
atelieron	atelier'o'n
atena	aten'a
atenaj	aten'a'j
atenajn	aten'a'j'n
atenan	aten'a'n
ateno	aten'o
atenon	aten'o'n
atenano	aten'an'o
atenanoj	aten'an'o'j
atenanojn	aten'an'o'j'n
atena	atena
atencas	atenc'as
atenci	atenc'i
atencis	atenc'is
atenco	atenc'o
atencoj	atenc'o'j
atencojn	atenc'o'j'n
atencon	atenc'o'n
atencintoj	atenc'int'o'j
atenda	atend'a
atendas	atend'as
atende	atend'e
atendi	atend'i
atendis	atend'is
atendo	atend'o
atendoj	atend'o'j
atendojn	atend'o'j'n
atendon	atend'o'n
atendos	atend'os
atendu	atend'u
atendus	atend'us
atendadas	atend'ad'as
atendadi	atend'ad'i
atendadis	atend'ad'is
atendado	atend'ad'o
atendadon	atend'ad'o'n
atendanta	atend'ant'a
atendantaj	atend'ant'a'j
atendantajn	atend'ant'a'j'n
atendantan	atend'ant'a'n
atendante	atend'ant'e
atendantoj	atend'ant'o'j
atendata	atend'at'a
atendataj	atend'at'a'j
atendatajn	atend'at'a'j'n
atendatan	atend'at'a'n
atendate	atend'at'e
atendebla	atend'ebl'a
atendeblas	atend'ebl'as
atendeble	atend'ebl'e
atendejo	atend'ej'o
atendiga	atend'ig'a
atendigas	atend'ig'as
atendigi	atend'ig'i
atendigis	atend'ig'is
atendigu	atend'ig'u
atendinta	atend'int'a
atendinte	atend'int'e
atendita	atend'it'a
atenditaj	atend'it'a'j
atenditan	atend'it'a'n
atendite	atend'it'e
atendolisto	atend'o'list'o
atendovico	atend'o'vic'o
atendovicoj	atend'o'vic'o'j
atendovicon	atend'o'vic'o'n
atendota	atend'ot'a
ateneo	atene'o
atenta	atent'a
atentaj	atent'a'j
atentan	atent'a'n
atentas	atent'as
atente	atent'e
atenti	atent'i
atentis	atent'is
atento	atent'o
atentoj	atent'o'j
atentojn	atent'o'j'n
atenton	atent'o'n
atentos	atent'os
atentu	atent'u
atentus	atent'us
atentado	atent'ad'o
atentante	atent'ant'e
atentata	atent'at'a
atentataj	atent'at'a'j
atenteco	atent'ec'o
atentecrilata	atent'ec'rilat'a
atentecrilataj	atent'ec'rilat'a'j
atentega	atent'eg'a
atentege	atent'eg'e
atentema	atent'em'a
atentemaj	atent'em'a'j
atenteman	atent'em'a'n
atenteme	atent'em'e
atentemo	atent'em'o
atentemon	atent'em'o'n
atentigas	atent'ig'as
atentigi	atent'ig'i
atentigis	atent'ig'is
atentigo	atent'ig'o
atentigoj	atent'ig'o'j
atentigojn	atent'ig'o'j'n
atentigon	atent'ig'o'n
atentigos	atent'ig'os
atentigu	atent'ig'u
atentigante	atent'ig'ant'e
atentinda	atent'ind'a
atentindaj	atent'ind'a'j
atentindan	atent'ind'a'n
atentindas	atent'ind'as
atentinde	atent'ind'e
atentita	atent'it'a
atentokapta	atent'o'kapt'a
atentokaptaj	atent'o'kapt'a'j
atentokaptan	atent'o'kapt'a'n
atenuiĝo	atenu'iĝ'o
aterosklerozo	ateroskleroz'o
atestas	atest'as
atesti	atest'i
atestis	atest'is
atesto	atest'o
atestoj	atest'o'j
atestojn	atest'o'j'n
ateston	atest'o'n
atestos	atest'os
atestu	atest'u
atestado	atest'ad'o
atestadoj	atest'ad'o'j
atestadon	atest'ad'o'n
atestaĵo	atest'aĵ'o
atestaĵoj	atest'aĵ'o'j
atestaĵojn	atest'aĵ'o'j'n
atestaĵon	atest'aĵ'o'n
atestanta	atest'ant'a
atestante	atest'ant'e
atestanto	atest'ant'o
atestantoj	atest'ant'o'j
atestantojn	atest'ant'o'j'n
atestanton	atest'ant'o'n
atestata	atest'at'a
atestilo	atest'il'o
atestiloj	atest'il'o'j
atestilojn	atest'il'o'j'n
atestilon	atest'il'o'n
atestintoj	atest'int'o'j
atestita	atest'it'a
atestitaj	atest'it'a'j
atestite	atest'it'e
atika	atik'a
atikaj	atik'a'j
atiko	atik'o
atikon	atik'o'n
atilo	atil'o
atinga	ating'a
atingas	ating'as
atingi	ating'i
atingis	ating'is
atingo	ating'o
atingoj	ating'o'j
atingojn	ating'o'j'n
atingon	ating'o'n
atingos	ating'os
atingu	ating'u
atingus	ating'us
atingadis	ating'ad'is
atingado	ating'ad'o
atingaĵo	ating'aĵ'o
atingaĵoj	ating'aĵ'o'j
atingaĵojn	ating'aĵ'o'j'n
atinganta	ating'ant'a
atingantaj	ating'ant'a'j
atingante	ating'ant'e
atingata	ating'at'a
atingebla	ating'ebl'a
atingeblaj	ating'ebl'a'j
atingeblajn	ating'ebl'a'j'n
atingeblan	ating'ebl'a'n
atingeblas	ating'ebl'as
atingeblo	ating'ebl'o
atinginta	ating'int'a
atingintaj	ating'int'a'j
atinginte	ating'int'e
atingita	ating'it'a
atingitaj	ating'it'a'j
atingitajn	ating'it'a'j'n
atingitan	ating'it'a'n
atingopovo	ating'o'pov'o
atingota	ating'ot'a
atlanta	atlant'a
atlantis	atlant'is
atlanto	atlant'o
atlantido	atlantid'o
atlantika	atlantik'a
atlantikaj	atlantik'a'j
atlantikan	atlantik'a'n
atlantiko	atlantik'o
atlantikon	atlantik'o'n
atlasa	atlas'a
atlaso	atlas'o
atlasoj	atlas'o'j
atleta	atlet'a
atletaj	atlet'a'j
atletan	atlet'a'n
atleto	atlet'o
atletoj	atlet'o'j
atletojn	atlet'o'j'n
atleton	atlet'o'n
atletika	atlet'ik'a
atletikaj	atlet'ik'a'j
atletiko	atlet'ik'o
atletikon	atlet'ik'o'n
atmano	atman'o
atmosfera	atmosfer'a
atmosferaj	atmosfer'a'j
atmosferajn	atmosfer'a'j'n
atmosferan	atmosfer'a'n
atmosfero	atmosfer'o
atmosferoj	atmosfer'o'j
atmosferojn	atmosfer'o'j'n
atmosferon	atmosfer'o'n
atolo	atol'o
atoloj	atol'o'j
atoma	atom'a
atomaj	atom'a'j
atomajn	atom'a'j'n
atoman	atom'a'n
atomo	atom'o
atomoj	atom'o'j
atomojn	atom'o'j'n
atomon	atom'o'n
atomarmiloj	atom'arm'il'o'j
atomarmilojn	atom'arm'il'o'j'n
atombomba	atom'bomb'a
atombombo	atom'bomb'o
atombomboj	atom'bomb'o'j
atombombojn	atom'bomb'o'j'n
atombombon	atom'bomb'o'n
atomcentralo	atom'central'o
atomcentraloj	atom'central'o'j
atomcentralojn	atom'central'o'j'n
atomeksplodo	atom'eksplod'o
atomeksplodoj	atom'eksplod'o'j
atomenergia	atom'energi'a
atomenergiaj	atom'energi'a'j
atomenergio	atom'energi'o
atomenergion	atom'energi'o'n
atomepoko	atom'epok'o
atomindustrio	atom'industri'o
atomismo	atom'ism'o
atomkerno	atom'kern'o
atomkernoj	atom'kern'o'j
atommedicino	atom'medicin'o
atommilito	atom'milit'o
atommiliton	atom'milit'o'n
atomnumero	atom'numer'o
atomnumeroj	atom'numer'o'j
atompezo	atom'pez'o
atomprogramo	atom'program'o
atomrubo	atom'rub'o
atomrubaĵo	atom'rub'aĵ'o
atomstrukturo	atom'struktur'o
atomŝeloj	atom'ŝel'o'j
atomteknologio	atom'teknologi'o
atrakcio	atrakci'o
atrakcioj	atrakci'o'j
atreo	atre'o
atria	atri'a
atrio	atri'o
atrion	atri'o'n
atribua	atribu'a
atribuaj	atribu'a'j
atribuas	atribu'as
atribui	atribu'i
atribuis	atribu'is
atribuo	atribu'o
atribuoj	atribu'o'j
atribuojn	atribu'o'j'n
atribuon	atribu'o'n
atribuos	atribu'os
atribuu	atribu'u
atribuado	atribu'ad'o
atribuante	atribu'ant'e
atribuata	atribu'at'a
atribuataj	atribu'at'a'j
atribuebla	atribu'ebl'a
atribueblaj	atribu'ebl'a'j
atribuiĝas	atribu'iĝ'as
atribuita	atribu'it'a
atribuitaj	atribu'it'a'j
atribuitajn	atribu'it'a'j'n
atribuitan	atribu'it'a'n
atribuite	atribu'it'e
atributas	atribut'as
atributi	atribut'i
atributo	atribut'o
atributoj	atribut'o'j
atributojn	atribut'o'j'n
atributon	atribut'o'n
atributita	atribut'it'a
atributitaj	atribut'it'a'j
atriplo	atripl'o
atrofio	atrofi'o
atuto	atut'o
atutoj	atut'o'j
atutojn	atut'o'j'n
atuton	atut'o'n
aŭ	aŭ
aŭda	aŭd'a
aŭdaj	aŭd'a'j
aŭdajn	aŭd'a'j'n
aŭdan	aŭd'a'n
aŭdas	aŭd'as
aŭde	aŭd'e
aŭdi	aŭd'i
aŭdis	aŭd'is
aŭdo	aŭd'o
aŭdon	aŭd'o'n
aŭdos	aŭd'os
aŭdu	aŭd'u
aŭdus	aŭd'us
aŭdadis	aŭd'ad'is
aŭdado	aŭd'ad'o
aŭdadon	aŭd'ad'o'n
aŭdanta	aŭd'ant'a
aŭdantaj	aŭd'ant'a'j
aŭdante	aŭd'ant'e
aŭdanto	aŭd'ant'o
aŭdantoj	aŭd'ant'o'j
aŭdantaro	aŭd'ant'ar'o
aŭdantaron	aŭd'ant'ar'o'n
aŭdata	aŭd'at'a
aŭdataj	aŭd'at'a'j
aŭdcerbo	aŭd'cerb'o
aŭdebla	aŭd'ebl'a
aŭdeblaj	aŭd'ebl'a'j
aŭdeblajn	aŭd'ebl'a'j'n
aŭdeblan	aŭd'ebl'a'n
aŭdeblas	aŭd'ebl'as
aŭdeble	aŭd'ebl'e
aŭdeblis	aŭd'ebl'is
aŭdebleco	aŭd'ebl'ec'o
aŭdigas	aŭd'ig'as
aŭdigi	aŭd'ig'i
aŭdigis	aŭd'ig'is
aŭdigu	aŭd'ig'u
aŭdiĝas	aŭd'iĝ'as
aŭdiĝi	aŭd'iĝ'i
aŭdiĝis	aŭd'iĝ'is
aŭdilo	aŭd'il'o
aŭdiloj	aŭd'il'o'j
aŭdilojn	aŭd'il'o'j'n
aŭdilon	aŭd'il'o'n
aŭdinta	aŭd'int'a
aŭdintaj	aŭd'int'a'j
aŭdinte	aŭd'int'e
aŭdita	aŭd'it'a
aŭditaj	aŭd'it'a'j
aŭditajn	aŭd'it'a'j'n
aŭditan	aŭd'it'a'n
aŭdite	aŭd'it'e
aŭdkapablo	aŭd'kapabl'o
aŭdkapablon	aŭd'kapabl'o'n
aŭdoprotektiloj	aŭd'o'protekt'il'o'j
aŭdovida	aŭd'o'vid'a
aŭdperdo	aŭd'perd'o
aŭdvida	aŭd'vid'a
aŭdvidaj	aŭd'vid'a'j
aŭdvidan	aŭd'vid'a'n
aŭdaca	aŭdac'a
aŭdacaj	aŭdac'a'j
aŭdacajn	aŭdac'a'j'n
aŭdacan	aŭdac'a'n
aŭdacas	aŭdac'as
aŭdace	aŭdac'e
aŭdaci	aŭdac'i
aŭdacis	aŭdac'is
aŭdaco	aŭdac'o
aŭdacon	aŭdac'o'n
aŭdacos	aŭdac'os
aŭdacu	aŭdac'u
aŭdacus	aŭdac'us
aŭdienco	aŭdienc'o
aŭdiencoj	aŭdienc'o'j
aŭdiencon	aŭdienc'o'n
aŭditorio	aŭditori'o
aŭditorioj	aŭditori'o'j
aŭditorion	aŭditori'o'n
aŭgura	aŭgur'a
aŭguras	aŭgur'as
aŭguri	aŭgur'i
aŭguris	aŭgur'is
aŭguro	aŭgur'o
aŭguroj	aŭgur'o'j
aŭguron	aŭgur'o'n
aŭgurado	aŭgur'ad'o
aŭguradon	aŭgur'ad'o'n
aŭguristo	aŭgur'ist'o
aŭguristoj	aŭgur'ist'o'j
aŭgusta	aŭgust'a
aŭguste	aŭgust'e
aŭgusto	aŭgust'o
aŭguston	aŭgust'o'n
aŭgustena	aŭgusten'a
aŭgusteno	aŭgusten'o
aŭgustenon	aŭgusten'o'n
aŭgustenana	aŭgusten'an'a
aŭgustenanoj	aŭgusten'an'o'j
aŭkaj	aŭk'a'j
aŭko	aŭk'o
aŭkoj	aŭk'o'j
aŭkcio	aŭkci'o
aŭkcioj	aŭkci'o'j
aŭkcion	aŭkci'o'n
aŭksino	aŭksin'o
aŭlo	aŭl'o
aŭrelio	aŭreli'o
aŭreliano	aŭrelian'o
aŭreolo	aŭreol'o
aŭreoloj	aŭreol'o'j
aŭriklo	aŭrikl'o
aŭrora	aŭror'a
aŭroro	aŭror'o
aŭroroj	aŭror'o'j
aŭrorojn	aŭror'o'j'n
aŭroron	aŭror'o'n
auskultas	aŭskult'as
aŭskultas	aŭskult'as
auskulti	aŭskult'i
aŭskulti	aŭskult'i
auskultis	aŭskult'is
aŭskultis	aŭskult'is
aŭskulto	aŭskult'o
aŭskultos	aŭskult'os
auskultu	aŭskult'u
aŭskultu	aŭskult'u
aŭskultus	aŭskult'us
aŭskultadis	aŭskult'ad'is
auskultado	aŭskult'ad'o
aŭskultado	aŭskult'ad'o
aŭskultadon	aŭskult'ad'o'n
aŭskultanta	aŭskult'ant'a
aŭskultantaj	aŭskult'ant'a'j
aŭskultantajn	aŭskult'ant'a'j'n
auskultante	aŭskult'ant'e
aŭskultante	aŭskult'ant'e
aŭskultanto	aŭskult'ant'o
auskultantoj	aŭskult'ant'o'j
aŭskultantoj	aŭskult'ant'o'j
aŭskultantojn	aŭskult'ant'o'j'n
aŭskultanton	aŭskult'ant'o'n
aŭskultantaro	aŭskult'ant'ar'o
aŭskultantaron	aŭskult'ant'ar'o'n
aŭskultata	aŭskult'at'a
aŭskultataj	aŭskult'at'a'j
aŭskultebla	aŭskult'ebl'a
aŭskulteblas	aŭskult'ebl'as
aŭskultilo	aŭskult'il'o
aŭskultiloj	aŭskult'il'o'j
aŭskultilon	aŭskult'il'o'n
aŭskultinta	aŭskult'int'a
aŭskultinte	aŭskult'int'e
aŭskultita	aŭskult'it'a
aŭskultitaj	aŭskult'it'a'j
aŭspicia	aŭspici'a
aŭspicias	aŭspici'as
aŭspiciis	aŭspici'is
aŭspicio	aŭspici'o
aŭspicioj	aŭspici'o'j
aŭspiciojn	aŭspici'o'j'n
aŭstra	aŭstr'a
aŭstraj	aŭstr'a'j
aŭstrajn	aŭstr'a'j'n
aŭstran	aŭstr'a'n
aŭstro	aŭstr'o
aŭstroj	aŭstr'o'j
aŭstrojn	aŭstr'o'j'n
aŭstrahungara	aŭstr'a'hungar'a
aŭstria	aŭstr'i'a
aŭstriaj	aŭstr'i'a'j
aŭstrian	aŭstr'i'a'n
aŭstrio	aŭstr'i'o
aŭstrion	aŭstr'i'o'n
aŭstriahungara	aŭstr'i'a'hungar'a
aŭstriohungario	aŭstr'i'o'hungari'o
aŭstrohungara	aŭstr'o'hungar'a
aŭstrohungaraj	aŭstr'o'hungar'a'j
aŭstrohungario	aŭstr'o'hungari'o
aŭstrujo	aŭstr'uj'o
aŭstrujon	aŭstr'uj'o'n
aŭstrala	aŭstral'a
aŭstralazia	aŭstralazi'a
aŭstralaziaj	aŭstralazi'a'j
aŭstralazio	aŭstralazi'o
aŭstralia	aŭstrali'a
aŭstraliaj	aŭstrali'a'j
aŭstraliajn	aŭstrali'a'j'n
aŭstralian	aŭstrali'a'n
aŭstralio	aŭstrali'o
aŭstralion	aŭstrali'o'n
aŭstraliano	aŭstrali'an'o
aŭstralianoj	aŭstrali'an'o'j
aŭstrazio	aŭstrazi'o
aŭta	aŭt'a
aŭtaj	aŭt'a'j
aŭtajn	aŭt'a'j'n
aŭtan	aŭt'a'n
aŭtas	aŭt'as
aŭte	aŭt'e
aŭti	aŭt'i
aŭtis	aŭt'is
aŭto	aŭt'o
aŭtoj	aŭt'o'j
aŭtojn	aŭt'o'j'n
aŭton	aŭt'o'n
aŭtaĉo	aŭt'aĉ'o
aŭtejo	aŭt'ej'o
aŭtejon	aŭt'ej'o'n
aŭteto	aŭt'et'o
aŭteton	aŭt'et'o'n
aŭtindustrio	aŭt'industri'o
aŭtisto	aŭt'ist'o
aŭtistoj	aŭt'ist'o'j
aŭtistojn	aŭt'ist'o'j'n
aŭtoakcidento	aŭt'o'akcident'o
aŭtobombo	aŭt'o'bomb'o
aŭtobomboj	aŭt'o'bomb'o'j
aŭtoindustrio	aŭt'o'industri'o
aŭtokodo	aŭt'o'kod'o
aŭtokodoj	aŭt'o'kod'o'j
aŭtopiloto	aŭt'o'pilot'o
aŭtoproduktanto	aŭt'o'produkt'ant'o
aŭtoproduktantoj	aŭt'o'produkt'ant'o'j
aŭtostirado	aŭt'o'stir'ad'o
aŭtoŝlosilojn	aŭt'o'ŝlos'il'o'j'n
aŭtoŝoseo	aŭt'o'ŝose'o
aŭtoŝoseoj	aŭt'o'ŝose'o'j
aŭtotransporto	aŭt'o'trans'port'o
aŭtoveturejo	aŭt'o'vetur'ej'o
aŭtoveturejoj	aŭt'o'vetur'ej'o'j
aŭtovoja	aŭt'o'voj'a
aŭtovojaj	aŭt'o'voj'a'j
aŭtovojo	aŭt'o'voj'o
aŭtovojoj	aŭt'o'voj'o'j
aŭtovojojn	aŭt'o'voj'o'j'n
aŭtovojon	aŭt'o'voj'o'n
aŭtovojreto	aŭt'o'voj'ret'o
aŭtproduktantoj	aŭt'produkt'ant'o'j
aŭtarkio	aŭtarki'o
aŭtarkion	aŭtarki'o'n
aŭtenta	aŭtent'a
aŭtentaj	aŭtent'a'j
aŭtentajn	aŭtent'a'j'n
aŭtentan	aŭtent'a'n
aŭtente	aŭtent'e
aŭtenteco	aŭtent'ec'o
aŭtentecon	aŭtent'ec'o'n
aŭtentika	aŭtentik'a
aŭtentikaj	aŭtentik'a'j
aŭtentikan	aŭtentik'a'n
aŭtentike	aŭtentik'e
aŭtentikeco	aŭtentik'ec'o
aŭtentikecon	aŭtentik'ec'o'n
aŭtentikigi	aŭtentik'ig'i
aŭtentikigita	aŭtentik'ig'it'a
aŭtisma	aŭtism'a
aŭtismaj	aŭtism'a'j
aŭtismo	aŭtism'o
aŭtismon	aŭtism'o'n
aŭtismulo	aŭtism'ul'o
aŭtismuloj	aŭtism'ul'o'j
aŭtobiografia	aŭtobiografi'a
aŭtobiografiaj	aŭtobiografi'a'j
aŭtobiografiajn	aŭtobiografi'a'j'n
aŭtobiografian	aŭtobiografi'a'n
aŭtobiografio	aŭtobiografi'o
aŭtobiografioj	aŭtobiografi'o'j
aŭtobiografion	aŭtobiografi'o'n
aŭtobusa	aŭtobus'a
aŭtobusaj	aŭtobus'a'j
aŭtobusan	aŭtobus'a'n
aŭtobuse	aŭtobus'e
aŭtobuso	aŭtobus'o
aŭtobusoj	aŭtobus'o'j
aŭtobusojn	aŭtobus'o'j'n
aŭtobuson	aŭtobus'o'n
aŭtodafeo	aŭtodafe'o
aŭtodidakte	aŭtodidakt'e
aŭtodidakto	aŭtodidakt'o
aŭtogiro	aŭtogir'o
aŭtografo	aŭtograf'o
aŭtografoj	aŭtograf'o'j
aŭtografojn	aŭtograf'o'j'n
aŭtografon	aŭtograf'o'n
aŭtokrata	aŭtokrat'a
aŭtokrato	aŭtokrat'o
aŭtokrateca	aŭtokrat'ec'a
aŭtokratio	aŭtokrat'i'o
aŭtokration	aŭtokrat'i'o'n
aŭtoktona	aŭtokton'a
aŭtoktonaj	aŭtokton'a'j
aŭtoktonoj	aŭtokton'o'j
automata	aŭtomat'a
aŭtomata	aŭtomat'a
aŭtomataj	aŭtomat'a'j
aŭtomatajn	aŭtomat'a'j'n
aŭtomatan	aŭtomat'a'n
automate	aŭtomat'e
aŭtomate	aŭtomat'e
aŭtomato	aŭtomat'o
aŭtomatoj	aŭtomat'o'j
aŭtomaton	aŭtomat'o'n
aŭtomatigi	aŭtomat'ig'i
aŭtomatigis	aŭtomat'ig'is
aŭtomatigo	aŭtomat'ig'o
aŭtomatigon	aŭtomat'ig'o'n
aŭtomatigita	aŭtomat'ig'it'a
aŭtomatigitaj	aŭtomat'ig'it'a'j
aŭtomatigitajn	aŭtomat'ig'it'a'j'n
aŭtomatigitan	aŭtomat'ig'it'a'n
aŭtomatismo	aŭtomat'ism'o
aŭtomobila	aŭtomobil'a
aŭtomobilaj	aŭtomobil'a'j
aŭtomobilan	aŭtomobil'a'n
aŭtomobile	aŭtomobil'e
aŭtomobilo	aŭtomobil'o
aŭtomobiloj	aŭtomobil'o'j
aŭtomobilojn	aŭtomobil'o'j'n
aŭtomobilon	aŭtomobil'o'n
aŭtomobilisto	aŭtomobil'ist'o
aŭtomobilistoj	aŭtomobil'ist'o'j
aŭtonoma	aŭtonom'a
aŭtonomaj	aŭtonom'a'j
aŭtonomajn	aŭtonom'a'j'n
aŭtonoman	aŭtonom'a'n
aŭtonome	aŭtonom'e
aŭtonomeco	aŭtonom'ec'o
aŭtonomecon	aŭtonom'ec'o'n
aŭtonomia	aŭtonom'i'a
aŭtonomiaj	aŭtonom'i'a'j
aŭtonomian	aŭtonom'i'a'n
aŭtonomio	aŭtonom'i'o
aŭtonomion	aŭtonom'i'o'n
aŭtora	aŭtor'a
aŭtoraj	aŭtor'a'j
aŭtorajn	aŭtor'a'j'n
aŭtoran	aŭtor'a'n
aŭtoris	aŭtor'is
autoro	aŭtor'o
aŭtoro	aŭtor'o
autoroj	aŭtor'o'j
aŭtoroj	aŭtor'o'j
aŭtorojn	aŭtor'o'j'n
autoron	aŭtor'o'n
aŭtoron	aŭtor'o'n
aŭtoreco	aŭtor'ec'o
aŭtorecon	aŭtor'ec'o'n
aŭtorino	aŭtor'in'o
aŭtorrajta	aŭtor'rajt'a
aŭtorrajto	aŭtor'rajt'o
aŭtorrajtoj	aŭtor'rajt'o'j
aŭtorrajtojn	aŭtor'rajt'o'j'n
aŭtoritata	aŭtoritat'a
aŭtoritataj	aŭtoritat'a'j
aŭtoritatajn	aŭtoritat'a'j'n
aŭtoritatan	aŭtoritat'a'n
aŭtoritatas	aŭtoritat'as
aŭtoritate	aŭtoritat'e
autoritato	aŭtoritat'o
aŭtoritato	aŭtoritat'o
autoritatoj	aŭtoritat'o'j
aŭtoritatoj	aŭtoritat'o'j
aŭtoritatojn	aŭtoritat'o'j'n
autoritaton	aŭtoritat'o'n
aŭtoritaton	aŭtoritat'o'n
aŭtoritateco	aŭtoritat'ec'o
aŭtoritatecon	aŭtoritat'ec'o'n
aŭtoritatema	aŭtoritat'em'a
aŭtoritatemaj	aŭtoritat'em'a'j
aŭtoritatemo	aŭtoritat'em'o
aŭtoritatisma	aŭtoritat'ism'a
aŭtoritatismo	aŭtoritat'ism'o
aŭtoritatulo	aŭtoritat'ul'o
autoritatuloj	aŭtoritat'ul'o'j
aŭtoritatuloj	aŭtoritat'ul'o'j
aŭtoritatulojn	aŭtoritat'ul'o'j'n
autuna	aŭtun'a
aŭtuna	aŭtun'a
aŭtunaj	aŭtun'a'j
aŭtunan	aŭtun'a'n
autune	aŭtun'e
aŭtune	aŭtun'e
autuno	aŭtun'o
aŭtuno	aŭtun'o
aŭtunoj	aŭtun'o'j
aŭtunon	aŭtun'o'n
aŭtunmeza	aŭtun'mez'a
aŭvernjo	aŭvernj'o
ava	av'a
ave	av'e
avo	av'o
avoj	av'o'j
avon	av'o'n
aveto	av'et'o
avino	av'in'o
avinoj	av'in'o'j
avinon	av'in'o'n
avineto	av'in'et'o
avalokiteŝvaro	avalokiteŝvar'o
avangarda	avan'gard'a
avangardaj	avan'gard'a'j
avangardajn	avan'gard'a'j'n
avangardan	avan'gard'a'n
avangardo	avan'gard'o
avangardoj	avan'gard'o'j
avangardon	avan'gard'o'n
avanulo	avan'ul'o
avancas	avanc'as
avanci	avanc'i
avancis	avanc'is
avanco	avanc'o
avancon	avanc'o'n
avancus	avanc'us
avancado	avanc'ad'o
avancadon	avanc'ad'o'n
avancanta	avanc'ant'a
avancante	avanc'ant'e
avancita	avanc'it'a
avancitaj	avanc'it'a'j
avanculo	avanc'ul'o
avanculon	avanc'ul'o'n
avantaĝa	avantaĝ'a
avantaĝaj	avantaĝ'a'j
avantaĝan	avantaĝ'a'n
avantaĝas	avantaĝ'as
avantaĝe	avantaĝ'e
avantagho	avantaĝ'o
avantaĝo	avantaĝ'o
avantaĝoj	avantaĝ'o'j
avantaĝojn	avantaĝ'o'j'n
avantaĝon	avantaĝ'o'n
avantaĝinterŝanĝo	avantaĝ'inter'ŝanĝ'o
avantaĝinterŝanĝoj	avantaĝ'inter'ŝanĝ'o'j
avantaĝinterŝanĝojn	avantaĝ'inter'ŝanĝ'o'j'n
avantaĝinterŝanĝon	avantaĝ'inter'ŝanĝ'o'n
avara	avar'a
avaraj	avar'a'j
avaras	avar'as
avare	avar'e
avaris	avar'is
avaro	avar'o
avaroj	avar'o'j
avareco	avar'ec'o
avarulo	avar'ul'o
avaruloj	avar'ul'o'j
avataro	avatar'o
avataroj	avatar'o'j
avatarojn	avatar'o'j'n
avataron	avatar'o'n
avĉjo	avĉj'o
avelo	avel'o
aveloj	avel'o'j
avelojn	avel'o'j'n
aveno	aven'o
avenon	aven'o'n
aventura	aventur'a
aventuraj	aventur'a'j
aventuran	aventur'a'n
aventuro	aventur'o
aventuroj	aventur'o'j
aventurojn	aventur'o'j'n
aventuron	aventur'o'n
aventurantoj	aventur'ant'o'j
aventurema	aventur'em'a
aventuremaj	aventur'em'a'j
aventuremo	aventur'em'o
aventuristo	aventur'ist'o
aventuristoj	aventur'ist'o'j
aventurludoj	aventur'lud'o'j
aventurulo	aventur'ul'o
avenue	avenu'e
avenuo	avenu'o
avenuoj	avenu'o'j
avenuojn	avenu'o'j'n
avenuon	avenu'o'n
averagha	averaĝ'a
averaĝa	averaĝ'a
averaĝaj	averaĝ'a'j
averaĝan	averaĝ'a'n
averaĝas	averaĝ'as
averaĝe	averaĝ'e
averaĝi	averaĝ'i
averaĝis	averaĝ'is
averaĝo	averaĝ'o
averaĝado	averaĝ'ad'o
averaĝita	averaĝ'it'a
averaĝitaj	averaĝ'it'a'j
averio	averi'o
averso	avers'o
averta	avert'a
avertaj	avert'a'j
avertan	avert'a'n
avertas	avert'as
averte	avert'e
averti	avert'i
avertis	avert'is
averto	avert'o
avertoj	avert'o'j
avertojn	avert'o'j'n
averton	avert'o'n
avertos	avert'os
avertu	avert'u
avertado	avert'ad'o
avertanta	avert'ant'a
avertantaj	avert'ant'a'j
avertantajn	avert'ant'a'j'n
avertantan	avert'ant'a'n
avertante	avert'ant'e
avertilo	avert'il'o
avertita	avert'it'a
avertitaj	avert'it'a'j
avertrimarko	avert'rimark'o
avesta	avest'a
avestan	avest'a'n
avesto	avest'o
avia	avi'a
avio	avi'o
avioj	avi'o'j
avion	avi'o'n
aviada	aviad'a
aviadaj	aviad'a'j
aviadan	aviad'a'n
aviadi	aviad'i
aviado	aviad'o
aviadon	aviad'o'n
aviadila	aviad'il'a
aviadilaj	aviad'il'a'j
aviadilajn	aviad'il'a'j'n
aviadilan	aviad'il'a'n
aviadile	aviad'il'e
aviadilo	aviad'il'o
aviadiloj	aviad'il'o'j
aviadilojn	aviad'il'o'j'n
aviadilon	aviad'il'o'n
aviadilskeleto	aviad'il'skelet'o
aviadilŝipo	aviad'il'ŝip'o
aviadilŝipoj	aviad'il'ŝip'o'j
aviadilŝipojn	aviad'il'ŝip'o'j'n
aviadisto	aviad'ist'o
aviadistoj	aviad'ist'o'j
aviadkompanio	aviad'kompani'o
aviadkompanioj	aviad'kompani'o'j
aviadkompaniojn	aviad'kompani'o'j'n
aviadkompanion	aviad'kompani'o'n
aviceno	avicen'o
avida	avid'a
avidaj	avid'a'j
avidas	avid'as
avide	avid'e
avidi	avid'i
avidis	avid'is
avido	avid'o
avidoj	avid'o'j
avidon	avid'o'n
avideco	avid'ec'o
avidecon	avid'ec'o'n
avidita	avid'it'a
avinjono	avinjon'o
avizo	aviz'o
avizoj	aviz'o'j
avizojn	aviz'o'j'n
avizon	aviz'o'n
avokado	avokad'o
azaleoj	azale'o'j
azena	azen'a
azeno	azen'o
azenoj	azen'o'j
azenojn	azen'o'j'n
azenon	azen'o'n
azeneto	azen'et'o
azera	azer'a
azeraj	azer'a'j
azeroj	azer'o'j
azerbajĝana	azerbajĝan'a
azerbajĝano	azerbajĝan'o
azerbajĝanon	azerbajĝan'o'n
azia	azi'a
aziaj	azi'a'j
aziajn	azi'a'j'n
azian	azi'a'n
azio	azi'o
azion	azi'o'n
aziano	azi'an'o
azianoj	azi'an'o'j
azianojn	azi'an'o'j'n
azipacifika	azi'pacifik'a
azido	azid'o
azilo	azil'o
azilon	azil'o'n
azilpetantoj	azil'pet'ant'o'j
azimuton	azimut'o'n
azoto	azot'o
azova	azov'a
azteka	aztek'a
aztekaj	aztek'a'j
aztekoj	aztek'o'j