cara	car'a
caraj	car'a'j
caran	car'a'n
care	car'e
caro	car'o
caroj	car'o'j
caron	car'o'n
carido	car'id'o
carino	car'in'o
carisma	car'ism'a
carismo	car'ism'o
carlevaro	carlevar'o
caruso	carus'o
ceda	ced'a
cedas	ced'as
cedi	ced'i
cedis	ced'is
cedo	ced'o
cedoj	ced'o'j
cedojn	ced'o'j'n
cedon	ced'o'n
cedos	ced'os
cedu	ced'u
cedus	ced'us
cedanta	ced'ant'a
cedantaj	ced'ant'a'j
cedante	ced'ant'e
cedema	ced'em'a
cedemaj	ced'em'a'j
cedemo	ced'em'o
cedita	ced'it'a
ceditaj	ced'it'a'j
cedro	cedr'o
cedroj	cedr'o'j
cefalopodoj	cefalopod'o'j
cefeo	cefe'o
cejana	cejan'a
cejano	cejan'o
cekumo	cekum'o
cela	cel'a
celaj	cel'a'j
celajn	cel'a'j'n
celan	cel'a'n
celas	cel'as
cele	cel'e
celi	cel'i
celis	cel'is
celo	cel'o
celoj	cel'o'j
celojn	cel'o'j'n
celon	cel'o'n
celos	cel'os
celu	cel'u
celus	cel'us
celado	cel'ad'o
celadoj	cel'ad'o'j
celadon	cel'ad'o'n
celanta	cel'ant'a
celantaj	cel'ant'a'j
celantajn	cel'ant'a'j'n
celantan	cel'ant'a'n
celante	cel'ant'e
celaro	cel'ar'o
celareo	cel'are'o
celata	cel'at'a
celataj	cel'at'a'j
celatan	cel'at'a'n
celgrupo	cel'grup'o
celgrupoj	cel'grup'o'j
celgrupon	cel'grup'o'n
celita	cel'it'a
celitaj	cel'it'a'j
celitajn	cel'it'a'j'n
celitan	cel'it'a'n
celite	cel'it'e
celkonforma	cel'konform'a
celkonformeco	cel'konform'ec'o
celkonscia	cel'konsci'a
celkonsciaj	cel'konsci'a'j
celkonscian	cel'konsci'a'n
celkonscie	cel'konsci'e
cellingvo	cel'lingv'o
celloko	cel'lok'o
cellokoj	cel'lok'o'j
cellokojn	cel'lok'o'j'n
cellokon	cel'lok'o'n
celmerkato	cel'merkat'o
celpubliko	cel'publik'o
celpunkto	cel'punkt'o
celtabulo	cel'tabul'o
celtrafa	cel'traf'a
celvarbi	cel'varb'i
celvarbis	cel'varb'is
celakantoj	celakant'o'j
celebra	celebr'a
celebras	celebr'as
celebri	celebr'i
celebris	celebr'is
celebro	celebr'o
celebroj	celebr'o'j
celebros	celebr'os
celebru	celebr'u
celebrado	celebr'ad'o
celebradoj	celebr'ad'o'j
celebradon	celebr'ad'o'n
celebrante	celebr'ant'e
celebranto	celebr'ant'o
celebrata	celebr'at'a
celebrataj	celebr'at'a'j
celebrita	celebr'it'a
celebritaj	celebr'it'a'j
celerio	celeri'o
celerion	celeri'o'n
celsia	celsi'a
celsiaj	celsi'a'j
celuloido	celuloid'o
celuloza	celuloz'a
celulozo	celuloz'o
celulozon	celuloz'o'n
cementa	cement'a
cementas	cement'as
cementi	cement'i
cementis	cement'is
cemento	cement'o
cementon	cement'o'n
cementita	cement'it'a
cementitaj	cement'it'a'j
cendo	cend'o
cendoj	cend'o'j
cendojn	cend'o'j'n
cendon	cend'o'n
censa	cens'a
censo	cens'o
censoj	cens'o'j
censon	cens'o'n
censoburoo	cens'o'buro'o
censodatumoj	cens'o'datum'o'j
cent	cent
centa	cent'a
centan	cent'a'n
centmil	cent'mil
cento	cent'o
centoj	cent'o'j
centojn	cent'o'j'n
centon	cent'o'n
centelcente	cent'el'cent'e
centestro	cent'estr'o
centestroj	cent'estr'o'j
centfoje	cent'foj'e
centjara	cent'jar'a
centjaraj	cent'jar'a'j
centjaran	cent'jar'a'n
centjaroj	cent'jar'o'j
centjariĝo	cent'jar'iĝ'o
centjariĝon	cent'jar'iĝ'o'n
centjaruloj	cent'jar'ul'o'j
centmetra	cent'metr'a
centmiloj	cent'mil'o'j
centmilojn	cent'mil'o'j'n
centmilionoj	cent'milion'o'j
centoble	cent'obl'e
centono	cent'on'o
centonoj	cent'on'o'j
centprocenta	cent'procent'a
centprocente	cent'procent'e
centaŭro	centaŭr'o
centaŭroj	centaŭr'o'j
centimetro	centi'metr'o
centimetroj	centi'metr'o'j
centimetrojn	centi'metr'o'j'n
centimetron	centi'metr'o'n
centimoj	centim'o'j
centimojn	centim'o'j'n
centimon	centim'o'n
centra	centr'a
centraj	centr'a'j
centrajn	centr'a'j'n
centran	centr'a'n
centras	centr'as
centre	centr'e
centri	centr'i
centris	centr'is
centro	centr'o
centroj	centr'o'j
centrojn	centr'o'j'n
centron	centr'o'n
centrafrika	centr'afrik'a
centrafriko	centr'afrik'o
centramerika	centr'amerik'a
centramerikaj	centr'amerik'a'j
centrameriko	centr'amerik'o
centraziaj	centr'azi'a'j
centrazio	centr'azi'o
centreco	centr'ec'o
centrecon	centr'ec'o'n
centreja	centr'ej'a
centrejo	centr'ej'o
centrejoj	centr'ej'o'j
centrejon	centr'ej'o'n
centreŭropaj	centr'eŭrop'a'j
centrigo	centr'ig'o
centrigita	centr'ig'it'a
centriĝas	centr'iĝ'as
centriĝis	centr'iĝ'is
centrisma	centr'ism'a
centrita	centr'it'a
centritaj	centr'it'a'j
centrovalo	centr'oval'o
centrala	central'a
centrale	central'e
centralo	central'o
centraloj	central'o'j
centralojn	central'o'j'n
centralon	central'o'n
centraligo	central'ig'o
centraligita	central'ig'it'a
centralismo	central'ism'o
centralizita	centraliz'it'a
centralizitan	centraliz'it'a'n
centrifuga	centrifug'a
centrifugaj	centrifug'a'j
centrifugan	centrifug'a'n
centrifugado	centrifug'ad'o
centrifugilo	centrifug'il'o
centrifugiloj	centrifug'il'o'j
centripeta	centripet'a
cenzura	cenzur'a
cenzuras	cenzur'as
cenzuri	cenzur'i
cenzuris	cenzur'is
cenzuro	cenzur'o
cenzuron	cenzur'o'n
cenzurado	cenzur'ad'o
cenzuristo	cenzur'ist'o
cenzuristoj	cenzur'ist'o'j
cenzurita	cenzur'it'a
cenzuritaj	cenzur'it'a'j
cepo	cep'o
cepoj	cep'o'j
cepojn	cep'o'j'n
cepon	cep'o'n
ceramika	ceramik'a
ceramikaj	ceramik'a'j
ceramikajn	ceramik'a'j'n
ceramikan	ceramik'a'n
ceramiko	ceramik'o
ceramikoj	ceramik'o'j
ceramikon	ceramik'o'n
ceramikaĵo	ceramik'aĵ'o
ceramikaĵoj	ceramik'aĵ'o'j
ceramikaĵojn	ceramik'aĵ'o'j'n
ceramikaĵon	ceramik'aĵ'o'n
ceramikisto	ceramik'ist'o
ceramikistoj	ceramik'ist'o'j
cerba	cerb'a
cerbaj	cerb'a'j
cerbajn	cerb'a'j'n
cerban	cerb'a'n
cerbe	cerb'e
cerbo	cerb'o
cerboj	cerb'o'j
cerbojn	cerb'o'j'n
cerbon	cerb'o'n
cerbaĵo	cerb'aĵ'o
cerbaktiveco	cerb'aktiv'ec'o
cerbaktivecon	cerb'aktiv'ec'o'n
cerbareoj	cerb'are'o'j
cerbbildigo	cerb'bild'ig'o
cerbĉeloj	cerb'ĉel'o'j
cerbeto	cerb'et'o
cerbofunkcio	cerb'o'funkci'o
cerbograndeco	cerb'o'grand'ec'o
cerbolavado	cerb'o'lav'ad'o
cerbolezo	cerb'o'lez'o
cerbolezon	cerb'o'lez'o'n
cerbospina	cerb'o'spin'a
cerbostimulo	cerb'o'stimul'o
cerbostrukturo	cerb'o'struktur'o
cerbostrukturoj	cerb'o'struktur'o'j
cerbotrunko	cerb'o'trunk'o
cerbregionoj	cerb'region'o'j
cerbumas	cerb'um'as
cerbumi	cerb'um'i
cerbumis	cerb'um'is
cerbumos	cerb'um'os
cerbumu	cerb'um'u
cerbumadis	cerb'um'ad'is
cerbumado	cerb'um'ad'o
cerbumadon	cerb'um'ad'o'n
cerbumante	cerb'um'ant'e
cerbero	cerber'o
cerealo	cereal'o
cerealoj	cereal'o'j
cerealojn	cereal'o'j'n
cerebela	cerebel'a
cerebelo	cerebel'o
ceremonia	ceremoni'a
ceremoniaj	ceremoni'a'j
ceremoniajn	ceremoni'a'j'n
ceremonian	ceremoni'a'n
ceremonie	ceremoni'e
ceremonio	ceremoni'o
ceremonioj	ceremoni'o'j
ceremoniojn	ceremoni'o'j'n
ceremonion	ceremoni'o'n
ceremoniaro	ceremoni'ar'o
ceremoniestro	ceremoni'estr'o
cerio	ceri'o
certa	cert'a
certaj	cert'a'j
certajn	cert'a'j'n
certan	cert'a'n
certas	cert'as
certe	cert'e
certi	cert'i
certis	cert'is
certo	cert'o
certu	cert'u
certus	cert'us
certagrada	cert'a'grad'a
certagrade	cert'a'grad'e
certasence	cert'a'senc'e
certaĵo	cert'aĵ'o
certeco	cert'ec'o
certecoj	cert'ec'o'j
certecon	cert'ec'o'n
certege	cert'eg'e
certiga	cert'ig'a
certigas	cert'ig'as
certigi	cert'ig'i
certigis	cert'ig'is
certigo	cert'ig'o
certigoj	cert'ig'o'j
certigon	cert'ig'o'n
certigos	cert'ig'os
certigu	cert'ig'u
certigus	cert'ig'us
certigado	cert'ig'ad'o
certiganta	cert'ig'ant'a
certigante	cert'ig'ant'e
certigata	cert'ig'at'a
certigita	cert'ig'it'a
certigitaj	cert'ig'it'a'j
certiĝas	cert'iĝ'as
certiĝi	cert'iĝ'i
certiĝis	cert'iĝ'is
certiĝos	cert'iĝ'os
certiĝu	cert'iĝ'u
certio	certi'o
cerva	cerv'a
cervo	cerv'o
cervoj	cerv'o'j
cervojn	cerv'o'j'n
cervon	cerv'o'n
cervedoj	cerv'ed'o'j
cervido	cerv'id'o
cervino	cerv'in'o
cervinoj	cerv'in'o'j
cervinon	cerv'in'o'n
cervoviando	cerv'o'viand'o
cerviko	cervik'o
cetacoj	cetac'o'j
cetera	ceter'a
ceteraj	ceter'a'j
ceterajn	ceter'a'j'n
ceteran	ceter'a'n
cetere	ceter'e
cetero	ceter'o
ceteron	ceter'o'n
ceteraĵoj	ceter'aĵ'o'j
cezara	cezar'a
cezaro	cezar'o
cezaroj	cezar'o'j
cezaron	cezar'o'n
cezareo	cezar'e'o
cezio	cezi'o
cezuro	cezur'o
ci	ci
cia	ci'a
ciaj	ci'a'j
cian	ci'a'n
cin	ci'n
ciumas	ci'um'as
cianato	cian'at'o
cianobakterioj	cian'o'bakteri'o'j
cianogena	cian'o'gen'a
cianamido	cianamid'o
cianida	cianid'a
cianido	cianid'o
cianidoj	cianid'o'j
cianidon	cianid'o'n
cibernetika	cibernetik'a
cibernetikaj	cibernetik'a'j
cibernetiko	cibernetik'o
ciberspaco	ciberspac'o
cibeto	cibet'o
cico	cic'o
cicoj	cic'o'j
cicojn	cic'o'j'n
cicero	cicer'o
cicerono	ciceron'o
ciceronon	ciceron'o'n
cidonio	cidoni'o
cidro	cidr'o
cidron	cidr'o'n
cifera	cifer'a
ciferaj	cifer'a'j
ciferan	cifer'a'n
cifero	cifer'o
ciferoj	cifer'o'j
ciferojn	cifer'o'j'n
ciferon	cifer'o'n
ciferdisko	cifer'disk'o
cifereca	cifer'ec'a
ciferecaj	cifer'ec'a'j
ciferecajn	cifer'ec'a'j'n
ciferecan	cifer'ec'a'n
ciferece	cifer'ec'e
ciferecaĵo	cifer'ec'aĵ'o
ciferecigi	cifer'ec'ig'i
ciferecigo	cifer'ec'ig'o
ciferecigita	cifer'ec'ig'it'a
ciferecigitaj	cifer'ec'ig'it'a'j
ciferplato	cifer'plat'o
ciferplatoj	cifer'plat'o'j
cigana	cigan'a
ciganaj	cigan'a'j
ciganan	cigan'a'n
cigano	cigan'o
ciganoj	cigan'o'j
ciganojn	cigan'o'j'n
ciganon	cigan'o'n
ciganino	cigan'in'o
cigaro	cigar'o
cigaroj	cigar'o'j
cigarojn	cigar'o'j'n
cigaron	cigar'o'n
cigareda	cigared'a
cigaredan	cigared'a'n
cigaredo	cigared'o
cigaredoj	cigared'o'j
cigaredojn	cigared'o'j'n
cigaredon	cigared'o'n
cigna	cign'a
cigno	cign'o
cignoj	cign'o'j
cignon	cign'o'n
cikado	cikad'o
cikadoj	cikad'o'j
cikatra	cikatr'a
cikatro	cikatr'o
cikatroj	cikatr'o'j
cikatrojn	cikatr'o'j'n
cikatron	cikatr'o'n
cikatriĝo	cikatr'iĝ'o
cikla	cikl'a
ciklaj	cikl'a'j
ciklajn	cikl'a'j'n
ciklan	cikl'a'n
cikle	cikl'e
ciklo	cikl'o
cikloj	cikl'o'j
ciklojn	cikl'o'j'n
ciklon	cikl'o'n
cikladoj	ciklad'o'j
ciklono	ciklon'o
ciklonoj	ciklon'o'j
ciklonon	ciklon'o'n
ciklopo	ciklop'o
ciklopoj	ciklop'o'j
ciklotrono	ciklotron'o
cikonia	cikoni'a
cikonio	cikoni'o
cikonioj	cikoni'o'j
cikonion	cikoni'o'n
cikorio	cikori'o
cikuto	cikut'o
cilindra	cilindr'a
cilindraj	cilindr'a'j
cilindrajn	cilindr'a'j'n
cilindran	cilindr'a'n
cilindro	cilindr'o
cilindroj	cilindr'o'j
cilindrojn	cilindr'o'j'n
cilindron	cilindr'o'n
cilindroforma	cilindr'o'form'a
cima	cim'a
cimo	cim'o
cimoj	cim'o'j
cimojn	cim'o'j'n
cimon	cim'o'n
cimbalo	cimbal'o
cimbaloj	cimbal'o'j
cimbalojn	cimbal'o'j'n
cinabro	cinabr'o
cinamo	cinam'o
cinamon	cinam'o'n
cinamaldehido	cinam'aldehid'o
cinamata	cinam'at'a
cinamato	cinam'at'o
cinamujoj	cinam'uj'o'j
cindra	cindr'a
cindraj	cindr'a'j
cindro	cindr'o
cindroj	cindr'o'j
cindrojn	cindr'o'j'n
cindron	cindr'o'n
cindrigita	cindr'ig'it'a
cindrogriza	cindr'o'griz'a
cindrotinamo	cindr'o'tinam'o
cindrujo	cindr'uj'o
cindrujon	cindr'uj'o'n
cindrulino	cindr'ul'in'o
cindrulinon	cindr'ul'in'o'n
cingulkortekso	cingul'korteks'o
cinika	cinik'a
cinikaj	cinik'a'j
cinikan	cinik'a'n
cinike	cinik'e
cinikeco	cinik'ec'o
cinikismo	cinik'ism'o
cinikulo	cinik'ul'o
cinikuloj	cinik'ul'o'j
cinomuso	cinomus'o
cinomusoj	cinomus'o'j
ciono	cion'o
cionisma	cion'ism'a
cionismaj	cion'ism'a'j
cionisman	cion'ism'a'n
cionismo	cion'ism'o
cionismon	cion'ism'o'n
cionista	cion'ist'a
cionisto	cion'ist'o
cionistoj	cion'ist'o'j
ciperacoj	ciperac'o'j
cipro	cipr'o
cipresa	cipres'a
cipreso	cipres'o
cipresoj	cipres'o'j
cipriano	ciprian'o
ciro	cir'o
ciron	cir'o'n
cirila	ciril'a
cirilaj	ciril'a'j
cirilan	ciril'a'n
cirile	ciril'e
cirilo	ciril'o
cirka	cirk'a
cirkaj	cirk'a'j
cirko	cirk'o
cirkoj	cirk'o'j
cirkon	cirk'o'n
cirkelo	cirkel'o
cirkla	cirkl'a
cirklaj	cirkl'a'j
cirklajn	cirkl'a'j'n
cirklan	cirkl'a'n
cirkle	cirkl'e
cirklo	cirkl'o
cirkloj	cirkl'o'j
cirklojn	cirkl'o'j'n
cirklon	cirkl'o'n
cirkonferenco	cirkonferenc'o
cirkonstanco	cirkonstanc'o
cirkonstancoj	cirkonstanc'o'j
cirkonstancojn	cirkonstanc'o'j'n
cirkonstancon	cirkonstanc'o'n
cirkonstancaro	cirkonstanc'ar'o
cirkuo	cirku'o
cirkuoj	cirku'o'j
cirkula	cirkul'a
cirkulaj	cirkul'a'j
cirkulan	cirkul'a'n
cirkulas	cirkul'as
cirkuli	cirkul'i
cirkulis	cirkul'is
cirkulado	cirkul'ad'o
cirkuladoj	cirkul'ad'o'j
cirkuladon	cirkul'ad'o'n
cirkulanta	cirkul'ant'a
cirkulantaj	cirkul'ant'a'j
cirkulante	cirkul'ant'e
cirkuligis	cirkul'ig'is
cirkulita	cirkul'it'a
cirkulitaj	cirkul'it'a'j
cirkulero	cirkuler'o
cirkuleroj	cirkuler'o'j
cirkulerojn	cirkuler'o'j'n
cirkuleron	cirkuler'o'n
cirkumcido	cirkumcid'o
cirkumcidon	cirkumcid'o'n
cirkumcidita	cirkumcid'it'a
cirkumflekso	cirkumfleks'o
cirkumflekson	cirkumfleks'o'n
cirkvita	cirkvit'a
cirkvitaj	cirkvit'a'j
cirkvito	cirkvit'o
cirkvitoj	cirkvit'o'j
cirkvitojn	cirkvit'o'j'n
cirkviton	cirkvit'o'n
cirkvitplateno	cirkvit'platen'o
cirkvitplatenoj	cirkvit'platen'o'j
cirozo	ciroz'o
ciruso	cirus'o
cisterno	cistern'o
cisternoj	cistern'o'j
cisternon	cistern'o'n
citas	cit'as
citi	cit'i
citis	cit'is
cito	cit'o
citoj	cit'o'j
citos	cit'os
citu	cit'u
citado	cit'ad'o
citaĵo	cit'aĵ'o
citaĵoj	cit'aĵ'o'j
citaĵojn	cit'aĵ'o'j'n
citaĵon	cit'aĵ'o'n
citanta	cit'ant'a
citante	cit'ant'e
citata	cit'at'a
citataj	cit'at'a'j
citiloj	cit'il'o'j
citilojn	cit'il'o'j'n
citita	cit'it'a
cititaj	cit'it'a'j
cititajn	cit'it'a'j'n
cititan	cit'it'a'n
citite	cit'it'e
citadelo	citadel'o
citadeloj	citadel'o'j
citadelon	citadel'o'n
citadelestro	citadel'estr'o
citokromo	citokrom'o
citoplasma	citoplasm'a
citoplasmo	citoplasm'o
citoplasmon	citoplasm'o'n
citosolo	citosol'o
citozino	citozin'o
citro	citr'o
citrata	citr'at'a
citrato	citr'at'o
citrona	citron'a
citronan	citron'a'n
citrono	citron'o
citronoj	citron'o'j
citronojn	citron'o'j'n
citronon	citron'o'n
citronarbo	citron'arb'o
citronsuko	citron'suk'o
citruso	citrus'o
citrusoj	citrus'o'j
civila	civil'a
civilaj	civil'a'j
civilajn	civil'a'j'n
civilan	civil'a'n
civile	civil'e
civilkodeksaj	civil'kodeks'a'j
civiltumulto	civil'tumult'o
civilulo	civil'ul'o
civiluloj	civil'ul'o'j
civilulojn	civil'ul'o'j'n
civilvivo	civil'viv'o
civiliza	civiliz'a
civilizo	civiliz'o
civilizoj	civiliz'o'j
civilizojn	civiliz'o'j'n
civilizon	civiliz'o'n
civilizita	civiliz'it'a
civilizitaj	civiliz'it'a'j
civilizitan	civiliz'it'a'n
civilizacia	civilizaci'a
civilizacian	civilizaci'a'n
civilizacio	civilizaci'o
civilizacioj	civilizaci'o'j
civilizaciojn	civilizaci'o'j'n
civilizacion	civilizaci'o'n
civita	civit'a
civitaj	civit'a'j
civitajn	civit'a'j'n
civitan	civit'a'n
civitas	civit'as
civito	civit'o
civitoj	civit'o'j
civiton	civit'o'n
civitana	civit'an'a
civitanaj	civit'an'a'j
civitanajn	civit'an'a'j'n
civitanan	civit'an'a'n
civitano	civit'an'o
civitanoj	civit'an'o'j
civitanojn	civit'an'o'j'n
civitanon	civit'an'o'n
civitanaro	civit'an'ar'o
civitaneco	civit'an'ec'o
civitanecon	civit'an'ec'o'n
civitaniĝo	civit'an'iĝ'o
civitanino	civit'an'in'o
civitaninoj	civit'an'in'o'j
civitanismo	civit'an'ism'o
civitanrajta	civit'an'rajt'a
civitanrajtaj	civit'an'rajt'a'j
civitanrajtoj	civit'an'rajt'o'j
civitanrajtojn	civit'an'rajt'o'j'n
civitismo	civit'ism'o
civitmilita	civit'milit'a
cola	col'a
cole	col'e
colo	col'o
coloj	col'o'j
colojn	col'o'j'n
colon	col'o'n
cumoj	cum'o'j
cunamo	cunam'o
cunamoj	cunam'o'j
cunamon	cunam'o'n