da	da
dadaismo	dadaism'o
dafno	dafn'o
dagon	dag'o'n
dagestano	dagestan'o
daimio	daimi'o
dajmonoj	dajmon'o'j
dakio	dak'i'o
dakaro	dakar'o
dakota	dakot'a
dakoto	dakot'o
daktila	daktil'a
daktilo	daktil'o
daktiloj	daktil'o'j
daktilojn	daktil'o'j'n
dalailamao	dalailama'o
dalailamaoj	dalailama'o'j
dalailamaon	dalailama'o'n
dalian	dali'a'n
dalmata	dalmat'a
dalmatio	dalmat'i'o
dalmatiko	dalmatik'o
dama	dam'a
daman	dam'a'n
dame	dam'e
damo	dam'o
damoj	dam'o'j
damon	dam'o'n
damino	dam'in'o
damaino	dama'in'o
damaĝa	damaĝ'a
damaĝaj	damaĝ'a'j
damaĝajn	damaĝ'a'j'n
damaĝan	damaĝ'a'n
damaĝas	damaĝ'as
damaĝe	damaĝ'e
damaĝi	damaĝ'i
damaĝis	damaĝ'is
damaĝo	damaĝ'o
damaĝoj	damaĝ'o'j
damaĝojn	damaĝ'o'j'n
damaĝon	damaĝ'o'n
damaĝos	damaĝ'os
damaĝu	damaĝ'u
damaĝus	damaĝ'us
damaĝado	damaĝ'ad'o
damaĝante	damaĝ'ant'e
damaĝata	damaĝ'at'a
damaĝataj	damaĝ'at'a'j
damaĝbestoj	damaĝ'best'o'j
damaĝbestojn	damaĝ'best'o'j'n
damaĝita	damaĝ'it'a
damaĝitaj	damaĝ'it'a'j
damaĝitajn	damaĝ'it'a'j'n
damaĝitan	damaĝ'it'a'n
damaska	damask'a
damasko	damask'o
damaskon	damask'o'n
damiano	damian'o
damna	damn'a
damne	damn'e
damnis	damn'is
damno	damn'o
damnu	damn'u
damninda	damn'ind'a
damninde	damn'ind'e
damnita	damn'it'a
damnitaj	damn'it'a'j
damnitan	damn'it'a'n
damnito	damn'it'o
dampas	damp'as
dampi	damp'i
dampilo	damp'il'o
dampiloj	damp'il'o'j
dampita	damp'it'a
dana	dan'a
danaj	dan'a'j
danajn	dan'a'j'n
danan	dan'a'n
dane	dan'e
dano	dan'o
danoj	dan'o'j
danojn	dan'o'j'n
danon	dan'o'n
dania	dan'i'a
danian	dan'i'a'n
danio	dan'i'o
danion	dan'i'o'n
danlando	dan'land'o
danujo	dan'uj'o
danae	dana'e
danao	dana'o
danaidinoj	dana'id'in'o'j
danca	danc'a
dancaj	danc'a'j
dancan	danc'a'n
dancas	danc'as
dance	danc'e
danci	danc'i
dancis	danc'is
danco	danc'o
dancoj	danc'o'j
dancojn	danc'o'j'n
dancon	danc'o'n
dancos	danc'os
dancu	danc'u
dancus	danc'us
dancadis	danc'ad'is
dancado	danc'ad'o
dancadon	danc'ad'o'n
dancanta	danc'ant'a
dancantaj	danc'ant'a'j
dancantajn	danc'ant'a'j'n
dancantan	danc'ant'a'n
dancante	danc'ant'e
dancanto	danc'ant'o
dancantoj	danc'ant'o'j
dancantojn	danc'ant'o'j'n
dancarto	danc'art'o
dancdramo	danc'dram'o
dancejo	danc'ej'o
dancejoj	danc'ej'o'j
dancejon	danc'ej'o'n
dancformo	danc'form'o
dancigis	danc'ig'is
dancigo	danc'ig'o
dancisto	danc'ist'o
dancistoj	danc'ist'o'j
dancistojn	danc'ist'o'j'n
dancistino	danc'ist'in'o
dancistinoj	danc'ist'in'o'j
dancita	danc'it'a
dancmovoj	danc'mov'o'j
dancmuziko	danc'muzik'o
dancigo	dancig'o
danda	dand'a
dando	dand'o
dandoj	dand'o'j
danĝera	danĝer'a
danĝeraj	danĝer'a'j
danĝerajn	danĝer'a'j'n
danĝeran	danĝer'a'n
danĝeras	danĝer'as
danĝere	danĝer'e
danĝero	danĝer'o
danĝeroj	danĝer'o'j
danĝerojn	danĝer'o'j'n
danĝeron	danĝer'o'n
danĝereco	danĝer'ec'o
danĝerega	danĝer'eg'a
danĝernivele	danĝer'nivel'e
daniela	daniel'a
danielo	daniel'o
danielon	daniel'o'n
danka	dank'a
dankaj	dank'a'j
dankas	dank'as
danke	dank'e
danki	dank'i
dankis	dank'is
danko	dank'o
dankoj	dank'o'j
dankojn	dank'o'j'n
dankon	dank'o'n
dankos	dank'os
danku	dank'u
dankus	dank'us
dankante	dank'ant'e
dankegas	dank'eg'as
dankegon	dank'eg'o'n
dankema	dank'em'a
dankemaj	dank'em'a'j
dankemas	dank'em'as
dankeme	dank'em'e
dankemo	dank'em'o
dankemon	dank'em'o'n
dankesprimo	dank'esprim'o
dankesprimon	dank'esprim'o'n
dankinda	dank'ind'a
dankindas	dank'ind'as
dankinde	dank'ind'e
dankinte	dank'int'e
dankleteron	dank'leter'o'n
danuba	danub'a
danubo	danub'o
danubon	danub'o'n
darmo	darm'o
darmoj	darm'o'j
darmon	darm'o'n
data	dat'a
datan	dat'a'n
datas	dat'as
dati	dat'i
datis	dat'is
dato	dat'o
datoj	dat'o'j
datojn	dat'o'j'n
daton	dat'o'n
datu	dat'u
datado	dat'ad'o
datanta	dat'ant'a
datantaj	dat'ant'a'j
datante	dat'ant'e
datigo	dat'ig'o
datiĝas	dat'iĝ'as
datita	dat'it'a
datitaj	dat'it'a'j
datrevenan	dat're'ven'a'n
datreveno	dat're'ven'o
datrevenoj	dat're'ven'o'j
datrevenojn	dat're'ven'o'j'n
datrevenon	dat're'ven'o'n
datrilatas	dat'rilat'as
datuma	dat'um'a
datumaj	dat'um'a'j
datuman	dat'um'a'n
datumas	dat'um'as
datumo	dat'um'o
datumoj	dat'um'o'j
datumojn	dat'um'o'j'n
datumon	dat'um'o'n
datumaro	dat'um'ar'o
datumaroj	dat'um'ar'o'j
datumbaza	dat'um'baz'a
datumbazo	dat'um'baz'o
datumbazoj	dat'um'baz'o'j
datumbazojn	dat'um'baz'o'j'n
datumbazon	dat'um'baz'o'n
datumfluo	dat'um'flu'o
datuminterŝanĝo	dat'um'inter'ŝanĝ'o
datummodelo	dat'um'model'o
datummodeloj	dat'um'model'o'j
datummodelon	dat'um'model'o'n
datumserio	dat'um'seri'o
datumserioj	dat'um'seri'o'j
datumseriojn	dat'um'seri'o'j'n
datumstokado	dat'um'stok'ad'o
datumstrukturo	dat'um'struktur'o
datumstrukturoj	dat'um'struktur'o'j
datumtipo	dat'um'tip'o
datumtipojn	dat'um'tip'o'j'n
datumtraktado	dat'um'trakt'ad'o
datumtransigo	dat'um'trans'ig'o
datumtranssendo	dat'um'trans'send'o
datenajn	daten'a'j'n
dateno	daten'o
datenoj	daten'o'j
datenojn	daten'o'j'n
datenaro	daten'ar'o
datenbanko	daten'bank'o
datenbankoj	daten'bank'o'j
datenbazo	daten'baz'o
datencentro	daten'centr'o
datencentroj	daten'centr'o'j
datenfontoj	daten'font'o'j
datenkolektado	daten'kolekt'ad'o
datenminado	daten'min'ad'o
datenobjektoj	daten'objekt'o'j
datenpunkto	daten'punkt'o
datenpunktoj	daten'punkt'o'j
datenrapideco	daten'rapid'ec'o
datenrapidecoj	daten'rapid'ec'o'j
datenserio	daten'seri'o
datenserioj	daten'seri'o'j
datenstrukturo	daten'struktur'o
datenstrukturoj	daten'struktur'o'j
datenstrukturojn	daten'struktur'o'j'n
datentipo	daten'tip'o
datentipoj	daten'tip'o'j
datenvaloroj	daten'valor'o'j
dativo	dativ'o
dativon	dativ'o'n
dativobjekto	dativ'objekt'o
datuma	datum'a
datumaj	datum'a'j
datuman	datum'a'n
datumo	datum'o
datumoj	datum'o'j
datumojn	datum'o'j'n
datumon	datum'o'n
datumaro	datum'ar'o
datumaroj	datum'ar'o'j
daŭfeno	daŭfen'o
daŭra	daŭr'a
daŭraj	daŭr'a'j
daŭrajn	daŭr'a'j'n
daŭran	daŭr'a'n
daŭras	daŭr'as
daŭre	daŭr'e
daŭri	daŭr'i
daŭris	daŭr'is
daŭro	daŭr'o
daŭroj	daŭr'o'j
daŭron	daŭr'o'n
daŭros	daŭr'os
daŭru	daŭr'u
daŭrus	daŭr'us
daŭradas	daŭr'ad'as
daŭradis	daŭr'ad'is
daŭrado	daŭr'ad'o
daŭranta	daŭr'ant'a
daŭrantaj	daŭr'ant'a'j
daŭrantajn	daŭr'ant'a'j'n
daŭrantan	daŭr'ant'a'n
daŭrante	daŭr'ant'e
daŭreco	daŭr'ec'o
daŭrema	daŭr'em'a
daŭremaj	daŭr'em'a'j
daŭreman	daŭr'em'a'n
daŭripova	daŭr'i'pov'a
daŭripovan	daŭr'i'pov'a'n
daŭripovo	daŭr'i'pov'o
daŭripovon	daŭr'i'pov'o'n
daŭriga	daŭr'ig'a
daŭrigaj	daŭr'ig'a'j
daŭrigan	daŭr'ig'a'n
daŭrigas	daŭr'ig'as
daŭrigi	daŭr'ig'i
daŭrigis	daŭr'ig'is
daŭrigo	daŭr'ig'o
daŭrigoj	daŭr'ig'o'j
daŭrigojn	daŭr'ig'o'j'n
daŭrigon	daŭr'ig'o'n
daŭrigos	daŭr'ig'os
daŭrigu	daŭr'ig'u
daŭrigus	daŭr'ig'us
daŭrigado	daŭr'ig'ad'o
daŭriganta	daŭr'ig'ant'a
daŭrigantaj	daŭr'ig'ant'a'j
daŭrigante	daŭr'ig'ant'e
daŭriganto	daŭr'ig'ant'o
daŭrigata	daŭr'ig'at'a
daŭrigebla	daŭr'ig'ebl'a
daŭrigeblaj	daŭr'ig'ebl'a'j
daŭrigeblajn	daŭr'ig'ebl'a'j'n
daŭrigeblan	daŭr'ig'ebl'a'n
daŭrigeble	daŭr'ig'ebl'e
daŭrigebleco	daŭr'ig'ebl'ec'o
daŭrigeblecon	daŭr'ig'ebl'ec'o'n
daŭrigita	daŭr'ig'it'a
daŭrigitaj	daŭr'ig'it'a'j
daŭrigota	daŭr'ig'ot'a
daŭriĝas	daŭr'iĝ'as
daŭriĝi	daŭr'iĝ'i
daŭriĝis	daŭr'iĝ'is
daŭriĝos	daŭr'iĝ'os
daŭriĝus	daŭr'iĝ'us
daŭriĝanta	daŭr'iĝ'ant'a
daŭrinta	daŭr'int'a
davida	david'a
davido	david'o
davidon	david'o'n
de	de
depost	de'post
desur	de'sur
deĉevaliĝis	de'ĉeval'iĝ'is
deekstere	de'ekster'e
defalas	de'fal'as
defali	de'fal'i
defalis	de'fal'is
defalo	de'fal'o
defalaĵoj	de'fal'aĵ'o'j
defalinta	de'fal'int'a
defalintaj	de'fal'int'a'j
defalinto	de'fal'int'o
defalintoj	de'fal'int'o'j
deflanke	de'flank'e
deflankiĝas	de'flank'iĝ'as
deflankiĝi	de'flank'iĝ'i
deflankiĝis	de'flank'iĝ'is
deflankiĝo	de'flank'iĝ'o
deflankiĝoj	de'flank'iĝ'o'j
defluas	de'flu'as
defluis	de'flu'is
defluilo	de'flu'il'o
defluiloj	de'flu'il'o'j
deformado	de'form'ad'o
deformadoj	de'form'ad'o'j
deformadojn	de'form'ad'o'j'n
deformadon	de'form'ad'o'n
deformebla	de'form'ebl'a
deformiĝo	de'form'iĝ'o
deformita	de'form'it'a
deformitaj	de'form'it'a'j
degaso	de'gas'o
degason	de'gas'o'n
degasrapideco	de'gas'rapid'ec'o
deglitas	de'glit'as
degliti	de'glit'i
deglitis	de'glit'is
deglito	de'glit'o
dehakas	de'hak'as
dehaki	de'hak'i
dehakis	de'hak'is
dehakitaj	de'hak'it'a'j
dehidratiĝo	de'hidrat'iĝ'o
dehidratiĝon	de'hidrat'iĝ'o'n
deiĝis	de'iĝ'is
deinfanaĝa	de'infan'aĝ'a
deinfanece	de'infan'ec'e
deinterne	de'intern'e
deiras	de'ir'as
deiri	de'ir'i
deiris	de'ir'is
deiru	de'ir'u
deirante	de'ir'ant'e
deirinte	de'ir'int'e
deirpunkto	de'ir'punkt'o
deirpunkton	de'ir'punkt'o'n
deĵetas	de'ĵet'as
deĵeti	de'ĵet'i
deĵetis	de'ĵet'is
deĵetado	de'ĵet'ad'o
deĵetante	de'ĵet'ant'e
deĵetita	de'ĵet'it'a
deĵetitaj	de'ĵet'it'a'j
deklino	de'klin'o
deklinon	de'klin'o'n
dekliniĝas	de'klin'iĝ'as
dekliniĝo	de'klin'iĝ'o
dekomenca	de'komenc'a
dekomencaj	de'komenc'a'j
dekomence	de'komenc'e
dekroĉi	de'kroĉ'i
dekroĉis	de'kroĉ'is
dekroĉita	de'kroĉ'it'a
dekroĉitaj	de'kroĉ'it'a'j
dekutimigitaj	de'kutim'ig'it'a'j
delasi	de'las'i
delasis	de'las'is
deloga	de'log'a
delogas	de'log'as
delogi	de'log'i
delogis	de'log'is
delogo	de'log'o
delogita	de'log'it'a
delogitaj	de'log'it'a'j
deloki	de'lok'i
delokigas	de'lok'ig'as
delokigi	de'lok'ig'i
delokigis	de'lok'ig'is
delokigo	de'lok'ig'o
delokigoj	de'lok'ig'o'j
delokigante	de'lok'ig'ant'e
delokigita	de'lok'ig'it'a
delokigitaj	de'lok'ig'it'a'j
delokiĝo	de'lok'iĝ'o
delokiĝon	de'lok'iĝ'o'n
delokita	de'lok'it'a
delokitaj	de'lok'it'a'j
delonga	de'long'a
delongaj	de'long'a'j
delongan	de'long'a'n
delonge	de'long'e
demalproksima	de'mal'proksim'a
demalproksime	de'mal'proksim'e
demalsupre	de'mal'supr'e
demetas	de'met'as
demeti	de'met'i
demetis	de'met'is
demeto	de'met'o
demetos	de'met'os
demetu	de'met'u
demetado	de'met'ad'o
demetaĵoj	de'met'aĵ'o'j
demetaĵojn	de'met'aĵ'o'j'n
demetante	de'met'ant'e
demetataj	de'met'at'a'j
demetinte	de'met'int'e
demetita	de'met'it'a
demetitaj	de'met'it'a'j
demordis	de'mord'is
denaska	de'nask'a
denaskaj	de'nask'a'j
denaskajn	de'nask'a'j'n
denaskan	de'nask'a'n
denaske	de'nask'e
denaskulo	de'nask'ul'o
denaskuloj	de'nask'ul'o'j
denova	de'nov'a
denovan	de'nov'a'n
denove	de'nov'e
depaŝis	de'paŝ'is
dependa	de'pend'a
dependaj	de'pend'a'j
dependajn	de'pend'a'j'n
dependan	de'pend'a'n
dependas	de'pend'as
depende	de'pend'e
dependi	de'pend'i
dependis	de'pend'is
dependo	de'pend'o
dependon	de'pend'o'n
dependos	de'pend'os
dependu	de'pend'u
dependus	de'pend'us
dependado	de'pend'ad'o
dependanta	de'pend'ant'a
dependantaj	de'pend'ant'a'j
dependantan	de'pend'ant'a'n
dependante	de'pend'ant'e
dependanto	de'pend'ant'o
dependantoj	de'pend'ant'o'j
dependeco	de'pend'ec'o
dependecoj	de'pend'ec'o'j
dependecojn	de'pend'ec'o'j'n
dependecon	de'pend'ec'o'n
dependiga	de'pend'ig'a
dependigas	de'pend'ig'as
dependigita	de'pend'ig'it'a
dependigitaj	de'pend'ig'it'a'j
dependogramatikoj	de'pend'o'gramatik'o'j
depostulas	de'postul'as
depostuli	de'postul'i
deprenas	de'pren'as
depreni	de'pren'i
deprenis	de'pren'is
depreno	de'pren'o
deprenoj	de'pren'o'j
deprenon	de'pren'o'n
deprenos	de'pren'os
deprenu	de'pren'u
deprenante	de'pren'ant'e
deprenita	de'pren'it'a
deprenitaj	de'pren'it'a'j
deproksima	de'proksim'a
deproksime	de'proksim'e
deprunti	de'prunt'i
depruntis	de'prunt'is
depuŝis	de'puŝ'is
deradike	de'radik'e
dereguligo	de'regul'ig'o
derompas	de'romp'as
derompi	de'romp'i
derompis	de'romp'is
derompaĵoj	de'romp'aĵ'o'j
derompaĵojn	de'romp'aĵ'o'j'n
derompiĝis	de'romp'iĝ'is
deruliĝis	de'rul'iĝ'is
desalti	de'salt'i
desaltis	de'salt'is
deŝiras	de'ŝir'as
deŝiri	de'ŝir'i
deŝiris	de'ŝir'is
deŝiradis	de'ŝir'ad'is
deŝirante	de'ŝir'ant'e
deŝiriĝis	de'ŝir'iĝ'is
deŝirita	de'ŝir'it'a
deŝovis	de'ŝov'is
deŝovo	de'ŝov'o
deŝoviĝis	de'ŝov'iĝ'is
desuba	de'sub'a
desube	de'sub'e
desubisma	de'sub'ism'a
desubismo	de'sub'ism'o
desupra	de'supr'a
desupraj	de'supr'a'j
desupran	de'supr'a'n
desupre	de'supr'e
desuprisma	de'supr'ism'a
desuprismo	de'supr'ism'o
detenas	de'ten'as
deteni	de'ten'i
detenis	de'ten'is
detenos	de'ten'os
detenu	de'ten'u
detenata	de'ten'at'a
detenataj	de'ten'at'a'j
deteniĝema	de'ten'iĝ'em'a
detenita	de'ten'it'a
detenitaj	de'ten'it'a'j
deteriĝo	de'ter'iĝ'o
deteriĝon	de'ter'iĝ'o'n
detiris	de'tir'is
detranĉas	de'tranĉ'as
detranĉi	de'tranĉ'i
detranĉis	de'tranĉ'is
detranĉo	de'tranĉ'o
detranĉado	de'tranĉ'ad'o
detranĉita	de'tranĉ'it'a
detranĉitaj	de'tranĉ'it'a'j
detronigi	de'tron'ig'i
detronigis	de'tron'ig'is
detronigo	de'tron'ig'o
deturnas	de'turn'as
deturni	de'turn'i
deturnis	de'turn'is
deturnante	de'turn'ant'e
deturniĝas	de'turn'iĝ'as
deturniĝi	de'turn'iĝ'i
deturniĝis	de'turn'iĝ'is
deturniĝo	de'turn'iĝ'o
deturnita	de'turn'it'a
deturnitaj	de'turn'it'a'j
devaga	de'vag'a
devagaj	de'vag'a'j
devagas	de'vag'as
devena	de'ven'a
devenaj	de'ven'a'j
devenajn	de'ven'a'j'n
devenan	de'ven'a'n
devenas	de'ven'as
devene	de'ven'e
deveni	de'ven'i
devenis	de'ven'is
deveno	de'ven'o
devenoj	de'ven'o'j
devenojn	de'ven'o'j'n
devenon	de'ven'o'n
devenos	de'ven'os
devenus	de'ven'us
devenado	de'ven'ad'o
devenanta	de'ven'ant'a
devenantaj	de'ven'ant'a'j
devenantajn	de'ven'ant'a'j'n
devenantan	de'ven'ant'a'n
devenante	de'ven'ant'e
devenantoj	de'ven'ant'o'j
devenigas	de'ven'ig'as
devenigi	de'ven'ig'i
devenigis	de'ven'ig'is
deveninta	de'ven'int'a
devenintaj	de'ven'int'a'j
devenitaj	de'ven'it'a'j
devenlando	de'ven'land'o
devojigi	de'voj'ig'i
devojigis	de'voj'ig'is
devojiĝis	de'voj'iĝ'is
devojiĝoj	de'voj'iĝ'o'j
debata	debat'a
debatas	debat'as
debati	debat'i
debatis	debat'is
debato	debat'o
debatoj	debat'o'j
debatojn	debat'o'j'n
debaton	debat'o'n
debatado	debat'ad'o
debatanto	debat'ant'o
debatata	debat'at'a
debatita	debat'it'a
debito	debit'o
debiton	debit'o'n
debitoro	debitor'o
debitoroj	debitor'o'j
debora	debora
debuta	debut'a
debutis	debut'is
debuto	debut'o
debuton	debut'o'n
deca	dec'a
decaj	dec'a'j
decajn	dec'a'j'n
decan	dec'a'n
decas	dec'as
dece	dec'e
decis	dec'is
deco	dec'o
decus	dec'us
dececo	dec'ec'o
decembra	decembr'a
decembre	decembr'e
decembro	decembr'o
decembron	decembr'o'n
decio	deci'o
decibeloj	deci'bel'o'j
decida	decid'a
decidaj	decid'a'j
decidajn	decid'a'j'n
decidan	decid'a'n
decidas	decid'as
decide	decid'e
decidi	decid'i
decidis	decid'is
decido	decid'o
decidoj	decid'o'j
decidojn	decid'o'j'n
decidon	decid'o'n
decidos	decid'os
decidu	decid'u
decidus	decid'us
decidado	decid'ad'o
decidadon	decid'ad'o'n
decidanta	decid'ant'a
decidantaj	decid'ant'a'j
decidantajn	decid'ant'a'j'n
decidantan	decid'ant'a'n
decidante	decid'ant'e
decidanto	decid'ant'o
decidantoj	decid'ant'o'j
decidata	decid'at'a
decidebla	decid'ebl'a
decidema	decid'em'a
decidemaj	decid'em'a'j
decideme	decid'em'e
decidemo	decid'em'o
decidemon	decid'em'o'n
decidiga	decid'ig'a
decidigaj	decid'ig'a'j
decidigan	decid'ig'a'n
decidigis	decid'ig'is
decidiĝas	decid'iĝ'as
decidiĝi	decid'iĝ'i
decidiĝis	decid'iĝ'is
decidiĝo	decid'iĝ'o
decidiĝon	decid'iĝ'o'n
decidiĝos	decid'iĝ'os
decidiĝu	decid'iĝ'u
decidinta	decid'int'a
decidintaj	decid'int'a'j
decidinte	decid'int'e
decidita	decid'it'a
deciditaj	decid'it'a'j
decidite	decid'it'e
decidofarado	decid'o'far'ad'o
decidoproblemo	decid'o'problem'o
decidpovo	decid'pov'o
decidpovon	decid'pov'o'n
decidpropono	decid'propon'o
decidproponoj	decid'propon'o'j
decidproponojn	decid'propon'o'j'n
decidproponon	decid'propon'o'n
decidrajto	decid'rajt'o
decidrajton	decid'rajt'o'n
decidulo	decid'ul'o
deciduloj	decid'ul'o'j
decidua	decidu'a
deciduaj	decidu'a'j
deĉifras	deĉifr'as
deĉifri	deĉifr'i
deĉifris	deĉifr'is
deĉifrado	deĉifr'ad'o
deĉifrebla	deĉifr'ebl'a
deĉifrita	deĉifr'it'a
deĉifritaj	deĉifr'it'a'j
decimala	decimal'a
decimalaj	decimal'a'j
decimalpotencoj	decimal'potenc'o'j
dedalo	dedal'o
dediĉa	dediĉ'a
dediĉas	dediĉ'as
dediĉi	dediĉ'i
dediĉis	dediĉ'is
dediĉo	dediĉ'o
dediĉoj	dediĉ'o'j
dediĉon	dediĉ'o'n
dediĉos	dediĉ'os
dediĉu	dediĉ'u
dediĉus	dediĉ'us
dediĉante	dediĉ'ant'e
dediĉata	dediĉ'at'a
dediĉataj	dediĉ'at'a'j
dediĉintaj	dediĉ'int'a'j
dediĉita	dediĉ'it'a
dediĉitaj	dediĉ'it'a'j
dediĉitajn	dediĉ'it'a'j'n
dediĉitan	dediĉ'it'a'n
dediĉite	dediĉ'it'e
dedukta	dedukt'a
deduktaj	dedukt'a'j
deduktas	dedukt'as
dedukti	dedukt'i
deduktis	dedukt'is
dedukto	dedukt'o
deduktebla	dedukt'ebl'a
dedukteblas	dedukt'ebl'as
deduktiĝas	dedukt'iĝ'as
deduktita	dedukt'it'a
deduktitaj	dedukt'it'a'j
defenda	defend'a
defendaj	defend'a'j
defendajn	defend'a'j'n
defendan	defend'a'n
defendas	defend'as
defende	defend'e
defendi	defend'i
defendis	defend'is
defendo	defend'o
defendoj	defend'o'j
defendojn	defend'o'j'n
defendon	defend'o'n
defendos	defend'os
defendu	defend'u
defendus	defend'us
defendado	defend'ad'o
defendadon	defend'ad'o'n
defendanta	defend'ant'a
defendantaj	defend'ant'a'j
defendantan	defend'ant'a'n
defendante	defend'ant'e
defendanto	defend'ant'o
defendantoj	defend'ant'o'j
defendantojn	defend'ant'o'j'n
defendanton	defend'ant'o'n
defendata	defend'at'a
defendebla	defend'ebl'a
defendeblaj	defend'ebl'a'j
defendeble	defend'ebl'e
defendiĝi	defend'iĝ'i
defendiĝis	defend'iĝ'is
defendiloj	defend'il'o'j
defendintoj	defend'int'o'j
defendita	defend'it'a
defenditaj	defend'it'a'j
defendlinio	defend'lini'o
defendministro	defend'ministr'o
defensiva	defensiv'a
defensivaj	defensiv'a'j
defensivajn	defensiv'a'j'n
defensivan	defensiv'a'n
defensive	defensiv'e
defensivo	defensiv'o
defia	defi'a
defiaj	defi'a'j
defian	defi'a'n
defias	defi'as
defie	defi'e
defii	defi'i
defiis	defi'is
defio	defi'o
defioj	defi'o'j
defiojn	defi'o'j'n
defion	defi'o'n
defiado	defi'ad'o
defianta	defi'ant'a
defiante	defi'ant'e
defianto	defi'ant'o
defiantoj	defi'ant'o'j
defiita	defi'it'a
defiitaj	defi'it'a'j
deficita	deficit'a
deficito	deficit'o
deficitoj	deficit'o'j
deficitojn	deficit'o'j'n
deficiton	deficit'o'n
defilas	defil'as
defilis	defil'is
defilado	defil'ad'o
definas	defin'as
defini	defin'i
defino	defin'o
definita	defin'it'a
definitiva	definitiv'a
definitivaj	definitiv'a'j
definitivajn	definitiv'a'j'n
definitivan	definitiv'a'n
definitive	definitiv'e
deflacio	deflaci'o
defraŭdo	defraŭd'o
degelas	degel'as
degeli	degel'i
degelis	degel'is
degelo	degel'o
degelos	degel'os
degelado	degel'ad'o
degelakvo	degel'akv'o
degelanta	degel'ant'a
degelinta	degel'int'a
degelintaj	degel'int'a'j
degenera	degener'a
degeneraj	degener'a'j
degeneras	degener'as
degeneri	degener'i
degeneris	degener'is
degenero	degener'o
degeneron	degener'o'n
degenerado	degener'ad'o
degenereco	degener'ec'o
degenerinta	degener'int'a
degenerintaj	degener'int'a'j
degenerita	degener'it'a
degeneritaj	degener'it'a'j
degnis	degn'is
degradas	degrad'as
degradi	degrad'i
degradis	degrad'is
degradus	degrad'us
degradado	degrad'ad'o
degradante	degrad'ant'e
degradiĝas	degrad'iĝ'as
degradiĝo	degrad'iĝ'o
degradita	degrad'it'a
degraditaj	degrad'it'a'j
deistoj	deist'o'j
deja	dej'a
deĵoras	deĵor'as
deĵori	deĵor'i
deĵoris	deĵor'is
deĵoro	deĵor'o
deĵoroj	deĵor'o'j
deĵoron	deĵor'o'n
deĵoros	deĵor'os
deĵorado	deĵor'ad'o
deĵoranta	deĵor'ant'a
deĵorantaj	deĵor'ant'a'j
deĵoranto	deĵor'ant'o
deĵorantoj	deĵor'ant'o'j
deĵoranton	deĵor'ant'o'n
dek	dek
deka	dek'a
dekaj	dek'a'j
dekan	dek'a'n
dekdu	dek'du
dekkvar	dek'kvar
dekkvin	dek'kvin
dekmil	dek'mil
deknaŭ	dek'naŭ
deko	dek'o
dekoj	dek'o'j
dekojn	dek'o'j'n
dekok	dek'ok
dekon	dek'o'n
deksep	dek'sep
dekses	dek'ses
dektri	dek'tri
dekunu	dek'unu
dekaĝula	dek'aĝ'ul'a
dekaĝulaj	dek'aĝ'ul'a'j
dekdua	dek'du'a
dekduaj	dek'du'a'j
dekduan	dek'du'a'n
dekduo	dek'du'o
dekduoj	dek'du'o'j
dekduojn	dek'du'o'j'n
dekduon	dek'du'o'n
dekduedro	dek'du'edr'o
dekdujara	dek'du'jar'a
dekduope	dek'du'op'e
dekfoje	dek'foj'e
dekjara	dek'jar'a
dekjaran	dek'jar'a'n
dekjaroj	dek'jar'o'j
dekjaraĝa	dek'jar'aĝ'a
dekkelkaj	dek'kelk'a'j
dekkelkajn	dek'kelk'a'j'n
dekkelke	dek'kelk'e
dekkelkjara	dek'kelk'jar'a
dekkelkjarulo	dek'kelk'jar'ul'o
dekkelkjaruloj	dek'kelk'jar'ul'o'j
dekkvara	dek'kvar'a
dekkvaran	dek'kvar'a'n
dekkvarjara	dek'kvar'jar'a
dekkvina	dek'kvin'a
dekkvinan	dek'kvin'a'n
dekkvino	dek'kvin'o
dekkvinjara	dek'kvin'jar'a
dekmilo	dek'mil'o
dekmiloj	dek'mil'o'j
dekmilojn	dek'mil'o'j'n
dekmilon	dek'mil'o'n
dekminuta	dek'minut'a
deknaŭa	dek'naŭ'a
deknaŭaj	dek'naŭ'a'j
deknaŭan	dek'naŭ'a'n
deknaŭajarcenta	dek'naŭ'a'jar'cent'a
deknaŭjara	dek'naŭ'jar'a
dekobla	dek'obl'a
dekoble	dek'obl'e
dekoka	dek'ok'a
dekokajarcenta	dek'ok'a'jar'cent'a
dekokjara	dek'ok'jar'a
dekokjaraj	dek'ok'jar'a'j
dekono	dek'on'o
dekonoj	dek'on'o'j
dekonon	dek'on'o'n
dekonimposto	dek'on'impost'o
dekope	dek'op'e
dekpieduloj	dek'pied'ul'o'j
deksepa	dek'sep'a
deksepajarcenta	dek'sep'a'jar'cent'a
deksepjara	dek'sep'jar'a
deksesa	dek'ses'a
deksesjara	dek'ses'jar'a
deksesjaraĝa	dek'ses'jar'aĝ'a
dektaga	dek'tag'a
dektria	dek'tri'a
dektrijara	dek'tri'jar'a
dekuma	dek'um'a
dekunua	dek'unu'a
dekunuan	dek'unu'a'n
dekunujara	dek'unu'jar'a
dekadenca	dekadenc'a
dekadencaj	dekadenc'a'j
dekadencan	dekadenc'a'n
dekadencis	dekadenc'is
dekadenco	dekadenc'o
dekadencon	dekadenc'o'n
dekalogo	dekalog'o
dekamerono	dekameron'o
dekano	dekan'o
dekanoj	dekan'o'j
dekanon	dekan'o'n
deklamas	deklam'as
deklami	deklam'i
deklamis	deklam'is
deklamo	deklam'o
deklamoj	deklam'o'j
deklamu	deklam'u
deklamado	deklam'ad'o
deklamadoj	deklam'ad'o'j
deklamadon	deklam'ad'o'n
deklamante	deklam'ant'e
deklamita	deklam'it'a
deklamitaj	deklam'it'a'j
deklara	deklar'a
deklaraj	deklar'a'j
deklaras	deklar'as
deklari	deklar'i
deklaris	deklar'is
deklaro	deklar'o
deklaroj	deklar'o'j
deklarojn	deklar'o'j'n
deklaron	deklar'o'n
deklaros	deklar'os
deklaru	deklar'u
deklarus	deklar'us
deklarado	deklar'ad'o
deklaranta	deklar'ant'a
deklarantaj	deklar'ant'a'j
deklarantan	deklar'ant'a'n
deklarante	deklar'ant'e
deklarata	deklar'at'a
deklarinta	deklar'int'a
deklarinte	deklar'int'e
deklarita	deklar'it'a
deklaritaj	deklar'it'a'j
deklaritajn	deklar'it'a'j'n
deklaritan	deklar'it'a'n
deklarite	deklar'it'e
deklaracio	deklaraci'o
deklaracioj	deklaraci'o'j
deklaraciojn	deklaraci'o'j'n
deklaracion	deklaraci'o'n
deklinacio	deklinaci'o
deklinacioj	deklinaci'o'j
deklinaciojn	deklinaci'o'j'n
deklinacion	deklinaci'o'n
dekliva	dekliv'a
deklivaj	dekliv'a'j
deklivan	dekliv'a'n
deklivas	dekliv'as
deklivo	dekliv'o
deklivoj	dekliv'o'j
deklivojn	dekliv'o'j'n
deklivon	dekliv'o'n
deklivaro	dekliv'ar'o
dekliveco	dekliv'ec'o
deklivirejo	dekliv'ir'ej'o
deklivirejoj	dekliv'ir'ej'o'j
dekoltaĵo	dekolt'aĵ'o
dekoltaĵon	dekolt'aĵ'o'n
dekora	dekor'a
dekoraj	dekor'a'j
dekori	dekor'i
dekoro	dekor'o
dekorado	dekor'ad'o
dekoraĵoj	dekor'aĵ'o'j
dekorita	dekor'it'a
dekoritaj	dekor'it'a'j
dekoracia	dekoraci'a
dekoraciaj	dekoraci'a'j
dekoraciajn	dekoraci'a'j'n
dekoracian	dekoraci'a'n
dekoracias	dekoraci'as
dekoracii	dekoraci'i
dekoraciis	dekoraci'is
dekoracio	dekoraci'o
dekoracioj	dekoraci'o'j
dekoraciojn	dekoraci'o'j'n
dekoracion	dekoraci'o'n
dekoraciisto	dekoraci'ist'o
dekoraciita	dekoraci'it'a
dekoraciitaj	dekoraci'it'a'j
dekretas	dekret'as
dekreti	dekret'i
dekretis	dekret'is
dekreto	dekret'o
dekretoj	dekret'o'j
dekretojn	dekret'o'j'n
dekreton	dekret'o'n
dekretita	dekret'it'a
dekstra	dekstr'a
dekstraj	dekstr'a'j
dekstrajn	dekstr'a'j'n
dekstran	dekstr'a'n
dekstre	dekstr'e
dekstren	dekstr'e'n
dekstro	dekstr'o
dekstron	dekstr'o'n
dekstraplej	dekstr'a'plej
dekstraalmaldekstra	dekstr'a'al'mal'dekstr'a
dekstraflanka	dekstr'a'flank'a
dekstraflankaj	dekstr'a'flank'a'j
dekstraflanke	dekstr'a'flank'e
dekstresida	dekstr'e'sid'a
dekstreco	dekstr'ec'o
dekstrema	dekstr'em'a
dekstremaj	dekstr'em'a'j
dekstrula	dekstr'ul'a
dekstrulaj	dekstr'ul'a'j
dekstrulo	dekstr'ul'o
dekstruloj	dekstr'ul'o'j
dekstrularo	dekstr'ul'ar'o
dekstruma	dekstr'um'a
dekstrume	dekstr'um'e
delavaro	delavar'o
delegas	deleg'as
delegi	deleg'i
delegis	deleg'is
delego	deleg'o
delegado	deleg'ad'o
delegita	deleg'it'a
delegitaj	deleg'it'a'j
delegitan	deleg'it'a'n
delegito	deleg'it'o
delegitoj	deleg'it'o'j
delegitojn	deleg'it'o'j'n
delegiton	deleg'it'o'n
delegitaro	deleg'it'ar'o
delegitaroj	deleg'it'ar'o'j
delegacio	delegaci'o
delegacioj	delegaci'o'j
delegaciojn	delegaci'o'j'n
delegacion	delegaci'o'n
delfeno	delfen'o
delfenoj	delfen'o'j
delfenojn	delfen'o'j'n
delfenon	delfen'o'n
delica	delic'a
delice	delic'e
delico	delic'o
delikata	delikat'a
delikataj	delikat'a'j
delikatajn	delikat'a'j'n
delikatan	delikat'a'n
delikate	delikat'e
delikataĵo	delikat'aĵ'o
delikataĵoj	delikat'aĵ'o'j
delikateco	delikat'ec'o
delikatecon	delikat'ec'o'n
delikto	delikt'o
deliktoj	delikt'o'j
deliktojn	delikt'o'j'n
delikton	delikt'o'n
deliktulo	delikt'ul'o
deliktuloj	delikt'ul'o'j
delira	delir'a
deliras	delir'as
delire	delir'e
deliri	delir'i
deliris	delir'is
deliro	delir'o
deliron	delir'o'n
delta	delt'a
delto	delt'o
deltoj	delt'o'j
delton	delt'o'n
demagogoj	demagog'o'j
demagogio	demagog'i'o
demanda	demand'a
demandaj	demand'a'j
demandajn	demand'a'j'n
demandan	demand'a'n
demandas	demand'as
demande	demand'e
demandi	demand'i
demandis	demand'is
demando	demand'o
demandoj	demand'o'j
demandojn	demand'o'j'n
demandon	demand'o'n
demandos	demand'os
demandu	demand'u
demandus	demand'us
demandadi	demand'ad'i
demandadis	demand'ad'is
demandado	demand'ad'o
demandadon	demand'ad'o'n
demandanta	demand'ant'a
demandantaj	demand'ant'a'j
demandante	demand'ant'e
demandanto	demand'ant'o
demandantoj	demand'ant'o'j
demandaro	demand'ar'o
demandaroj	demand'ar'o'j
demandaron	demand'ar'o'n
demandata	demand'at'a
demandataj	demand'at'a'j
demandeme	demand'em'e
demandiĝas	demand'iĝ'as
demandinta	demand'int'a
demandinte	demand'int'e
demandinto	demand'int'o
demandita	demand'it'a
demanditaj	demand'it'a'j
demandite	demand'it'e
demandito	demand'it'o
demandosesio	demand'o'sesi'o
demandosesioj	demand'o'sesi'o'j
demandosesiojn	demand'o'sesi'o'j'n
demandosesion	demand'o'sesi'o'n
demandosigno	demand'o'sign'o
demandosignojn	demand'o'sign'o'j'n
demandosignon	demand'o'sign'o'n
demandvorto	demand'vort'o
demarŝo	demarŝ'o
demarŝoj	demarŝ'o'j
demarŝojn	demarŝ'o'j'n
demenca	demenc'a
demenco	demenc'o
demencon	demenc'o'n
dementi	dement'i
demento	dement'o
demetra	demetr'a
demetro	demetr'o
demetrio	demetri'o
demisia	demisi'a
demisias	demisi'as
demisii	demisi'i
demisiis	demisi'is
demisio	demisi'o
demisioj	demisi'o'j
demision	demisi'o'n
demisios	demisi'os
demisiu	demisi'u
demisiigo	demisi'ig'o
demisiigon	demisi'ig'o'n
demografia	demograf'i'a
demografiaj	demograf'i'a'j
demografiajn	demograf'i'a'j'n
demografian	demograf'i'a'n
demografie	demograf'i'e
demografio	demograf'i'o
demografion	demograf'i'o'n
demokrata	demokrat'a
demokrataj	demokrat'a'j
demokratajn	demokrat'a'j'n
demokratan	demokrat'a'n
demokrate	demokrat'e
demokrato	demokrat'o
demokratoj	demokrat'o'j
demokratojn	demokrat'o'j'n
demokrateco	demokrat'ec'o
demokratecon	demokrat'ec'o'n
demokratia	demokrat'i'a
demokratiaj	demokrat'i'a'j
demokratiajn	demokrat'i'a'j'n
demokratian	demokrat'i'a'n
demokratie	demokrat'i'e
demokratio	demokrat'i'o
demokratioj	demokrat'i'o'j
demokratiojn	demokrat'i'o'j'n
demokration	demokrat'i'o'n
demokratieco	demokrat'i'ec'o
demokratiigi	demokrat'i'ig'i
demokratiigo	demokrat'i'ig'o
demokratiigon	demokrat'i'ig'o'n
demokrito	demokrit'o
demona	demon'a
demonaj	demon'a'j
demonan	demon'a'n
demono	demon'o
demonoj	demon'o'j
demonojn	demon'o'j'n
demonon	demon'o'n
demonologio	demon'olog'i'o
demonstra	demonstr'a
demonstras	demonstr'as
demonstre	demonstr'e
demonstri	demonstr'i
demonstris	demonstr'is
demonstro	demonstr'o
demonstron	demonstr'o'n
demonstrado	demonstr'ad'o
demonstraĵoj	demonstr'aĵ'o'j
demonstrante	demonstr'ant'e
demonstrebla	demonstr'ebl'a
demonstracio	demonstraci'o
demonstracioj	demonstraci'o'j
demonstraciojn	demonstraci'o'j'n
demonstrativoj	demonstrativ'o'j
demoralizita	demoraliz'it'a
demosteno	demosten'o
dendrita	dendrit'a
dendritaj	dendrit'a'j
dendritoj	dendrit'o'j
denizo	deniz'o
denominatoro	denominator'o
denotacia	denotaci'a
denotacio	denotaci'o
densa	dens'a
densaj	dens'a'j
densajn	dens'a'j'n
densan	dens'a'n
densas	dens'as
dense	dens'e
denso	dens'o
denson	dens'o'n
densaĵoj	dens'aĵ'o'j
denseco	dens'ec'o
densecoj	dens'ec'o'j
densecojn	dens'ec'o'j'n
densecon	dens'ec'o'n
densega	dens'eg'a
densejo	dens'ej'o
densejoj	dens'ej'o'j
densejon	dens'ej'o'n
densigas	dens'ig'as
densigi	dens'ig'i
densigo	dens'ig'o
densigita	dens'ig'it'a
densigitaj	dens'ig'it'a'j
densigitan	dens'ig'it'a'n
densigproporcio	dens'ig'proporci'o
densiĝas	dens'iĝ'as
densiĝis	dens'iĝ'is
denstrafika	dens'trafik'a
denta	dent'a
dentaj	dent'a'j
dentan	dent'a'n
dento	dent'o
dentoj	dent'o'j
dentojn	dent'o'j'n
denton	dent'o'n
dentaĵo	dent'aĵ'o
dentaro	dent'ar'o
dentaron	dent'ar'o'n
dentego	dent'eg'o
dentegoj	dent'eg'o'j
dentegojn	dent'eg'o'j'n
dentetoj	dent'et'o'j
dentiĝo	dent'iĝ'o
dentingo	dent'ing'o
dentingoj	dent'ing'o'j
dentisto	dent'ist'o
dentistoj	dent'ist'o'j
dentiston	dent'ist'o'n
dentita	dent'it'a
dentitaj	dent'it'a'j
dentkuracisto	dent'kurac'ist'o
dentobroso	dent'o'bros'o
dentobroson	dent'o'bros'o'n
dentocetacoj	dent'o'cetac'o'j
dentodoloro	dent'o'dolor'o
dentodoloron	dent'o'dolor'o'n
dentokarno	dent'o'karn'o
dentokremoj	dent'o'krem'o'j
dentokuracado	dent'o'kurac'ad'o
dentokuracisto	dent'o'kurac'ist'o
dentopasto	dent'o'past'o
dentopaston	dent'o'past'o'n
dentrado	dent'rad'o
dentradoj	dent'rad'o'j
dentŝraŭboj	dent'ŝraŭb'o'j
dentala	dental'a
dentalaj	dental'a'j
dentalajn	dental'a'j'n
denuncas	denunc'as
denunci	denunc'i
denuncis	denunc'is
denunco	denunc'o
denuncoj	denunc'o'j
denuncojn	denunc'o'j'n
denuncon	denunc'o'n
denuncos	denunc'os
denuncanto	denunc'ant'o
denuncita	denunc'it'a
departementa	departement'a
departementaj	departement'a'j
departementajn	departement'a'j'n
departemento	departement'o
departementoj	departement'o'j
departementojn	departement'o'j'n
departementon	departement'o'n
deplojas	deploj'as
deploji	deploj'i
deplojis	deploj'is
deplojo	deploj'o
deplojoj	deploj'o'j
deplojon	deploj'o'n
deplojado	deploj'ad'o
deplojante	deploj'ant'e
deplojiĝas	deploj'iĝ'as
deplojiĝis	deploj'iĝ'is
deplojita	deploj'it'a
deplojitaj	deploj'it'a'j
deplojite	deploj'it'e
deponas	depon'as
deponi	depon'i
deponis	depon'is
depono	depon'o
deponoj	depon'o'j
deponu	depon'u
deponado	depon'ad'o
deponaĵo	depon'aĵ'o
deponaĵoj	depon'aĵ'o'j
deponaĵon	depon'aĵ'o'n
deponante	depon'ant'e
deponejo	depon'ej'o
deponejoj	depon'ej'o'j
deponejojn	depon'ej'o'j'n
deponejon	depon'ej'o'n
deponiĝas	depon'iĝ'as
deponita	depon'it'a
deponitaj	depon'it'a'j
deportis	deport'is
deporto	deport'o
deportoj	deport'o'j
deportado	deport'ad'o
deportadoj	deport'ad'o'j
deportadon	deport'ad'o'n
deportita	deport'it'a
deportitaj	deport'it'a'j
depresia	depresi'a
depresiaj	depresi'a'j
depresio	depresi'o
depresioj	depresi'o'j
depresiojn	depresi'o'j'n
depresion	depresi'o'n
deprima	deprim'a
deprimas	deprim'as
deprimi	deprim'i
deprimis	deprim'is
deprimo	deprim'o
deprimon	deprim'o'n
deprimiĝis	deprim'iĝ'is
deprimiĝo	deprim'iĝ'o
deprimita	deprim'it'a
deprimitaj	deprim'it'a'j
deprimite	deprim'it'e
deprimiteco	deprim'it'ec'o
deputita	deput'it'a
deputitaj	deput'it'a'j
deputito	deput'it'o
deputitoj	deput'it'o'j
deputitojn	deput'it'o'j'n
deputiton	deput'it'o'n
deputitaro	deput'it'ar'o
deputitinstanco	deput'it'instanc'o
deriva	deriv'a
derivaj	deriv'a'j
derivas	deriv'as
derivi	deriv'i
derivis	deriv'is
derivo	deriv'o
derivado	deriv'ad'o
derivaĵo	deriv'aĵ'o
derivaĵoj	deriv'aĵ'o'j
derivaĵojn	deriv'aĵ'o'j'n
derivaĵon	deriv'aĵ'o'n
derivante	deriv'ant'e
derivata	deriv'at'a
derivataj	deriv'at'a'j
derivebla	deriv'ebl'a
deriviĝas	deriv'iĝ'as
deriviĝis	deriv'iĝ'is
derivita	deriv'it'a
derivitaj	deriv'it'a'j
derivitajn	deriv'it'a'j'n
derivitan	deriv'it'a'n
derivite	deriv'it'e
dermo	derm'o
derviŝoj	derviŝ'o'j
des	des
despli	des'pli
desinfekti	des'infekt'i
desinfektado	des'infekt'ad'o
desinfektaĵo	des'infekt'aĵ'o
desaponti	desapont'i
desapontita	desapont'it'a
desapontitaj	desapont'it'a'j
descenda	descend'a
descendaj	descend'a'j
descendan	descend'a'n
descendas	descend'as
descendi	descend'i
descendis	descend'is
descendo	descend'o
descendado	descend'ad'o
descendanta	descend'ant'a
descendante	descend'ant'e
descendantoj	descend'ant'o'j
descendita	descend'it'a
descenditaj	descend'it'a'j
desegna	desegn'a
desegnas	desegn'as
desegni	desegn'i
desegnis	desegn'is
desegno	desegn'o
desegnoj	desegn'o'j
desegnojn	desegn'o'j'n
desegnon	desegn'o'n
desegnos	desegn'os
desegnu	desegn'u
desegnado	desegn'ad'o
desegnadon	desegn'ad'o'n
desegnaĵo	desegn'aĵ'o
desegnaĵoj	desegn'aĵ'o'j
desegnaĵojn	desegn'aĵ'o'j'n
desegnaĵon	desegn'aĵ'o'n
desegnante	desegn'ant'e
desegnataj	desegn'at'a'j
desegniĝis	desegn'iĝ'is
desegnisto	desegn'ist'o
desegnistoj	desegn'ist'o'j
desegnita	desegn'it'a
desegnitaj	desegn'it'a'j
desegnitajn	desegn'it'a'j'n
desegnofilmo	desegn'o'film'o
desegnofilmoj	desegn'o'film'o'j
deserto	desert'o
desertoj	desert'o'j
desertojn	desert'o'j'n
deserton	desert'o'n
despera	desper'a
despere	desper'e
despero	desper'o
desperado	desper'ad'o
despota	despot'a
despotaj	despot'a'j
despotan	despot'a'n
despoto	despot'o
despotoj	despot'o'j
despoton	despot'o'n
despotismo	despot'ism'o
destinas	destin'as
destini	destin'i
destinis	destin'is
destino	destin'o
destinoj	destin'o'j
destinojn	destin'o'j'n
destinon	destin'o'n
destinata	destin'at'a
destinataj	destin'at'a'j
destinita	destin'it'a
destinitaj	destin'it'a'j
destinitajn	destin'it'a'j'n
destinitan	destin'it'a'n
destinite	destin'it'e
destrojero	destrojer'o
destrojeroj	destrojer'o'j
destrojerojn	destrojer'o'j'n
detala	detal'a
detalaj	detal'a'j
detalajn	detal'a'j'n
detalan	detal'a'n
detalas	detal'as
detale	detal'e
detali	detal'i
detalo	detal'o
detaloj	detal'o'j
detalojn	detal'o'j'n
detalon	detal'o'n
detalaĵoj	detal'aĵ'o'j
detaleco	detal'ec'o
detalema	detal'em'a
detalemaj	detal'em'a'j
detaleman	detal'em'a'n
detaleme	detal'em'e
detalemo	detal'em'o
detaleto	detal'et'o
detaletoj	detal'et'o'j
detaligas	detal'ig'as
detaligi	detal'ig'i
detaligis	detal'ig'is
detaligo	detal'ig'o
detaliganta	detal'ig'ant'a
detaligante	detal'ig'ant'e
detaligita	detal'ig'it'a
detektas	detekt'as
detekti	detekt'i
detektis	detekt'is
detekto	detekt'o
detekton	detekt'o'n
detektos	detekt'os
detektado	detekt'ad'o
detektante	detekt'ant'e
detekteblaj	detekt'ebl'a'j
detektilo	detekt'il'o
detektiloj	detekt'il'o'j
detektilojn	detekt'il'o'j'n
detektilon	detekt'il'o'n
detektita	detekt'it'a
detektitaj	detekt'it'a'j
detektometodoj	detekt'o'metod'o'j
detektsistemoj	detekt'sistem'o'j
detektiva	detektiv'a
detektivaj	detektiv'a'j
detektivo	detektiv'o
detektivoj	detektiv'o'j
detektivojn	detektiv'o'j'n
detektivon	detektiv'o'n
determina	determin'a
determinas	determin'as
determini	determin'i
determinis	determin'is
determino	determin'o
determinon	determin'o'n
determinos	determin'os
determinu	determin'u
determinus	determin'us
determinado	determin'ad'o
determinadfaktoro	determin'ad'faktor'o
determinanta	determin'ant'a
determinantaj	determin'ant'a'j
determinante	determin'ant'e
determinanto	determin'ant'o
determinantoj	determin'ant'o'j
determinantojn	determin'ant'o'j'n
determinanton	determin'ant'o'n
determinata	determin'at'a
determinataj	determin'at'a'j
determinebla	determin'ebl'a
determinisma	determin'ism'a
determinismaj	determin'ism'a'j
determinismo	determin'ism'o
determinismon	determin'ism'o'n
determinita	determin'it'a
determinitaj	determin'it'a'j
determinitajn	determin'it'a'j'n
determinitan	determin'it'a'n
determinite	determin'it'e
detonacias	detonaci'as
detonaciis	detonaci'is
detonacio	detonaci'o
detrito	detrit'o
detrua	detru'a
detruaj	detru'a'j
detruajn	detru'a'j'n
detruan	detru'a'n
detruas	detru'as
detrue	detru'e
detrui	detru'i
detruis	detru'is
detruo	detru'o
detruoj	detru'o'j
detruojn	detru'o'j'n
detruon	detru'o'n
detruos	detru'os
detruu	detru'u
detruus	detru'us
detruado	detru'ad'o
detruadon	detru'ad'o'n
detruanta	detru'ant'a
detruantaj	detru'ant'a'j
detruante	detru'ant'e
detruanto	detru'ant'o
detruantoj	detru'ant'o'j
detruata	detru'at'a
detruataj	detru'at'a'j
detruiga	detru'ig'a
detruiĝas	detru'iĝ'as
detruiĝi	detru'iĝ'i
detruiĝis	detru'iĝ'is
detruiĝo	detru'iĝ'o
detruiĝos	detru'iĝ'os
detruita	detru'it'a
detruitaj	detru'it'a'j
detruitajn	detru'it'a'j'n
detruitan	detru'it'a'n
deŭterio	deŭteri'o
deva	dev'a
devas	dev'as
deve	dev'e
devi	dev'i
devis	dev'is
devo	dev'o
devoj	dev'o'j
devojn	dev'o'j'n
devon	dev'o'n
devos	dev'os
devu	dev'u
devus	dev'us
devado	dev'ad'o
devanta	dev'ant'a
devantaj	dev'ant'a'j
devante	dev'ant'e
deviga	dev'ig'a
devigaj	dev'ig'a'j
devigajn	dev'ig'a'j'n
devigan	dev'ig'a'n
devigas	dev'ig'as
devige	dev'ig'e
devigi	dev'ig'i
devigis	dev'ig'is
devigo	dev'ig'o
devigoj	dev'ig'o'j
devigojn	dev'ig'o'j'n
devigon	dev'ig'o'n
devigos	dev'ig'os
devigu	dev'ig'u
devigus	dev'ig'us
devigado	dev'ig'ad'o
deviganta	dev'ig'ant'a
devigantaj	dev'ig'ant'a'j
devigantan	dev'ig'ant'a'n
devigante	dev'ig'ant'e
devigata	dev'ig'at'a
devigataj	dev'ig'at'a'j
devigatis	dev'ig'at'is
devigebla	dev'ig'ebl'a
devigeblaj	dev'ig'ebl'a'j
devigita	dev'ig'it'a
devigitaj	dev'ig'it'a'j
devigite	dev'ig'it'e
devinta	dev'int'a
devintaj	dev'int'a'j
devintus	dev'int'us
devita	dev'it'a
devitaj	dev'it'a'j
devosento	dev'o'sent'o
devontiga	dev'ont'ig'a
devontigaj	dev'ont'ig'a'j
devontigan	dev'ont'ig'a'n
devontigas	dev'ont'ig'as
devontigi	dev'ont'ig'i
devontigis	dev'ont'ig'is
devontigo	dev'ont'ig'o
devontigoj	dev'ont'ig'o'j
devontigojn	dev'ont'ig'o'j'n
devontigon	dev'ont'ig'o'n
devontigita	dev'ont'ig'it'a
devontigitaj	dev'ont'ig'it'a'j
devota	dev'ot'a
devotaj	dev'ot'a'j
devotas	dev'ot'as
devoti	dev'ot'i
devotis	dev'ot'is
devanci	devanc'i
devancita	devanc'it'a
devia	devi'a
deviaj	devi'a'j
devias	devi'as
devii	devi'i
deviis	devi'is
devio	devi'o
devioj	devi'o'j
deviojn	devi'o'j'n
devion	devi'o'n
devios	devi'os
deviante	devi'ant'e
deviigas	devi'ig'as
deviigi	devi'ig'i
deviigis	devi'ig'is
deviigita	devi'ig'it'a
deviigitaj	devi'ig'it'a'j
devizo	deviz'o
devizoj	deviz'o'j
devizon	deviz'o'n
devonio	devoni'o
devotas	devot'as
devoti	devot'i
devotis	devot'is
devotado	devot'ad'o
devoteco	devot'ec'o
devotecon	devot'ec'o'n
devotita	devot'it'a
devotitaj	devot'it'a'j
devotulo	devot'ul'o
devotuloj	devot'ul'o'j
dezajna	dezajn'a
dezajnaj	dezajn'a'j
dezajnis	dezajn'is
dezajno	dezajn'o
dezajnoj	dezajn'o'j
dezajnojn	dezajn'o'j'n
dezajnon	dezajn'o'n
dezajnadministrado	dezajn'administr'ad'o
dezajnaliro	dezajn'al'ir'o
dezajnelemento	dezajn'element'o
dezajnelementoj	dezajn'element'o'j
dezajnelementojn	dezajn'element'o'j'n
dezajnisto	dezajn'ist'o
dezajnistoj	dezajn'ist'o'j
dezajnita	dezajn'it'a
dezajnitaj	dezajn'it'a'j
dezajnlaboro	dezajn'labor'o
dezajnokonstruo	dezajn'o'konstru'o
dezajnprocezo	dezajn'procez'o
dezajnprocezon	dezajn'procez'o'n
dezajnteamo	dezajn'team'o
dezerta	dezert'a
dezertaj	dezert'a'j
dezertajn	dezert'a'j'n
dezertan	dezert'a'n
dezerte	dezert'e
dezerto	dezert'o
dezertoj	dezert'o'j
dezertojn	dezert'o'j'n
dezerton	dezert'o'n
dezerteca	dezert'ec'a
dezertejo	dezert'ej'o
dezertiĝis	dezert'iĝ'is
dezertiĝo	dezert'iĝ'o
dezertiĝon	dezert'iĝ'o'n
deziras	dezir'as
deziri	dezir'i
deziris	dezir'is
deziro	dezir'o
deziroj	dezir'o'j
dezirojn	dezir'o'j'n
deziron	dezir'o'n
deziros	dezir'os
deziru	dezir'u
dezirus	dezir'us
dezirado	dezir'ad'o
deziranta	dezir'ant'a
dezirantaj	dezir'ant'a'j
dezirantajn	dezir'ant'a'j'n
dezirante	dezir'ant'e
deziranto	dezir'ant'o
dezirantoj	dezir'ant'o'j
dezirantojn	dezir'ant'o'j'n
dezirata	dezir'at'a
dezirataj	dezir'at'a'j
deziratajn	dezir'at'a'j'n
deziratan	dezir'at'a'n
dezirate	dezir'at'e
dezirebla	dezir'ebl'a
deziregas	dezir'eg'as
deziregis	dezir'eg'is
dezirego	dezir'eg'o
dezirinda	dezir'ind'a
dezirindaj	dezir'ind'a'j
dezirindajn	dezir'ind'a'j'n
dezirindan	dezir'ind'a'n
dezirindas	dezir'ind'as
dezirinde	dezir'ind'e
dezirindaĵo	dezir'ind'aĵ'o
dezirindeco	dezir'ind'ec'o
dezirindecon	dezir'ind'ec'o'n
dezirinta	dezir'int'a
dezirintus	dezir'int'us
dezirita	dezir'it'a
deziritaj	dezir'it'a'j
deziritan	dezir'it'a'n
dezirite	dezir'it'e
dia	di'a
diaj	di'a'j
diajn	di'a'j'n
dian	di'a'n
die	di'e
dio	di'o
dioj	di'o'j
diojn	di'o'j'n
dion	di'o'n
diaĵo	di'aĵ'o
diaĵoj	di'aĵ'o'j
diaĵojn	di'aĵ'o'j'n
diaĵon	di'aĵ'o'n
diaro	di'ar'o
dibenitan	di'ben'it'a'n
didomoj	di'dom'o'j
dieca	di'ec'a
diecan	di'ec'a'n
dieco	di'ec'o
diecoj	di'ec'o'j
diecon	di'ec'o'n
dietila	di'et'il'a
difilo	di'fil'o
diigis	di'ig'is
diigo	di'ig'o
diigita	di'ig'it'a
diigitaj	di'ig'it'a'j
diino	di'in'o
diinoj	di'in'o'j
diinojn	di'in'o'j'n
diinon	di'in'o'n
diismo	di'ism'o
dikredo	di'kred'o
dikredantaj	di'kred'ant'a'j
dikredantoj	di'kred'ant'o'j
dioksido	di'oksid'o
dioksidon	di'oksid'o'n
dipatrino	di'patr'in'o
dipatrinon	di'patr'in'o'n
diregna	di'regn'a
disakaridoj	di'sakar'id'o'j
diserva	di'serv'a
diservo	di'serv'o
diservoj	di'serv'o'j
diservojn	di'serv'o'j'n
diservon	di'serv'o'n
disimila	di'simil'a
disinjoro	di'sinjor'o
diabeto	diabet'o
diabeton	diabet'o'n
diabla	diabl'a
diablaj	diabl'a'j
diablajn	diabl'a'j'n
diablan	diabl'a'n
diable	diabl'e
diablo	diabl'o
diabloj	diabl'o'j
diablojn	diabl'o'j'n
diablon	diabl'o'n
diableto	diabl'et'o
diademo	diadem'o
diademon	diadem'o'n
diafana	diafan'a
diafanaj	diafan'a'j
diafanajn	diafan'a'j'n
diafanan	diafan'a'n
diafane	diafan'e
diafragmo	diafragm'o
diafragmon	diafragm'o'n
diagnoza	diagnoz'a
diagnozaj	diagnoz'a'j
diagnozajn	diagnoz'a'j'n
diagnozan	diagnoz'a'n
diagnozas	diagnoz'as
diagnozi	diagnoz'i
diagnozis	diagnoz'is
diagnozo	diagnoz'o
diagnozoj	diagnoz'o'j
diagnozojn	diagnoz'o'j'n
diagnozon	diagnoz'o'n
diagnozado	diagnoz'ad'o
diagnozita	diagnoz'it'a
diagnozitaj	diagnoz'it'a'j
diagonala	diagonal'a
diagonalaj	diagonal'a'j
diagonalan	diagonal'a'n
diagonale	diagonal'e
diagonalo	diagonal'o
diagonaloj	diagonal'o'j
diagramo	diagram'o
diagramoj	diagram'o'j
diagramojn	diagram'o'j'n
diagramon	diagram'o'n
diakono	diakon'o
diakonoj	diakon'o'j
diakrita	diakrit'a
diakritaj	diakrit'a'j
diakritajn	diakrit'a'j'n
diakritan	diakrit'a'n
diakrona	diakron'a
dialekta	dialekt'a
dialektaj	dialekt'a'j
dialektajn	dialekt'a'j'n
dialektan	dialekt'a'n
dialekte	dialekt'e
dialekto	dialekt'o
dialektoj	dialekt'o'j
dialektojn	dialekt'o'j'n
dialekton	dialekt'o'n
dialektaro	dialekt'ar'o
dialektogrupo	dialekt'o'grup'o
dialektika	dialektik'a
dialektikaj	dialektik'a'j
dialektikan	dialektik'a'n
dialektike	dialektik'e
dialektiko	dialektik'o
dialektikon	dialektik'o'n
dializo	dializ'o
dialoga	dialog'a
dialogaj	dialog'a'j
dialogan	dialog'a'n
dialogas	dialog'as
dialogi	dialog'i
dialogo	dialog'o
dialogoj	dialog'o'j
dialogojn	dialog'o'j'n
dialogon	dialog'o'n
dialogado	dialog'ad'o
dialogadon	dialog'ad'o'n
dialogujo	dialog'uj'o
diamagnetaj	diamagnet'a'j
diamanta	diamant'a
diamantaj	diamant'a'j
diamantajn	diamant'a'j'n
diamantan	diamant'a'n
diamanto	diamant'o
diamantoj	diamant'o'j
diamantojn	diamant'o'j'n
diamanton	diamant'o'n
diametre	diametr'e
diametro	diametr'o
diametroj	diametr'o'j
diametrojn	diametr'o'j'n
diametron	diametr'o'n
diana	dian'a
diane	dian'e
diano	dian'o
dianto	diant'o
diantoj	diant'o'j
diapazono	diapazon'o
diapozitivo	diapozitiv'o
diapozitivoj	diapozitiv'o'j
diareo	diare'o
diareon	diare'o'n
diaspora	diaspor'a
diasporaj	diaspor'a'j
diasporo	diaspor'o
diasporoj	diaspor'o'j
diasporon	diaspor'o'n
diastola	diastol'a
diatomeoj	diatome'o'j
diatona	diaton'a
diatonaj	diaton'a'j
diboĉa	diboĉ'a
diboĉas	diboĉ'as
diboĉi	diboĉ'i
diboĉis	diboĉ'is
diboĉo	diboĉ'o
diboĉado	diboĉ'ad'o
diboĉema	diboĉ'em'a
diboĉulo	diboĉ'ul'o
dido	did'o
didaktika	didaktik'a
didaktikaj	didaktik'a'j
didaktike	didaktik'e
didaktiko	didaktik'o
didono	didon'o
diego	dieg'o
dielektrika	dielektrik'a
dielektrikaj	dielektrik'a'j
dielektrikan	dielektrik'a'n
dielektriko	dielektrik'o
dielektrikoj	dielektrik'o'j
dierezo	dierez'o
diesa	dies'a
dieso	dies'o
diesoj	dies'o'j
dieta	diet'a
dietaj	diet'a'j
dietajn	diet'a'j'n
dietan	diet'a'n
dietas	diet'as
dieti	diet'i
dieto	diet'o
dietoj	diet'o'j
dietojn	diet'o'j'n
dieton	diet'o'n
difekta	difekt'a
difektaj	difekt'a'j
difektas	difekt'as
difekti	difekt'i
difektis	difekt'is
difekto	difekt'o
difektoj	difekt'o'j
difektojn	difekt'o'j'n
difekton	difekt'o'n
difektos	difekt'os
difektu	difekt'u
difektus	difekt'us
difektado	difekt'ad'o
difektanta	difekt'ant'a
difektante	difekt'ant'e
difektata	difekt'at'a
difektiĝas	difekt'iĝ'as
difektiĝi	difekt'iĝ'i
difektiĝis	difekt'iĝ'is
difektiĝo	difekt'iĝ'o
difektiĝon	difekt'iĝ'o'n
difektita	difekt'it'a
difektitaj	difekt'it'a'j
difektitajn	difekt'it'a'j'n
difektitan	difekt'it'a'n
difektite	difekt'it'e
diferaj	difer'a'j
diferenca	diferenc'a
diferencaj	diferenc'a'j
diferencajn	diferenc'a'j'n
diferencan	diferenc'a'n
diferencas	diferenc'as
diference	diferenc'e
diferenci	diferenc'i
diferencis	diferenc'is
diferenco	diferenc'o
diferencoj	diferenc'o'j
diferencojn	diferenc'o'j'n
diferencon	diferenc'o'n
diferenciga	diferenc'ig'a
diferencigaj	diferenc'ig'a'j
diferencigajn	diferenc'ig'a'j'n
diferencigan	diferenc'ig'a'n
diferencigas	diferenc'ig'as
diferencige	diferenc'ig'e
diferencigi	diferenc'ig'i
diferencigis	diferenc'ig'is
diferencigo	diferenc'ig'o
diferencigon	diferenc'ig'o'n
diferencigado	diferenc'ig'ad'o
diferencigante	diferenc'ig'ant'e
diferencigita	diferenc'ig'it'a
diferencigitaj	diferenc'ig'it'a'j
diferenciĝas	diferenc'iĝ'as
diferenciĝi	diferenc'iĝ'i
diferenciĝis	diferenc'iĝ'is
diferenciĝo	diferenc'iĝ'o
diferencita	diferenc'it'a
diferencitaj	diferenc'it'a'j
diferenciebla	diferenci'ebl'a
diferenciala	diferencial'a
diferencialaj	diferencial'a'j
diferencialan	diferencial'a'n
diferencialo	diferencial'o
diferencialoj	diferencial'o'j
diferencialon	diferencial'o'n
difina	difin'a
difinaj	difin'a'j
difinajn	difin'a'j'n
difinan	difin'a'n
difinas	difin'as
difini	difin'i
difinis	difin'is
difino	difin'o
difinoj	difin'o'j
difinojn	difin'o'j'n
difinon	difin'o'n
difinos	difin'os
difinu	difin'u
difinus	difin'us
difinado	difin'ad'o
difinanta	difin'ant'a
difinantaj	difin'ant'a'j
difinante	difin'ant'e
difinata	difin'at'a
difinebla	difin'ebl'a
difineblaj	difin'ebl'a'j
difineblan	difin'ebl'a'n
difineblas	difin'ebl'as
difiniĝas	difin'iĝ'as
difinilo	difin'il'o
difiniloj	difin'il'o'j
difinilon	difin'il'o'n
difinita	difin'it'a
difinitaj	difin'it'a'j
difinitajn	difin'it'a'j'n
difinitan	difin'it'a'n
difinite	difin'it'e
difinitoj	difin'it'o'j
difiniteco	difin'it'ec'o
difinitecon	difin'it'ec'o'n
difrakti	difrakt'i
difrakto	difrakt'o
difterio	difteri'o
diftongo	diftong'o
diftongoj	diftong'o'j
diftongojn	diftong'o'j'n
diftongon	diftong'o'n
difuza	difuz'a
difuzaj	difuz'a'j
difuzan	difuz'a'n
difuzo	difuz'o
difuzon	difuz'o'n
difuzigas	difuz'ig'as
difuzigi	difuz'ig'i
difuzigita	difuz'ig'it'a
difuzigitaj	difuz'ig'it'a'j
dige	dig'e
digi	dig'i
digo	dig'o
digoj	dig'o'j
digojn	dig'o'j'n
digon	dig'o'n
digita	dig'it'a
digografo	dig'o'graf'o
digvojo	dig'voj'o
digesta	digest'a
digestaj	digest'a'j
digestan	digest'a'n
digestas	digest'as
digesti	digest'i
digestis	digest'is
digesto	digest'o
digeston	digest'o'n
digestado	digest'ad'o
digestadon	digest'ad'o'n
digestebla	digest'ebl'a
digesteblaj	digest'ebl'a'j
digestiga	digest'ig'a
digestigaj	digest'ig'a'j
digestigajn	digest'ig'a'j'n
digestita	digest'it'a
digestitaj	digest'it'a'j
digestkanalo	digest'kanal'o
diĝita	diĝit'a
diĝitaj	diĝit'a'j
diĝitan	diĝit'a'n
diĝitkamerao	diĝit'kamera'o
diĝitkameraoj	diĝit'kamera'o'j
diglosio	diglosi'o
digna	dign'a
dignaj	dign'a'j
dignajn	dign'a'j'n
dignan	dign'a'n
digne	dign'e
digno	dign'o
dignoj	dign'o'j
dignon	dign'o'n
digneco	dign'ec'o
dignecon	dign'ec'o'n
dignoplena	dign'o'plen'a
dignulo	dign'ul'o
digrafo	digraf'o
digrafoj	digraf'o'j
dika	dik'a
dikaj	dik'a'j
dikajn	dik'a'j'n
dikan	dik'a'n
dikas	dik'as
dike	dik'e
diko	dik'o
dikeco	dik'ec'o
dikecoj	dik'ec'o'j
dikecon	dik'ec'o'n
dikecmezurilo	dik'ec'mezur'il'o
dikega	dik'eg'a
dikegaj	dik'eg'a'j
dikegan	dik'eg'a'n
diketa	dik'et'a
diketaj	dik'et'a'j
dikfingro	dik'fingr'o
dikfingroj	dik'fingr'o'j
dikfingrojn	dik'fingr'o'j'n
dikfingron	dik'fingr'o'n
dikigas	dik'ig'as
dikigita	dik'ig'it'a
dikiĝas	dik'iĝ'as
dikiĝi	dik'iĝ'i
dikiĝis	dik'iĝ'is
dikiĝo	dik'iĝ'o
dikiĝos	dik'iĝ'os
dikulo	dik'ul'o
dikuloj	dik'ul'o'j
dikuleto	dik'ul'et'o
dikventra	dik'ventr'a
diktas	dikt'as
dikti	dikt'i
diktis	dikt'is
diktado	dikt'ad'o
diktaĵo	dikt'aĵ'o
diktaĵoj	dikt'aĵ'o'j
diktante	dikt'ant'e
diktita	dikt'it'a
diktitaj	dikt'it'a'j
diktatora	diktator'a
diktatoraj	diktator'a'j
diktatoro	diktator'o
diktatoroj	diktator'o'j
diktatorojn	diktator'o'j'n
diktatoron	diktator'o'n
diktatoreca	diktator'ec'a
diktatoreco	diktator'ec'o
diktatorecoj	diktator'ec'o'j
diktatorecon	diktator'ec'o'n
diktatura	diktatur'a
diktaturo	diktatur'o
diktaturoj	diktatur'o'j
diktaturon	diktatur'o'n
dilatas	dilat'as
dilato	dilat'o
dilatiĝo	dilat'iĝ'o
dilatita	dilat'it'a
dilemo	dilem'o
dilemoj	dilem'o'j
dilemon	dilem'o'n
diletanta	diletant'a
diletante	diletant'e
diletanto	diletant'o
diletantoj	diletant'o'j
diligenta	diligent'a
diligentaj	diligent'a'j
diligentajn	diligent'a'j'n
diligentan	diligent'a'n
diligentas	diligent'as
diligente	diligent'e
diligentis	diligent'is
diligento	diligent'o
diligenteco	diligent'ec'o
diligentecon	diligent'ec'o'n
diluas	dilu'as
dilui	dilu'i
diluis	dilu'is
diluo	dilu'o
diluon	dilu'o'n
diluilo	dilu'il'o
diluita	dilu'it'a
diluitaj	dilu'it'a'j
diluitan	dilu'it'a'n
diluvo	diluv'o
diluvon	diluv'o'n
dimanĉa	dimanĉ'a
dimanĉaj	dimanĉ'a'j
dimanĉajn	dimanĉ'a'j'n
dimanĉan	dimanĉ'a'n
dimanĉe	dimanĉ'e
dimanĉo	dimanĉ'o
dimanĉoj	dimanĉ'o'j
dimanĉojn	dimanĉ'o'j'n
dimanĉon	dimanĉ'o'n
dimensia	dimensi'a
dimensiaj	dimensi'a'j
dimensian	dimensi'a'n
dimensie	dimensi'e
dimensio	dimensi'o
dimensioj	dimensi'o'j
dimensiojn	dimensi'o'j'n
dimension	dimensi'o'n
diminuita	diminu'it'a
diminutivo	diminutiv'o
diminutivoj	diminutiv'o'j
dimitri	dimitri
dimorfismo	dimorf'ism'o
dinamo	dinam'o
dinamika	dinamik'a
dinamikaj	dinamik'a'j
dinamikajn	dinamik'a'j'n
dinamikan	dinamik'a'n
dinamike	dinamik'e
dinamiko	dinamik'o
dinamikon	dinamik'o'n
dinamismo	dinamism'o
dinamito	dinamit'o
dinamiton	dinamit'o'n
dinaro	dinar'o
dinastia	dinasti'a
dinastiaj	dinasti'a'j
dinastian	dinasti'a'n
dinastio	dinasti'o
dinastioj	dinasti'o'j
dinastiojn	dinasti'o'j'n
dinastion	dinasti'o'n
dinosaŭra	dinosaŭr'a
dinosaŭraj	dinosaŭr'a'j
dinosaŭro	dinosaŭr'o
dinosaŭroj	dinosaŭr'o'j
dinosaŭrojn	dinosaŭr'o'j'n
dioceza	diocez'a
diocezaj	diocez'a'j
diocezo	diocez'o
diocezoj	diocez'o'j
diocezojn	diocez'o'j'n
diocezon	diocez'o'n
diodo	diod'o
diodoj	diod'o'j
diodojn	diod'o'j'n
diodon	diod'o'n
diodato	diodat'o
diodoro	diodor'o
diogeno	diogen'o
dioikaj	dioik'a'j
diokleciano	dioklecian'o
dioksino	dioksin'o
dioksinoj	dioksin'o'j
diomedo	diomed'o
diomedea	diomede'a
diomedeo	diomede'o
dionizo	dioniz'o
dionizon	dioniz'o'n
dionizio	dionizi'o
dioskuroj	dioskur'o'j
diploma	diplom'a
diplomo	diplom'o
diplomoj	diplom'o'j
diplomojn	diplom'o'j'n
diplomon	diplom'o'n
diplomata	diplom'at'a
diplomataj	diplom'at'a'j
diplomatajn	diplom'at'a'j'n
diplomatan	diplom'at'a'n
diplomate	diplom'at'e
diplomato	diplom'at'o
diplomatoj	diplom'at'o'j
diplomatojn	diplom'at'o'j'n
diplomiĝas	diplom'iĝ'as
diplomiĝi	diplom'iĝ'i
diplomiĝis	diplom'iĝ'is
diplomiĝo	diplom'iĝ'o
diplomiĝinte	diplom'iĝ'int'e
diplomiĝinto	diplom'iĝ'int'o
diplomiĝintoj	diplom'iĝ'int'o'j
diplomiĝintojn	diplom'iĝ'int'o'j'n
diplomita	diplom'it'a
diplomitaj	diplom'it'a'j
diplomite	diplom'it'e
diplomito	diplom'it'o
diplomitoj	diplom'it'o'j
diplomitiĝis	diplom'it'iĝ'is
diplomitiĝo	diplom'it'iĝ'o
diplomata	diplomat'a
diplomataj	diplomat'a'j
diplomatajn	diplomat'a'j'n
diplomatan	diplomat'a'n
diplomate	diplomat'e
diplomato	diplomat'o
diplomatoj	diplomat'o'j
diplomatojn	diplomat'o'j'n
diplomataro	diplomat'ar'o
diplomatia	diplomat'i'a
diplomatiaj	diplomat'i'a'j
diplomatiajn	diplomat'i'a'j'n
diplomatian	diplomat'i'a'n
diplomatie	diplomat'i'e
diplomatio	diplomat'i'o
diplomation	diplomat'i'o'n
dipolo	dipol'o
dipoloj	dipol'o'j
dipolon	dipol'o'n
diras	dir'as
dire	dir'e
diri	dir'i
diris	dir'is
diro	dir'o
diroj	dir'o'j
dirojn	dir'o'j'n
diron	dir'o'n
diros	dir'os
diru	dir'u
dirus	dir'us
diradas	dir'ad'as
diradi	dir'ad'i
diradis	dir'ad'is
dirado	dir'ad'o
diraĵo	dir'aĵ'o
diraĵoj	dir'aĵ'o'j
diraĵojn	dir'aĵ'o'j'n
diraĵon	dir'aĵ'o'n
diranta	dir'ant'a
dirantaj	dir'ant'a'j
dirantan	dir'ant'a'n
dirante	dir'ant'e
dirata	dir'at'a
dirataj	dir'at'a'j
dirate	dir'at'e
direbla	dir'ebl'a
direblas	dir'ebl'as
direnda	dir'end'a
direndan	dir'end'a'n
direndas	dir'end'as
diriĝas	dir'iĝ'as
diriĝis	dir'iĝ'is
dirinda	dir'ind'a
dirindan	dir'ind'a'n
dirinta	dir'int'a
dirintaj	dir'int'a'j
dirinte	dir'int'e
dirintus	dir'int'us
dirita	dir'it'a
diritaj	dir'it'a'j
diritajn	dir'it'a'j'n
diritan	dir'it'a'n
dirite	dir'it'e
dirmaniero	dir'manier'o
dirmanieroj	dir'manier'o'j
dirmanieron	dir'manier'o'n
dironta	dir'ont'a
diraka	dirak'a
dirako	dirak'o
direkcio	direkci'o
direkcioj	direkci'o'j
direkta	direkt'a
direktaj	direkt'a'j
direktan	direkt'a'n
direktas	direkt'as
direkte	direkt'e
direkten	direkt'e'n
direkti	direkt'i
direktis	direkt'is
direkto	direkt'o
direktoj	direkt'o'j
direktojn	direkt'o'j'n
direkton	direkt'o'n
direktos	direkt'os
direktu	direkt'u
direktus	direkt'us
direktado	direkt'ad'o
direktadon	direkt'ad'o'n
direktanta	direkt'ant'a
direktantaj	direkt'ant'a'j
direktante	direkt'ant'e
direktanto	direkt'ant'o
direktata	direkt'at'a
direktataj	direkt'at'a'j
direktebla	direkt'ebl'a
direkteblaj	direkt'ebl'a'j
direkteco	direkt'ec'o
direktecon	direkt'ec'o'n
direktejo	direkt'ej'o
direktiĝas	direkt'iĝ'as
direktiĝi	direkt'iĝ'i
direktiĝis	direkt'iĝ'is
direktiĝante	direkt'iĝ'ant'e
direktilo	direkt'il'o
direktilisto	direkt'il'ist'o
direktinte	direkt'int'e
direktisto	direkt'ist'o
direktistoj	direkt'ist'o'j
direktistojn	direkt'ist'o'j'n
direktiston	direkt'ist'o'n
direktita	direkt'it'a
direktitaj	direkt'it'a'j
direktitajn	direkt'it'a'j'n
direktitan	direkt'it'a'n
direktite	direkt'it'e
direktivo	direktiv'o
direktivoj	direktiv'o'j
direktivojn	direktiv'o'j'n
direktivon	direktiv'o'n
direktora	direktor'a
direktoro	direktor'o
direktoroj	direktor'o'j
direktorojn	direktor'o'j'n
direktoron	direktor'o'n
direktoraro	direktor'ar'o
direktoraron	direktor'ar'o'n
direktorino	direktor'in'o
dirigento	dirigent'o
dirigentoj	dirigent'o'j
dirlididi	dirlididi
disa	dis'a
disaj	dis'a'j
disajn	dis'a'j'n
disan	dis'a'n
disas	dis'as
disde	dis'de
dise	dis'e
disen	dis'e'n
disaŭdiga	dis'aŭd'ig'a
disaŭdigas	dis'aŭd'ig'as
disaŭdigi	dis'aŭd'ig'i
disaŭdigo	dis'aŭd'ig'o
disaŭdigoj	dis'aŭd'ig'o'j
disaŭdigon	dis'aŭd'ig'o'n
disbatas	dis'bat'as
disbati	dis'bat'i
disbatis	dis'bat'is
disbatos	dis'bat'os
disbatita	dis'bat'it'a
disbatitaj	dis'bat'it'a'j
disbranĉigas	dis'branĉ'ig'as
disbranĉigis	dis'branĉ'ig'is
disbranĉigo	dis'branĉ'ig'o
disbranĉiĝas	dis'branĉ'iĝ'as
disbranĉita	dis'branĉ'it'a
disbranĉitaj	dis'branĉ'it'a'j
discentra	dis'centr'a
discentreco	dis'centr'ec'o
disdividas	dis'divid'as
disdividi	dis'divid'i
disdividis	dis'divid'is
disdivido	dis'divid'o
disdividoj	dis'divid'o'j
disdividon	dis'divid'o'n
disdividita	dis'divid'it'a
disdividitaj	dis'divid'it'a'j
disdonas	dis'don'as
disdoni	dis'don'i
disdonis	dis'don'is
disdono	dis'don'o
disdonon	dis'don'o'n
disdonos	dis'don'os
disdonu	dis'don'u
disdonus	dis'don'us
disdonadi	dis'don'ad'i
disdonadis	dis'don'ad'is
disdonado	dis'don'ad'o
disdonadon	dis'don'ad'o'n
disdonanta	dis'don'ant'a
disdonante	dis'don'ant'e
disdonanto	dis'don'ant'o
disdonata	dis'don'at'a
disdonataj	dis'don'at'a'j
disdonita	dis'don'it'a
disdonitaj	dis'don'it'a'j
diseco	dis'ec'o
diserigas	dis'er'ig'as
diserigi	dis'er'ig'i
diserigis	dis'er'ig'is
diserigita	dis'er'ig'it'a
diseriĝas	dis'er'iĝ'as
diseriĝi	dis'er'iĝ'i
diseriĝis	dis'er'iĝ'is
diseriĝo	dis'er'iĝ'o
diseriĝanta	dis'er'iĝ'ant'a
disetendas	dis'etend'as
disetendis	dis'etend'is
disetendiĝas	dis'etend'iĝ'as
disetendiĝi	dis'etend'iĝ'i
disetendiĝis	dis'etend'iĝ'is
disetendiĝus	dis'etend'iĝ'us
disetendiĝado	dis'etend'iĝ'ad'o
disetendiĝanta	dis'etend'iĝ'ant'a
disetendiĝante	dis'etend'iĝ'ant'e
disetenditaj	dis'etend'it'a'j
disfalas	dis'fal'as
disfali	dis'fal'i
disfalis	dis'fal'is
disfalo	dis'fal'o
disfalon	dis'fal'o'n
disfalos	dis'fal'os
disfalus	dis'fal'us
disfalanta	dis'fal'ant'a
disfaligi	dis'fal'ig'i
disfaligis	dis'fal'ig'is
disfaligita	dis'fal'ig'it'a
disfaligitaj	dis'fal'ig'it'a'j
disfalinta	dis'fal'int'a
disfalintaj	dis'fal'int'a'j
disfalonta	dis'fal'ont'a
disfaldis	dis'fald'is
disfendas	dis'fend'as
disfendi	dis'fend'i
disfendis	dis'fend'is
disfendado	dis'fend'ad'o
disfendante	dis'fend'ant'e
disfendita	dis'fend'it'a
disfenditaj	dis'fend'it'a'j
disflori	dis'flor'i
disfloro	dis'flor'o
disfluas	dis'flu'as
disfluis	dis'flu'is
disflugis	dis'flug'is
dishakis	dis'hak'is
disiga	dis'ig'a
disigaj	dis'ig'a'j
disigan	dis'ig'a'n
disigas	dis'ig'as
disigi	dis'ig'i
disigis	dis'ig'is
disigo	dis'ig'o
disigoj	dis'ig'o'j
disigojn	dis'ig'o'j'n
disigon	dis'ig'o'n
disigos	dis'ig'os
disigu	dis'ig'u
disigado	dis'ig'ad'o
disiganta	dis'ig'ant'a
disigantaj	dis'ig'ant'a'j
disigantan	dis'ig'ant'a'n
disigante	dis'ig'ant'e
disigata	dis'ig'at'a
disigebla	dis'ig'ebl'a
disigeblaj	dis'ig'ebl'a'j
disigeblas	dis'ig'ebl'as
disigita	dis'ig'it'a
disigitaj	dis'ig'it'a'j
disigitajn	dis'ig'it'a'j'n
disigitan	dis'ig'it'a'n
disigite	dis'ig'it'e
disiĝas	dis'iĝ'as
disiĝi	dis'iĝ'i
disiĝis	dis'iĝ'is
disigho	dis'iĝ'o
disiĝo	dis'iĝ'o
disiĝoj	dis'iĝ'o'j
disiĝon	dis'iĝ'o'n
disiĝos	dis'iĝ'os
disiĝu	dis'iĝ'u
disiĝus	dis'iĝ'us
disiĝante	dis'iĝ'ant'e
disiĝinta	dis'iĝ'int'a
disiĝintaj	dis'iĝ'int'a'j
disiras	dis'ir'as
disiri	dis'ir'i
disiris	dis'ir'is
disiru	dis'ir'u
disirantaj	dis'ir'ant'a'j
disĵetas	dis'ĵet'as
disĵeti	dis'ĵet'i
disĵetis	dis'ĵet'is
disĵeto	dis'ĵet'o
disĵetu	dis'ĵet'u
disĵetitaj	dis'ĵet'it'a'j
disĵetitajn	dis'ĵet'it'a'j'n
diskonigas	dis'kon'ig'as
diskonigi	dis'kon'ig'i
diskonigis	dis'kon'ig'is
diskonigo	dis'kon'ig'o
diskonigon	dis'kon'ig'o'n
diskonigos	dis'kon'ig'os
diskonigu	dis'kon'ig'u
diskonigado	dis'kon'ig'ad'o
diskonigata	dis'kon'ig'at'a
diskonigita	dis'kon'ig'it'a
diskonigitaj	dis'kon'ig'it'a'j
diskoniĝis	dis'kon'iĝ'is
diskuras	dis'kur'as
diskuris	dis'kur'is
dislimo	dis'lim'o
dislimon	dis'lim'o'n
dislokiĝas	dis'lok'iĝ'as
dislokitaj	dis'lok'it'a'j
dismeti	dis'met'i
dismetis	dis'met'is
dismeto	dis'met'o
dismetita	dis'met'it'a
dismetitaj	dis'met'it'a'j
dismovis	dis'mov'is
disopinieco	dis'opini'ec'o
disopiniecon	dis'opini'ec'o'n
dispartigas	dis'part'ig'as
dispartigi	dis'part'ig'i
dispartigis	dis'part'ig'is
dispartigo	dis'part'ig'o
dispartigoj	dis'part'ig'o'j
dispartigon	dis'part'ig'o'n
dispartigita	dis'part'ig'it'a
dispartigitaj	dis'part'ig'it'a'j
dispartiĝas	dis'part'iĝ'as
dispecigas	dis'pec'ig'as
dispecigi	dis'pec'ig'i
dispecigis	dis'pec'ig'is
dispecigo	dis'pec'ig'o
dispecigita	dis'pec'ig'it'a
dispecigitaj	dis'pec'ig'it'a'j
dispeciĝis	dis'pec'iĝ'is
dispelas	dis'pel'as
dispeli	dis'pel'i
dispelis	dis'pel'is
disportas	dis'port'as
disportis	dis'port'is
dispremas	dis'prem'as
dispremi	dis'prem'i
dispremis	dis'prem'is
dispremos	dis'prem'os
dispremado	dis'prem'ad'o
dispremante	dis'prem'ant'e
dispremita	dis'prem'it'a
dispremitaj	dis'prem'it'a'j
disrabado	dis'rab'ad'o
disradias	dis'radi'as
disradiis	dis'radi'is
disrevigita	dis'rev'ig'it'a
disreviĝo	dis'rev'iĝ'o
disrompas	dis'romp'as
disrompi	dis'romp'i
disrompis	dis'romp'is
disrompo	dis'romp'o
disrompon	dis'romp'o'n
disrompiĝis	dis'romp'iĝ'is
disrompiĝo	dis'romp'iĝ'o
disrompiĝon	dis'romp'iĝ'o'n
disrompita	dis'romp'it'a
disrompitaj	dis'romp'it'a'j
dissekci	dis'sekc'i
dissekcita	dis'sekc'it'a
dissekcio	dis'sekci'o
dissemas	dis'sem'as
dissemi	dis'sem'i
dissemis	dis'sem'is
dissemado	dis'sem'ad'o
dissemataj	dis'sem'at'a'j
dissemiĝas	dis'sem'iĝ'as
dissemita	dis'sem'it'a
dissemitaj	dis'sem'it'a'j
dissenda	dis'send'a
dissendas	dis'send'as
dissendi	dis'send'i
dissendis	dis'send'is
dissendo	dis'send'o
dissendoj	dis'send'o'j
dissendojn	dis'send'o'j'n
dissendon	dis'send'o'n
dissendos	dis'send'os
dissendado	dis'send'ad'o
dissendadon	dis'send'ad'o'n
dissendanta	dis'send'ant'a
dissendante	dis'send'ant'e
dissendanto	dis'send'ant'o
dissendantoj	dis'send'ant'o'j
dissendata	dis'send'at'a
dissendataj	dis'send'at'a'j
dissendilo	dis'send'il'o
dissendiloj	dis'send'il'o'j
dissendilojn	dis'send'il'o'j'n
dissendilon	dis'send'il'o'n
dissendita	dis'send'it'a
dissenditaj	dis'send'it'a'j
dissendolisto	dis'send'o'list'o
dissendolistoj	dis'send'o'list'o'j
dissendoliston	dis'send'o'list'o'n
disŝiras	dis'ŝir'as
disŝiri	dis'ŝir'i
disŝiris	dis'ŝir'is
disŝiro	dis'ŝir'o
disŝiros	dis'ŝir'os
disŝiru	dis'ŝir'u
disŝirante	dis'ŝir'ant'e
disŝirata	dis'ŝir'at'a
disŝiriĝas	dis'ŝir'iĝ'as
disŝiriĝi	dis'ŝir'iĝ'i
disŝiriĝis	dis'ŝir'iĝ'is
disŝirita	dis'ŝir'it'a
disŝiritaj	dis'ŝir'it'a'j
disŝiritan	dis'ŝir'it'a'n
dissolvas	dis'solv'as
dissolvi	dis'solv'i
dissolvis	dis'solv'is
dissolvo	dis'solv'o
dissolvon	dis'solv'o'n
dissolvado	dis'solv'ad'o
dissolvante	dis'solv'ant'e
dissolviĝas	dis'solv'iĝ'as
dissolviĝi	dis'solv'iĝ'i
dissolviĝis	dis'solv'iĝ'is
dissolviĝo	dis'solv'iĝ'o
dissolvita	dis'solv'it'a
dissolvitaj	dis'solv'it'a'j
dissolvitan	dis'solv'it'a'n
disŝuti	dis'ŝut'i
disŝutis	dis'ŝut'is
disŝutiĝis	dis'ŝut'iĝ'is
disŝutitaj	dis'ŝut'it'a'j
distranĉas	dis'tranĉ'as
distranĉi	dis'tranĉ'i
distranĉis	dis'tranĉ'is
distranĉu	dis'tranĉ'u
distranĉado	dis'tranĉ'ad'o
distranĉante	dis'tranĉ'ant'e
distranĉita	dis'tranĉ'it'a
distranĉitaj	dis'tranĉ'it'a'j
distrumpetas	dis'trumpet'as
distrumpetis	dis'trumpet'is
disvastiga	dis'vast'ig'a
disvastigaj	dis'vast'ig'a'j
disvastigas	dis'vast'ig'as
disvastigi	dis'vast'ig'i
disvastigis	dis'vast'ig'is
disvastigo	dis'vast'ig'o
disvastigon	dis'vast'ig'o'n
disvastigos	dis'vast'ig'os
disvastigu	dis'vast'ig'u
disvastigus	dis'vast'ig'us
disvastigado	dis'vast'ig'ad'o
disvastigadon	dis'vast'ig'ad'o'n
disvastiganta	dis'vast'ig'ant'a
disvastigantaj	dis'vast'ig'ant'a'j
disvastigante	dis'vast'ig'ant'e
disvastiganto	dis'vast'ig'ant'o
disvastigantoj	dis'vast'ig'ant'o'j
disvastigata	dis'vast'ig'at'a
disvastigataj	dis'vast'ig'at'a'j
disvastigejo	dis'vast'ig'ej'o
disvastigita	dis'vast'ig'it'a
disvastigitaj	dis'vast'ig'it'a'j
disvastigitajn	dis'vast'ig'it'a'j'n
disvastigite	dis'vast'ig'it'e
disvastigmeĥanismoj	dis'vast'ig'meĥanism'o'j
disvastiĝas	dis'vast'iĝ'as
disvastiĝi	dis'vast'iĝ'i
disvastiĝis	dis'vast'iĝ'is
disvastigho	dis'vast'iĝ'o
disvastiĝo	dis'vast'iĝ'o
disvastiĝon	dis'vast'iĝ'o'n
disvastiĝos	dis'vast'iĝ'os
disvastiĝu	dis'vast'iĝ'u
disvastiĝus	dis'vast'iĝ'us
disvastiĝado	dis'vast'iĝ'ad'o
disvastiĝanta	dis'vast'iĝ'ant'a
disvastiĝante	dis'vast'iĝ'ant'e
disvastiĝinta	dis'vast'iĝ'int'a
disvastiĝintaj	dis'vast'iĝ'int'a'j
disvastiĝintan	dis'vast'iĝ'int'a'n
disvastiĝite	dis'vast'iĝ'it'e
disvendis	dis'vend'is
disvendado	dis'vend'ad'o
disvendiĝas	dis'vend'iĝ'as
disvenkis	dis'venk'is
disvenkita	dis'venk'it'a
disvenkitaj	dis'venk'it'a'j
disverŝas	dis'verŝ'as
disverŝi	dis'verŝ'i
disverŝis	dis'verŝ'is
disverŝiĝas	dis'verŝ'iĝ'as
disverŝiĝis	dis'verŝ'iĝ'is
disverŝita	dis'verŝ'it'a
disvolva	dis'volv'a
disvolvaj	dis'volv'a'j
disvolvajn	dis'volv'a'j'n
disvolvan	dis'volv'a'n
disvolvas	dis'volv'as
disvolvi	dis'volv'i
disvolvis	dis'volv'is
disvolvo	dis'volv'o
disvolvon	dis'volv'o'n
disvolvos	dis'volv'os
disvolvu	dis'volv'u
disvolvado	dis'volv'ad'o
disvolvadon	dis'volv'ad'o'n
disvolvaĵo	dis'volv'aĵ'o
disvolvante	dis'volv'ant'e
disvolvata	dis'volv'at'a
disvolvigas	dis'volv'ig'as
disvolvigi	dis'volv'ig'i
disvolvigis	dis'volv'ig'is
disvolvigo	dis'volv'ig'o
disvolvigoj	dis'volv'ig'o'j
disvolvigon	dis'volv'ig'o'n
disvolvigita	dis'volv'ig'it'a
disvolvigitaj	dis'volv'ig'it'a'j
disvolviĝa	dis'volv'iĝ'a
disvolviĝas	dis'volv'iĝ'as
disvolviĝi	dis'volv'iĝ'i
disvolviĝis	dis'volv'iĝ'is
disvolvigho	dis'volv'iĝ'o
disvolviĝo	dis'volv'iĝ'o
disvolviĝoj	dis'volv'iĝ'o'j
disvolviĝon	dis'volv'iĝ'o'n
disvolviĝos	dis'volv'iĝ'os
disvolviĝu	dis'volv'iĝ'u
disvolviĝado	dis'volv'iĝ'ad'o
disvolviĝadon	dis'volv'iĝ'ad'o'n
disvolviĝanta	dis'volv'iĝ'ant'a
disvolviĝantaj	dis'volv'iĝ'ant'a'j
disvolviĝantan	dis'volv'iĝ'ant'a'n
disvolviĝbiologio	dis'volv'iĝ'biolog'i'o
disvolviĝinta	dis'volv'iĝ'int'a
disvolviĝintaj	dis'volv'iĝ'int'a'j
disvolvita	dis'volv'it'a
disvolvitaj	dis'volv'it'a'j
disĉiplo	disĉipl'o
disĉiploj	disĉipl'o'j
disĉiplojn	disĉipl'o'j'n
disĉiplon	disĉipl'o'n
disciplina	disciplin'a
disciplinaj	disciplin'a'j
disciplinajn	disciplin'a'j'n
disciplinan	disciplin'a'n
discipline	disciplin'e
disciplini	disciplin'i
disciplinis	disciplin'is
disciplino	disciplin'o
disciplinoj	disciplin'o'j
disciplinojn	disciplin'o'j'n
disciplinon	disciplin'o'n
disciplinita	disciplin'it'a
disciplinitaj	disciplin'it'a'j
disenterio	disenteri'o
disertaĵo	disert'aĵ'o
disertaĵoj	disert'aĵ'o'j
disertaĵojn	disert'aĵ'o'j'n
disertaĵon	disert'aĵ'o'n
disertacio	disertaci'o
disertacioj	disertaci'o'j
disertacion	disertaci'o'n
disforio	disfori'o
disgrafio	disgrafi'o
disidenta	disident'a
disidentaj	disident'a'j
disidento	disident'o
disidentoj	disident'o'j
disidentojn	disident'o'j'n
disipas	disip'as
disipi	disip'i
disipis	disip'is
disipado	disip'ad'o
disipita	disip'it'a
diska	disk'a
diskaj	disk'a'j
diskan	disk'a'n
diski	disk'i
diskis	disk'is
disko	disk'o
diskoj	disk'o'j
diskojn	disk'o'j'n
diskon	disk'o'n
diskaparato	disk'aparat'o
diskaparatoj	disk'aparat'o'j
diskejo	disk'ej'o
diskeldonejo	disk'el'don'ej'o
disketo	disk'et'o
disketoj	disk'et'o'j
disketon	disk'et'o'n
diskilo	disk'il'o
diskiloj	disk'il'o'j
diskisto	disk'ist'o
diskistoj	disk'ist'o'j
diskĵokeo	disk'ĵoke'o
diskokompanioj	disk'o'kompani'o'j
diskoteko	disk'o'tek'o
diskotekoj	disk'o'tek'o'j
diskotekon	disk'o'tek'o'n
disktelero	disk'teler'o
diskteleroj	disk'teler'o'j
diskalkulio	diskalkuli'o
diskanto	diskant'o
diskedo	disked'o
diskreta	diskret'a
diskretaj	diskret'a'j
diskretajn	diskret'a'j'n
diskretan	diskret'a'n
diskrete	diskret'e
diskreteco	diskret'ec'o
diskretecon	diskret'ec'o'n
diskriminado	diskrimin'ad'o
diskriminanta	diskrimin'ant'a
diskriminacia	diskriminaci'a
diskriminaciaj	diskriminaci'a'j
diskriminaciajn	diskriminaci'a'j'n
diskriminacias	diskriminaci'as
diskriminacii	diskriminaci'i
diskriminaciis	diskriminaci'is
diskriminacio	diskriminaci'o
diskriminacioj	diskriminaci'o'j
diskriminaciojn	diskriminaci'o'j'n
diskriminacion	diskriminaci'o'n
diskriminaciu	diskriminaci'u
diskriminaciado	diskriminaci'ad'o
diskriminaciataj	diskriminaci'at'a'j
diskriminaciitaj	diskriminaci'it'a'j
diskurso	diskurs'o
diskursoj	diskurs'o'j
diskursojn	diskurs'o'j'n
diskurson	diskurs'o'n
diskursiva	diskursiv'a
diskuta	diskut'a
diskutaj	diskut'a'j
diskutas	diskut'as
diskuti	diskut'i
diskutis	diskut'is
diskuto	diskut'o
diskutoj	diskut'o'j
diskutojn	diskut'o'j'n
diskuton	diskut'o'n
diskutos	diskut'os
diskutu	diskut'u
diskutus	diskut'us
diskutadas	diskut'ad'as
diskutadi	diskut'ad'i
diskutadis	diskut'ad'is
diskutado	diskut'ad'o
diskutadoj	diskut'ad'o'j
diskutadon	diskut'ad'o'n
diskutanta	diskut'ant'a
diskutantaj	diskut'ant'a'j
diskutante	diskut'ant'e
diskutanto	diskut'ant'o
diskutantoj	diskut'ant'o'j
diskutata	diskut'at'a
diskutataj	diskut'at'a'j
diskutebla	diskut'ebl'a
diskuteblaj	diskut'ebl'a'j
diskuteblas	diskut'ebl'as
diskuteble	diskut'ebl'e
diskutejo	diskut'ej'o
diskutejoj	diskut'ej'o'j
diskutenda	diskut'end'a
diskutforumo	diskut'forum'o
diskutgrupo	diskut'grup'o
diskutgrupoj	diskut'grup'o'j
diskutigi	diskut'ig'i
diskutinda	diskut'ind'a
diskutindaj	diskut'ind'a'j
diskutindas	diskut'ind'as
diskutita	diskut'it'a
diskutitaj	diskut'it'a'j
diskutite	diskut'it'e
diskutlisto	diskut'list'o
diskutlistoj	diskut'list'o'j
diskutota	diskut'ot'a
diskutpaĝo	diskut'paĝ'o
diskutrondoj	diskut'rond'o'j
diskuttemo	diskut'tem'o
diskuttemoj	diskut'tem'o'j
disleksia	disleksi'a
disleksio	disleksi'o
disleksiuloj	disleksi'ul'o'j
disonanco	disonanc'o
disonancoj	disonanc'o'j
dispepsio	dispepsi'o
dispersi	dispers'i
disperso	dispers'o
disperson	dispers'o'n
dispneo	dispne'o
disponas	dispon'as
disponi	dispon'i
disponis	dispon'is
dispono	dispon'o
disponoj	dispon'o'j
disponojn	dispon'o'j'n
disponon	dispon'o'n
disponos	dispon'os
disponu	dispon'u
disponus	dispon'us
disponado	dispon'ad'o
disponante	dispon'ant'e
disponebla	dispon'ebl'a
disponeblaj	dispon'ebl'a'j
disponeblajn	dispon'ebl'a'j'n
disponeblan	dispon'ebl'a'n
disponeblas	dispon'ebl'as
disponeblis	dispon'ebl'is
disponeblo	dispon'ebl'o
disponeblon	dispon'ebl'o'n
disponeblos	dispon'ebl'os
disponebleco	dispon'ebl'ec'o
disponeblecon	dispon'ebl'ec'o'n
disponigas	dispon'ig'as
disponigi	dispon'ig'i
disponigis	dispon'ig'is
disponigo	dispon'ig'o
disponigos	dispon'ig'os
disponigu	dispon'ig'u
disponigus	dispon'ig'us
disponigado	dispon'ig'ad'o
disponiganta	dispon'ig'ant'a
disponigantaj	dispon'ig'ant'a'j
disponigantan	dispon'ig'ant'a'n
disponigante	dispon'ig'ant'e
disponigata	dispon'ig'at'a
disponigita	dispon'ig'it'a
disponigitaj	dispon'ig'it'a'j
disponigitajn	dispon'ig'it'a'j'n
disponigitan	dispon'ig'it'a'n
disponigite	dispon'ig'it'e
disponitaj	dispon'it'a'j
dispozicias	dispozici'as
dispozicio	dispozici'o
dispozicioj	dispozici'o'j
dispoziciojn	dispozici'o'j'n
dispozicion	dispozici'o'n
dispoziciitaj	dispozici'it'a'j
disputas	disput'as
disputi	disput'i
disputis	disput'is
disputo	disput'o
disputoj	disput'o'j
disputojn	disput'o'j'n
disputon	disput'o'n
disputos	disput'os
disputu	disput'u
disputadis	disput'ad'is
disputado	disput'ad'o
disputantaj	disput'ant'a'j
disputante	disput'ant'e
disputantoj	disput'ant'o'j
disputata	disput'at'a
disputataj	disput'at'a'j
disputebla	disput'ebl'a
disputema	disput'em'a
disputiga	disput'ig'a
disputigaj	disput'ig'a'j
disputita	disput'it'a
disputitaj	disput'it'a'j
dista	dist'a
diste	dist'e
distanca	distanc'a
distancaj	distanc'a'j
distancas	distanc'as
distance	distanc'e
distancis	distanc'is
distanco	distanc'o
distancoj	distanc'o'j
distancojn	distanc'o'j'n
distancon	distanc'o'n
distanceduko	distanc'eduk'o
distancigas	distanc'ig'as
distancigi	distanc'ig'i
distancigis	distanc'ig'is
distancigita	distanc'ig'it'a
distancigitaj	distanc'ig'it'a'j
distanciĝas	distanc'iĝ'as
distanciĝi	distanc'iĝ'i
distanciĝis	distanc'iĝ'is
distanciĝo	distanc'iĝ'o
distanciĝon	distanc'iĝ'o'n
distancsondado	distanc'sond'ad'o
distilas	distil'as
distili	distil'i
distilado	distil'ad'o
distilejoj	distil'ej'o'j
distilita	distil'it'a
distilitaj	distil'it'a'j
distinga	disting'a
distingaj	disting'a'j
distingajn	disting'a'j'n
distingan	disting'a'n
distingas	disting'as
distinge	disting'e
distingi	disting'i
distingis	disting'is
distingo	disting'o
distingoj	disting'o'j
distingojn	disting'o'j'n
distingon	disting'o'n
distingos	disting'os
distingu	disting'u
distingus	disting'us
distingado	disting'ad'o
distinganta	disting'ant'a
distingante	disting'ant'e
distingata	disting'at'a
distingataj	disting'at'a'j
distingebla	disting'ebl'a
distingeblaj	disting'ebl'a'j
distingeblajn	disting'ebl'a'j'n
distingeblas	disting'ebl'as
distingigas	disting'ig'as
distingiĝa	disting'iĝ'a
distingiĝaj	disting'iĝ'a'j
distingiĝan	disting'iĝ'a'n
distingiĝas	disting'iĝ'as
distingiĝi	disting'iĝ'i
distingiĝis	disting'iĝ'is
distingilo	disting'il'o
distingiloj	disting'il'o'j
distingita	disting'it'a
distingitaj	disting'it'a'j
distingite	disting'it'e
distordas	distord'as
distordi	distord'i
distordis	distord'is
distordo	distord'o
distordado	distord'ad'o
distordante	distord'ant'e
distordita	distord'it'a
distorditaj	distord'it'a'j
distorditan	distord'it'a'n
distra	distr'a
distraj	distr'a'j
distrajn	distr'a'j'n
distran	distr'a'n
distras	distr'as
distre	distr'e
distri	distr'i
distris	distr'is
distro	distr'o
distroj	distr'o'j
distrojn	distr'o'j'n
distron	distr'o'n
distru	distr'u
distrado	distr'ad'o
distradon	distr'ad'o'n
distraĵo	distr'aĵ'o
distraĵoj	distr'aĵ'o'j
distraĵojn	distr'aĵ'o'j'n
distraĵon	distr'aĵ'o'n
distrante	distr'ant'e
distreco	distr'ec'o
distrejoj	distr'ej'o'j
distriĝas	distr'iĝ'as
distriĝi	distr'iĝ'i
distriĝis	distr'iĝ'is
distriĝo	distr'iĝ'o
distriĝon	distr'iĝ'o'n
distriĝema	distr'iĝ'em'a
distriĝemo	distr'iĝ'em'o
distrita	distr'it'a
distritaj	distr'it'a'j
distrite	distr'it'e
distribua	distribu'a
distribuaj	distribu'a'j
distribuajn	distribu'a'j'n
distribuan	distribu'a'n
distribuas	distribu'as
distribui	distribu'i
distribuis	distribu'is
distribuo	distribu'o
distribuoj	distribu'o'j
distribuojn	distribu'o'j'n
distribuon	distribu'o'n
distribuos	distribu'os
distribuu	distribu'u
distribuado	distribu'ad'o
distribuadoj	distribu'ad'o'j
distribuadon	distribu'ad'o'n
distribuaĵoj	distribu'aĵ'o'j
distribuante	distribu'ant'e
distribuanto	distribu'ant'o
distribuata	distribu'at'a
distribuataj	distribu'at'a'j
distribufunkcio	distribu'funkci'o
distribuiĝas	distribu'iĝ'as
distribuisto	distribu'ist'o
distribuistoj	distribu'ist'o'j
distribuita	distribu'it'a
distribuitaj	distribu'it'a'j
distribuitajn	distribu'it'a'j'n
distribuitan	distribu'it'a'n
distribusistemo	distribu'sistem'o
distribusistemoj	distribu'sistem'o'j
distrikta	distrikt'a
distriktaj	distrikt'a'j
distriktan	distrikt'a'n
distrikto	distrikt'o
distriktoj	distrikt'o'j
distriktojn	distrikt'o'j'n
distrikton	distrikt'o'n
distriktaro	distrikt'ar'o
distriktestro	distrikt'estr'o
distriktjuĝejo	distrikt'juĝ'ej'o
distriktjuĝejoj	distrikt'juĝ'ej'o'j
diurne	diurn'e
diurno	diurn'o
diurnoj	diurn'o'j
divano	divan'o
divanon	divan'o'n
divenas	diven'as
diveni	diven'i
divenis	diven'is
diveno	diven'o
divenoj	diven'o'j
divenojn	diven'o'j'n
divenon	diven'o'n
divenos	diven'os
divenu	diven'u
divenus	diven'us
divenado	diven'ad'o
divenante	diven'ant'e
divenebla	diven'ebl'a
diveninte	diven'int'e
divenisto	diven'ist'o
divenistoj	diven'ist'o'j
diverĝa	diverĝ'a
diverĝaj	diverĝ'a'j
diverĝajn	diverĝ'a'j'n
diverĝan	diverĝ'a'n
diverĝas	diverĝ'as
diverĝi	diverĝ'i
diverĝis	diverĝ'is
diverĝo	diverĝ'o
diverĝoj	diverĝ'o'j
diverĝojn	diverĝ'o'j'n
diverĝon	diverĝ'o'n
diversa	divers'a
diversaj	divers'a'j
diversajn	divers'a'j'n
diversan	divers'a'n
diversas	divers'as
diverse	divers'e
diversaĝaj	divers'aĝ'a'j
diversaĵoj	divers'aĵ'o'j
diversaĵojn	divers'aĵ'o'j'n
diverseca	divers'ec'a
diversece	divers'ec'e
diverseco	divers'ec'o
diversecoj	divers'ec'o'j
diversecon	divers'ec'o'n
diversflanka	divers'flank'a
diversflanke	divers'flank'e
diversflanken	divers'flank'e'n
diversfoje	divers'foj'e
diversformaj	divers'form'a'j
diversformajn	divers'form'a'j'n
diversgradaj	divers'grad'a'j
diversgrade	divers'grad'e
diversgrandaj	divers'grand'a'j
diversigi	divers'ig'i
diversigis	divers'ig'is
diversigo	divers'ig'o
diversigon	divers'ig'o'n
diversiĝis	divers'iĝ'is
diverskolora	divers'kolor'a
diverskoloraj	divers'kolor'a'j
diverskolorajn	divers'kolor'a'j'n
diverskolore	divers'kolor'e
diverslandaj	divers'land'a'j
diverslandajn	divers'land'a'j'n
diverslingva	divers'lingv'a
diverslingvaj	divers'lingv'a'j
diverslingvajn	divers'lingv'a'j'n
diverslingve	divers'lingv'e
diverslokaj	divers'lok'a'j
diverslokajn	divers'lok'a'j'n
diversloke	divers'lok'e
diversmaniere	divers'manier'e
diversnaciaj	divers'naci'a'j
diversnaciecaj	divers'naci'ec'a'j
diversnivelaj	divers'nivel'a'j
diversnivelajn	divers'nivel'a'j'n
diversnivele	divers'nivel'e
diversrondaj	divers'rond'a'j
diversspeca	divers'spec'a
diversspecaj	divers'spec'a'j
diversspecajn	divers'spec'a'j'n
diversstilaj	divers'stil'a'j
diverstalenta	divers'talent'a
diverstemaj	divers'tem'a'j
diverstipaj	divers'tip'a'j
diverstipajn	divers'tip'a'j'n
divida	divid'a
dividaj	divid'a'j
dividas	divid'as
divide	divid'e
dividi	divid'i
dividis	divid'is
divido	divid'o
dividoj	divid'o'j
dividojn	divid'o'j'n
dividon	divid'o'n
dividos	divid'os
dividu	divid'u
dividus	divid'us
dividado	divid'ad'o
dividadon	divid'ad'o'n
dividaĵo	divid'aĵ'o
dividaĵoj	divid'aĵ'o'j
dividanta	divid'ant'a
dividantaj	divid'ant'a'j
dividantan	divid'ant'a'n
dividante	divid'ant'e
dividanto	divid'ant'o
dividata	divid'at'a
dividataj	divid'at'a'j
dividebla	divid'ebl'a
divideblaj	divid'ebl'a'j
divideblas	divid'ebl'as
dividiĝas	divid'iĝ'as
dividiĝi	divid'iĝ'i
dividiĝis	divid'iĝ'is
dividiĝo	divid'iĝ'o
dividita	divid'it'a
dividitaj	divid'it'a'j
dividitajn	divid'it'a'j'n
dividitan	divid'it'a'n
dividite	divid'it'e
dividiteco	divid'it'ec'o
dividostreko	divid'o'strek'o
dividostrekojn	divid'o'strek'o'j'n
dividostrekon	divid'o'strek'o'n
dividendo	dividend'o
dividendoj	dividend'o'j
dividendojn	dividend'o'j'n
dividendon	dividend'o'n
divizio	divizi'o
divizioj	divizi'o'j
divorci	divorc'i
divorcis	divorc'is
divorco	divorc'o
divorcoj	divorc'o'j
divorcon	divorc'o'n
divorcita	divorc'it'a
divorcitaj	divorc'it'a'j
dizajnas	dizajn'as
dizajni	dizajn'i
dizajnis	dizajn'is
dizajno	dizajn'o
dizajnoj	dizajn'o'j
dizajnon	dizajn'o'n
dizajnado	dizajn'ad'o
dizajnante	dizajn'ant'e
dizajnisto	dizajn'ist'o
dizajnistoj	dizajn'ist'o'j
dizajnistojn	dizajn'ist'o'j'n
dizajniston	dizajn'ist'o'n
dizajnita	dizajn'it'a
dizajnitaj	dizajn'it'a'j
dizajnitajn	dizajn'it'a'j'n
dizajnitan	dizajn'it'a'n
dizajnite	dizajn'it'e
dizela	dizel'a
dizelaj	dizel'a'j
dizelo	dizel'o
dizeloj	dizel'o'j
dizellokomotivoj	dizel'lokomotiv'o'j
dizelmotoro	dizel'motor'o
dizelmotoroj	dizel'motor'o'j
dizelmotoron	dizel'motor'o'n
dizeloleo	dizel'ole'o
dizerti	dizert'i
dizertis	dizert'is
dizerto	dizert'o
dizertinto	dizert'int'o
dizertintoj	dizert'int'o'j
do	do
docento	docent'o
docentoj	docent'o'j
dogo	dog'o
doĝo	doĝ'o
dogana	dogan'a
doganaj	dogan'a'j
dogano	dogan'o
doganoj	dogan'o'j
doganon	dogan'o'n
doganejo	dogan'ej'o
doganisto	dogan'ist'o
doganistoj	dogan'ist'o'j
dogma	dogm'a
dogmaj	dogm'a'j
dogme	dogm'e
dogmo	dogm'o
dogmoj	dogm'o'j
dogmojn	dogm'o'j'n
dogmon	dogm'o'n
dogmaro	dogm'ar'o
dogmema	dogm'em'a
dogmismo	dogm'ism'o
dojeno	dojen'o
doko	dok'o
dokoj	dok'o'j
dokon	dok'o'n
dokta	dokt'a
doktora	doktor'a
doktoraj	doktor'a'j
doktorajn	doktor'a'j'n
doktoran	doktor'a'n
doktoro	doktor'o
doktoroj	doktor'o'j
doktorojn	doktor'o'j'n
doktoron	doktor'o'n
doktoreco	doktor'ec'o
doktorecoj	doktor'ec'o'j
doktorecojn	doktor'ec'o'j'n
doktorecon	doktor'ec'o'n
doktoriĝa	doktor'iĝ'a
doktoriĝi	doktor'iĝ'i
doktoriĝis	doktor'iĝ'is
doktoriĝo	doktor'iĝ'o
doktorino	doktor'in'o
doktortraktaĵo	doktor'trakt'aĵ'o
doktrina	doktrin'a
doktrinaj	doktrin'a'j
doktrinajn	doktrin'a'j'n
doktrinan	doktrin'a'n
doktrino	doktrin'o
doktrinoj	doktrin'o'j
doktrinojn	doktrin'o'j'n
doktrinon	doktrin'o'n
doktrineca	doktrin'ec'a
dokumenta	dokument'a
dokumentaj	dokument'a'j
dokumentajn	dokument'a'j'n
dokumentan	dokument'a'n
dokumentas	dokument'as
dokumenti	dokument'i
dokumentis	dokument'is
dokumento	dokument'o
dokumentoj	dokument'o'j
dokumentojn	dokument'o'j'n
dokumenton	dokument'o'n
dokumentado	dokument'ad'o
dokumentadon	dokument'ad'o'n
dokumentaro	dokument'ar'o
dokumentaron	dokument'ar'o'n
dokumentfilmo	dokument'film'o
dokumentfilmon	dokument'film'o'n
dokumentita	dokument'it'a
dokumentitaj	dokument'it'a'j
dokumentitajn	dokument'it'a'j'n
dokumentitan	dokument'it'a'n
dokumentite	dokument'it'e
dokumentujo	dokument'uj'o
dokumentario	dokumentari'o
dokumentarioj	dokumentari'o'j
dokumentariojn	dokumentari'o'j'n
dolara	dolar'a
dolaro	dolar'o
dolaroj	dolar'o'j
dolarojn	dolar'o'j'n
dolaron	dolar'o'n
dolĉa	dolĉ'a
dolĉaj	dolĉ'a'j
dolĉajn	dolĉ'a'j'n
dolĉan	dolĉ'a'n
dolĉas	dolĉ'as
dolĉe	dolĉ'e
dolĉo	dolĉ'o
dolĉon	dolĉ'o'n
dolĉaĵo	dolĉ'aĵ'o
dolĉaĵoj	dolĉ'aĵ'o'j
dolĉaĵojn	dolĉ'aĵ'o'j'n
dolĉaĵon	dolĉ'aĵ'o'n
dolĉakva	dolĉ'akv'a
dolĉakvaj	dolĉ'akv'a'j
dolĉakvo	dolĉ'akv'o
dolĉakvon	dolĉ'akv'o'n
dolĉeca	dolĉ'ec'a
dolĉeco	dolĉ'ec'o
dolĉecon	dolĉ'ec'o'n
dolĉega	dolĉ'eg'a
dolĉigas	dolĉ'ig'as
dolĉigi	dolĉ'ig'i
dolĉigis	dolĉ'ig'is
dolĉigilo	dolĉ'ig'il'o
dolĉigiloj	dolĉ'ig'il'o'j
dolĉigita	dolĉ'ig'it'a
dolinoj	dolin'o'j
dolmeno	dolmen'o
dolmenoj	dolmen'o'j
dolora	dolor'a
doloraj	dolor'a'j
dolorajn	dolor'a'j'n
doloran	dolor'a'n
doloras	dolor'as
dolore	dolor'e
dolori	dolor'i
doloris	dolor'is
doloro	dolor'o
doloroj	dolor'o'j
dolorojn	dolor'o'j'n
doloron	dolor'o'n
doloros	dolor'os
doloranta	dolor'ant'a
doloregas	dolor'eg'as
dolorego	dolor'eg'o
doloregon	dolor'eg'o'n
doloreto	dolor'et'o
doloreton	dolor'et'o'n
doloriga	dolor'ig'a
dolorigaj	dolor'ig'a'j
dolorigan	dolor'ig'a'n
dolorigas	dolor'ig'as
dolorige	dolor'ig'e
dolorigi	dolor'ig'i
dolorigis	dolor'ig'is
dolorigos	dolor'ig'os
dolorplena	dolor'plen'a
dolortelefono	dolor'telefon'o
dolortelefonoj	dolor'telefon'o'j
doma	dom'a
domaj	dom'a'j
domajn	dom'a'j'n
doman	dom'a'n
dome	dom'e
domen	dom'e'n
domo	dom'o
domoj	dom'o'j
domojn	dom'o'j'n
domon	dom'o'n
domaĉo	dom'aĉ'o
domaĉoj	dom'aĉ'o'j
domanoj	dom'an'o'j
domanara	dom'an'ar'a
domanaraj	dom'an'ar'a'j
domanaro	dom'an'ar'o
domanaroj	dom'an'ar'o'j
domanarojn	dom'an'ar'o'j'n
domanaron	dom'an'ar'o'n
domaro	dom'ar'o
domaroj	dom'ar'o'j
domaron	dom'ar'o'n
dombesto	dom'best'o
dombestoj	dom'best'o'j
dombestojn	dom'best'o'j'n
dombiena	dom'bien'a
dombloko	dom'blok'o
domboato	dom'boat'o
domego	dom'eg'o
domegoj	dom'eg'o'j
domegojn	dom'eg'o'j'n
domegon	dom'eg'o'n
dometo	dom'et'o
dometoj	dom'et'o'j
dometojn	dom'et'o'j'n
dometon	dom'et'o'n
domimposto	dom'impost'o
domkatoj	dom'kat'o'j
domkonstruado	dom'konstru'ad'o
dommastro	dom'mastr'o
dommastroj	dom'mastr'o'j
dommastrino	dom'mastr'in'o
dommastrinoj	dom'mastr'in'o'j
dommastrumado	dom'mastr'um'ad'o
dommastrumadon	dom'mastr'um'ad'o'n
domokupado	dom'okup'ad'o
dompasero	dom'paser'o
dompaseroj	dom'paser'o'j
dompordo	dom'pord'o
domposedanto	dom'posed'ant'o
domposedantoj	dom'posed'ant'o'j
domprezo	dom'prez'o
domprezoj	dom'prez'o'j
domservistino	dom'serv'ist'in'o
domservistinoj	dom'serv'ist'in'o'j
domzorgisto	dom'zorg'ist'o
domzorgistoj	dom'zorg'ist'o'j
domaĝa	domaĝ'a
domaĝas	domaĝ'as
domaĝe	domaĝ'e
domaghe	domaĝ'e
domaĝi	domaĝ'i
domaĝis	domaĝ'is
domaĝo	domaĝ'o
domaĝojn	domaĝ'o'j'n
domaĝon	domaĝ'o'n
domaĝu	domaĝ'u
domajna	domajn'a
domajnaj	domajn'a'j
domajnajn	domajn'a'j'n
domajnan	domajn'a'n
domajno	domajn'o
domajnoj	domajn'o'j
domajnojn	domajn'o'j'n
domajnon	domajn'o'n
domajnospecifa	domajn'o'specif'a
domajnospecifaj	domajn'o'specif'a'j
domeno	domen'o
domenoj	domen'o'j
domenon	domen'o'n
domiciano	domician'o
domina	domin'a
dominaj	domin'a'j
dominajn	domin'a'j'n
dominan	domin'a'n
dominas	domin'as
domine	domin'e
domini	domin'i
dominis	domin'is
domino	domin'o
dominos	domin'os
dominus	domin'us
dominado	domin'ad'o
dominadon	domin'ad'o'n
dominaĵo	domin'aĵ'o
dominanta	domin'ant'a
dominantaj	domin'ant'a'j
dominantan	domin'ant'a'n
dominante	domin'ant'e
dominanto	domin'ant'o
dominata	domin'at'a
dominataj	domin'at'a'j
domineco	domin'ec'o
dominecon	domin'ec'o'n
dominema	domin'em'a
dominita	domin'it'a
dominitaj	domin'it'a'j
dominga	doming'a
domingo	doming'o
dominion	domini'o'n
dominika	dominik'a
dominikaj	dominik'a'j
dominiko	dominik'o
dominikana	dominik'an'a
dominikano	dominik'an'o
dominikanoj	dominik'an'o'j
dona	don'a
donas	don'as
doni	don'i
donis	don'is
dono	don'o
donoj	don'o'j
donon	don'o'n
donos	don'os
donu	don'u
donus	don'us
donadas	don'ad'as
donadi	don'ad'i
donadis	don'ad'is
donado	don'ad'o
donadoj	don'ad'o'j
donadon	don'ad'o'n
donaĵo	don'aĵ'o
donaĵoj	don'aĵ'o'j
donanta	don'ant'a
donantaj	don'ant'a'j
donantajn	don'ant'a'j'n
donantan	don'ant'a'n
donante	don'ant'e
donanto	don'ant'o
donantoj	don'ant'o'j
donata	don'at'a
donataj	don'at'a'j
donati	don'at'i
donato	don'at'o
donema	don'em'a
doniĝis	don'iĝ'is
doninta	don'int'a
doninte	don'int'e
doninto	don'int'o
donintus	don'int'us
donita	don'it'a
donitaj	don'it'a'j
donitajn	don'it'a'j'n
donitan	don'it'a'n
donite	don'it'e
donitaĵo	don'it'aĵ'o
donitaĵoj	don'it'aĵ'o'j
donitaĵojn	don'it'aĵ'o'j'n
donaca	donac'a
donacas	donac'as
donace	donac'e
donaci	donac'i
donacis	donac'is
donaco	donac'o
donacoj	donac'o'j
donacojn	donac'o'j'n
donacon	donac'o'n
donacos	donac'os
donacu	donac'u
donacus	donac'us
donacado	donac'ad'o
donacaĵon	donac'aĵ'o'n
donacanta	donac'ant'a
donacante	donac'ant'e
donacanto	donac'ant'o
donacantoj	donac'ant'o'j
donacemo	donac'em'o
donaceto	donac'et'o
donacetoj	donac'et'o'j
donacetojn	donac'et'o'j'n
donaceton	donac'et'o'n
donacinta	donac'int'a
donacinto	donac'int'o
donacintoj	donac'int'o'j
donacita	donac'it'a
donacitaj	donac'it'a'j
donacitajn	donac'it'a'j'n
donacitan	donac'it'a'n
donaldo	donald'o
dongo	dong'o
dongoj	dong'o'j
donjuano	donjuan'o
donkiĥoto	donkiĥot'o
dopado	dop'ad'o
dorlotas	dorlot'as
dorloti	dorlot'i
dorlotis	dorlot'is
dorlotu	dorlot'u
dorlotado	dorlot'ad'o
dorlotata	dorlot'at'a
dorlotbesto	dorlot'best'o
dorlotbestoj	dorlot'best'o'j
dorlotbestojn	dorlot'best'o'j'n
dorlotbeston	dorlot'best'o'n
dorlotita	dorlot'it'a
dorlotitaj	dorlot'it'a'j
dorma	dorm'a
dormas	dorm'as
dorme	dorm'e
dormi	dorm'i
dormis	dorm'is
dormo	dorm'o
dormon	dorm'o'n
dormos	dorm'os
dormu	dorm'u
dormus	dorm'us
dormadis	dorm'ad'is
dormado	dorm'ad'o
dormadon	dorm'ad'o'n
dormanta	dorm'ant'a
dormantaj	dorm'ant'a'j
dormantajn	dorm'ant'a'j'n
dormantan	dorm'ant'a'n
dormante	dorm'ant'e
dormanto	dorm'ant'o
dormantoj	dorm'ant'o'j
dormantojn	dorm'ant'o'j'n
dormanton	dorm'ant'o'n
dormĉambro	dorm'ĉambr'o
dormĉambroj	dorm'ĉambr'o'j
dormĉambron	dorm'ĉambr'o'n
dormegis	dorm'eg'is
dormejo	dorm'ej'o
dormejoj	dorm'ej'o'j
dormejojn	dorm'ej'o'j'n
dormejon	dorm'ej'o'n
dormema	dorm'em'a
dormemaj	dorm'em'a'j
dormemas	dorm'em'as
dormeme	dorm'em'e
dormemis	dorm'em'is
dormemo	dorm'em'o
dormemon	dorm'em'o'n
dormemos	dorm'em'os
dormetas	dorm'et'as
dormeti	dorm'et'i
dormetis	dorm'et'is
dormeto	dorm'et'o
dormeton	dorm'et'o'n
dormetanta	dorm'et'ant'a
dormiga	dorm'ig'a
dormigi	dorm'ig'i
dormigis	dorm'ig'is
dormigilon	dorm'ig'il'o'n
dormiĝo	dorm'iĝ'o
dorminta	dorm'int'a
dormoĉambro	dorm'o'ĉambr'o
dormoĉambroj	dorm'o'ĉambr'o'j
dormoĉambrojn	dorm'o'ĉambr'o'j'n
dormoĉambron	dorm'o'ĉambr'o'n
dormosakoj	dorm'o'sak'o'j
dormosakon	dorm'o'sak'o'n
dorna	dorn'a
dornaj	dorn'a'j
dornan	dorn'a'n
dorno	dorn'o
dornoj	dorn'o'j
dornojn	dorn'o'j'n
dornon	dorn'o'n
dorotea	dorote'a
doroteo	dorote'o
doroteon	dorote'o'n
dorsa	dors'a
dorsaj	dors'a'j
dorsan	dors'a'n
dorse	dors'e
dorsen	dors'e'n
dorso	dors'o
dorsoj	dors'o'j
dorsojn	dors'o'j'n
dorson	dors'o'n
dorsaldorsaj	dors'al'dors'a'j
dorsapogilo	dors'apog'il'o
dorsflanke	dors'flank'e
dorsflanko	dors'flank'o
dorsflankon	dors'flank'o'n
dorsosako	dors'o'sak'o
dorsosakoj	dors'o'sak'o'j
dorsosakojn	dors'o'sak'o'j'n
dorsosakon	dors'o'sak'o'n
dorssurfaco	dors'surfac'o
dosiero	dosier'o
dosieroj	dosier'o'j
dosierojn	dosier'o'j'n
dosieron	dosier'o'n
dosierformato	dosier'format'o
dosierformatoj	dosier'format'o'j
dosiergrandeco	dosier'grand'ec'o
dosiernomo	dosier'nom'o
dosiernomoj	dosier'nom'o'j
dosierpartumo	dosier'part'um'o
dosiersistemo	dosier'sistem'o
dosiersistemoj	dosier'sistem'o'j
dosierujo	dosier'uj'o
dosierujoj	dosier'uj'o'j
dosierujon	dosier'uj'o'n
dotas	dot'as
doti	dot'i
dotis	dot'is
doto	dot'o
dotoj	dot'o'j
dotojn	dot'o'j'n
doton	dot'o'n
dotita	dot'it'a
dotitaj	dot'it'a'j
dovero	dover'o
dozo	doz'o
dozoj	doz'o'j
dozojn	doz'o'j'n
dozon	doz'o'n
dragan	drag'a'n
drago	drag'o
dragon	drag'o'n
dragado	drag'ad'o
dragota	drag'ot'a
dragotan	drag'ot'a'n
dragonoj	dragon'o'j
draka	drak'a
drakaj	drak'a'j
drakan	drak'a'n
drake	drak'e
drako	drak'o
drakoj	drak'o'j
drakojn	drak'o'j'n
drakon	drak'o'n
drakboata	drak'boat'a
draketo	drak'et'o
drakoreĝo	drak'o'reĝ'o
drakono	drakon'o
drakulo	drakul'o
drama	dram'a
dramaj	dram'a'j
dramajn	dram'a'j'n
draman	dram'a'n
drame	dram'e
dramo	dram'o
dramoj	dram'o'j
dramojn	dram'o'j'n
dramon	dram'o'n
dramarto	dram'art'o
drameca	dram'ec'a
dramecaj	dram'ec'a'j
dramecajn	dram'ec'a'j'n
dramecan	dram'ec'a'n
dramece	dram'ec'e
dramisto	dram'ist'o
dramistoj	dram'ist'o'j
dramverkisto	dram'verk'ist'o
dramaturgo	dramaturg'o
dramaturgio	dramaturg'i'o
drapo	drap'o
drapiraĵoj	drapir'aĵ'o'j
drapirita	drapir'it'a
draŝas	draŝ'as
draŝi	draŝ'i
draŝis	draŝ'is
draŝado	draŝ'ad'o
draŝejo	draŝ'ej'o
draŝita	draŝ'it'a
drasta	drast'a
drastaj	drast'a'j
drastajn	drast'a'j'n
drastan	drast'a'n
draste	drast'e
drata	drat'a
drataj	drat'a'j
drato	drat'o
dratoj	drat'o'j
dratojn	drat'o'j'n
draton	drat'o'n
drataro	drat'ar'o
dratumita	drat'um'it'a
dratumitaj	drat'um'it'a'j
dreliko	drelik'o
drena	dren'a
drenas	dren'as
dreni	dren'i
drenis	dren'is
drenado	dren'ad'o
drenadon	dren'ad'o'n
drenaĵo	dren'aĵ'o
dreniĝas	dren'iĝ'as
dreniĝi	dren'iĝ'i
drenilo	dren'il'o
dreniloj	dren'il'o'j
drenilon	dren'il'o'n
drenita	dren'it'a
drenitaj	dren'it'a'j
dresas	dres'as
dresi	dres'i
dresis	dres'is
dresado	dres'ad'o
dresisto	dres'ist'o
dresita	dres'it'a
dresitaj	dres'it'a'j
driloj	dril'o'j
drinkas	drink'as
drinki	drink'i
drinkis	drink'is
drinko	drink'o
drinkos	drink'os
drinku	drink'u
drinkadi	drink'ad'i
drinkadis	drink'ad'is
drinkado	drink'ad'o
drinkadon	drink'ad'o'n
drinkaĵo	drink'aĵ'o
drinkaĵoj	drink'aĵ'o'j
drinkaĵojn	drink'aĵ'o'j'n
drinkaĵon	drink'aĵ'o'n
drinkante	drink'ant'e
drinkejo	drink'ej'o
drinkejoj	drink'ej'o'j
drinkejojn	drink'ej'o'j'n
drinkejon	drink'ej'o'n
drinkema	drink'em'a
drinkemaj	drink'em'a'j
drinkemulo	drink'em'ul'o
drinkemuloj	drink'em'ul'o'j
drinkinte	drink'int'e
drinkulo	drink'ul'o
drinkuloj	drink'ul'o'j
drivas	driv'as
drive	driv'e
drivi	driv'i
drivis	driv'is
drivo	driv'o
drivanta	driv'ant'a
drivantaj	driv'ant'a'j
droga	drog'a
drogo	drog'o
drogoj	drog'o'j
drogojn	drog'o'j'n
drogon	drog'o'n
drogevoluo	drog'evolu'o
drogherboj	drog'herb'o'j
drogherbojn	drog'herb'o'j'n
drogita	drog'it'a
drogmanio	drog'mani'o
drogmanion	drog'mani'o'n
drogmaniuloj	drog'mani'ul'o'j
drogulo	drog'ul'o
droguloj	drog'ul'o'j
dromedaro	dromedar'o
dromedaroj	dromedar'o'j
dronas	dron'as
droni	dron'i
dronis	dron'is
drono	dron'o
dronos	dron'os
dronus	dron'us
dronado	dron'ad'o
dronanta	dron'ant'a
dronantaj	dron'ant'a'j
dronantan	dron'ant'a'n
dronante	dron'ant'e
dronanto	dron'ant'o
dronigas	dron'ig'as
dronigi	dron'ig'i
dronigis	dron'ig'is
dronigos	dron'ig'os
droninta	dron'int'a
dronintaj	dron'int'a'j
dronitaj	dron'it'a'j
druidoj	druid'o'j
drupoj	drup'o'j
du	du
dua	du'a
duaj	du'a'j
duajn	du'a'j'n
duan	du'a'n
ducent	du'cent
dudek	du'dek
due	du'e
dumil	du'mil
duo	du'o
duon	du'o'n
dutri	du'tri
duafoja	du'a'foj'a
duafoje	du'a'foj'e
duageneraciaj	du'a'generaci'a'j
duagrada	du'a'grad'a
duagradaj	du'a'grad'a'j
duagradan	du'a'grad'a'n
duajara	du'a'jar'a
duajarcenta	du'a'jar'cent'a
duakanonaj	du'a'kanon'a'j
duaklasa	du'a'klas'a
duaklasaj	du'a'klas'a'j
duaklasan	du'a'klas'a'n
dualingva	du'a'lingv'a
dualoke	du'a'lok'e
duanivela	du'a'nivel'a
duaorda	du'a'ord'a
duaordaj	du'a'ord'a'j
duapersona	du'a'person'a
duapersonaj	du'a'person'a'j
duaranga	du'a'rang'a
duarangaj	du'a'rang'a'j
duarangajn	du'a'rang'a'j'n
duarangan	du'a'rang'a'n
duarange	du'a'rang'e
duavica	du'a'vic'a
duavicaj	du'a'vic'a'j
duavice	du'a'vic'e
duargumenta	du'argument'a
dubaza	du'baz'a
dubordaj	du'bord'a'j
duĉambra	du'ĉambr'a
ducento	du'cent'o
ducifera	du'cifer'a
dudeka	du'dek'a
dudekaj	du'dek'a'j
dudekan	du'dek'a'n
dudekkvar	du'dek'kvar
dudekkvin	du'dek'kvin
dudeko	du'dek'o
dudekon	du'dek'o'n
dudektri	du'dek'tri
dudekajarcenta	du'dek'a'jar'cent'a
dudekajarcentaj	du'dek'ajar'cent'a'j
dudekdua	du'dek'du'a
dudekdujara	du'dek'du'jar'a
dudekedro	du'dek'edr'o
dudekjara	du'dek'jar'a
dudekjaraĝa	du'dek'jar'aĝ'a
dudekkvara	du'dek'kvar'a
dudekkvina	du'dek'kvin'a
dudekoka	du'dek'ok'a
dudekopo	du'dek'op'o
dudekopon	du'dek'op'o'n
dudeksepa	du'dek'sep'a
dudektria	du'dek'tri'a
dudekunua	du'dek'unu'a
dudimensia	du'dimensi'a
dudimensiaj	du'dimensi'a'j
dudimensiajn	du'dimensi'a'j'n
dudimensian	du'dimensi'a'n
dudirekta	du'direkt'a
dudirektaj	du'direkt'a'j
dudirektan	du'direkt'a'n
dueca	du'ec'a
dueco	du'ec'o
duecon	du'ec'o'n
duesencaj	du'esenc'a'j
duetila	du'et'il'a
duetaĝa	du'etaĝ'a
duetaĝaj	du'etaĝ'a'j
duetaĝan	du'etaĝ'a'n
dufaza	du'faz'a
duflanka	du'flank'a
duflankaj	du'flank'a'j
duflankajn	du'flank'a'j'n
duflankan	du'flank'a'n
duflanke	du'flank'e
dufoja	du'foj'a
dufoje	du'foj'e
duformismo	du'form'ism'o
duformismon	du'form'ism'o'n
duhora	du'hor'a
dujara	du'jar'a
dujaraj	du'jar'a'j
dujaran	du'jar'a'n
dujare	du'jar'e
dukajduono	du'kaj'du'on'o
dukamera	du'kamer'a
dukapa	du'kap'a
dukolora	du'kolor'a
dukoloraj	du'kolor'a'j
dukorda	du'kord'a
dukromiato	du'kromi'at'o
dulanda	du'land'a
dulandaj	du'land'a'j
dulandajn	du'land'a'j'n
dulandan	du'land'a'n
dulingva	du'lingv'a
dulingvaj	du'lingv'a'j
dulingvajn	du'lingv'a'j'n
dulingvan	du'lingv'a'n
dulingve	du'lingv'e
dulingveco	du'lingv'ec'o
dulingvismo	du'lingv'ism'o
dulitaj	du'lit'a'j
dulitan	du'lit'a'n
duloka	du'lok'a
dumaniere	du'manier'e
dumetila	du'met'il'a
dumonata	du'monat'a
dumonatan	du'monat'a'n
dunacia	du'naci'a
dunatria	du'natri'a
dunivela	du'nivel'a
dunoma	du'nom'a
duobla	du'obl'a
duoblaj	du'obl'a'j
duoblajn	du'obl'a'j'n
duoblan	du'obl'a'n
duoble	du'obl'e
duoblo	du'obl'o
duobloj	du'obl'o'j
duoblon	du'obl'o'n
duoblapenso	du'obl'a'pens'o
duoblaĵoj	du'obl'aĵ'o'j
duobligas	du'obl'ig'as
duobligi	du'obl'ig'i
duobligis	du'obl'ig'is
duobligo	du'obl'ig'o
duobligon	du'obl'ig'o'n
duobligu	du'obl'ig'u
duobligante	du'obl'ig'ant'e
duobligita	du'obl'ig'it'a
duobligitaj	du'obl'ig'it'a'j
duobliĝas	du'obl'iĝ'as
duobliĝi	du'obl'iĝ'i
duobliĝis	du'obl'iĝ'is
duobliĝo	du'obl'iĝ'o
duobliĝos	du'obl'iĝ'os
duoblulo	du'obl'ul'o
duoksido	du'oksid'o
duoksidon	du'oksid'o'n
duokula	du'okul'a
duona	du'on'a
duonaj	du'on'a'j
duonajn	du'on'a'j'n
duonan	du'on'a'n
duone	du'on'e
duono	du'on'o
duonoj	du'on'o'j
duonojn	du'on'o'j'n
duonon	du'on'o'n
duonakso	du'on'aks'o
duonarbaro	du'on'arb'ar'o
duonarbaroj	du'on'arb'ar'o'j
duonaridaj	du'on'arid'a'j
duonaŭtomata	du'on'aŭtomat'a
duonaŭtomataj	du'on'aŭtomat'a'j
duonĉeloj	du'on'ĉel'o'j
duoncento	du'on'cent'o
duonciklo	du'on'cikl'o
duoncirkla	du'on'cirkl'a
duoncirklaj	du'on'cirkl'a'j
duoncirkle	du'on'cirkl'e
duoncirklo	du'on'cirkl'o
duondezertaj	du'on'dezert'a'j
duondezertoj	du'on'dezert'o'j
duondio	du'on'di'o
duondioj	du'on'di'o'j
duondifina	du'on'difin'a
duondormo	du'on'dorm'o
duonfermis	du'on'ferm'is
duonfermita	du'on'ferm'it'a
duonfermitaj	du'on'ferm'it'a'j
duonfinalo	du'on'final'o
duonfinaloj	du'on'final'o'j
duonfinalon	du'on'final'o'n
duonflanka	du'on'flank'a
duonflankaj	du'on'flank'a'j
duonfrato	du'on'frat'o
duonfratoj	du'on'frat'o'j
duonfratojn	du'on'frat'o'j'n
duonfraton	du'on'frat'o'n
duonfratino	du'on'frat'in'o
duongefratoj	du'on'ge'frat'o'j
duongloba	du'on'glob'a
duonglobo	du'on'glob'o
duonhora	du'on'hor'a
duonhoran	du'on'hor'a'n
duonhoro	du'on'hor'o
duonhoron	du'on'hor'o'n
duonigas	du'on'ig'as
duonigi	du'on'ig'i
duonigis	du'on'ig'is
duonigita	du'on'ig'it'a
duoniĝis	du'on'iĝ'is
duoniĝotempo	du'on'iĝ'o'temp'o
duoninsula	du'on'insul'a
duoninsulo	du'on'insul'o
duoninsuloj	du'on'insul'o'j
duoninsulon	du'on'insul'o'n
duonjara	du'on'jar'a
duonjaro	du'on'jar'o
duonjaron	du'on'jar'o'n
duonjarcento	du'on'jar'cent'o
duonjarcenton	du'on'jar'cent'o'n
duonlinio	du'on'lini'o
duonlumo	du'on'lum'o
duonluno	du'on'lun'o
duonmalfermita	du'on'mal'ferm'it'a
duonmallumo	du'on'mal'lum'o
duonmiliono	du'on'milion'o
duonmonato	du'on'monat'o
duonmonaton	du'on'monat'o'n
duonmorta	du'on'mort'a
duonnuda	du'on'nud'a
duonnudaj	du'on'nud'a'j
duonombro	du'on'ombr'o
duononda	du'on'ond'a
duonpatro	du'on'patr'o
duonpatrino	du'on'patr'in'o
duonpatrinon	du'on'patr'in'o'n
duonplena	du'on'plen'a
duonronda	du'on'rond'a
duonrondaj	du'on'rond'a'j
duonsekaj	du'on'sek'a'j
duonŝerce	du'on'ŝerc'e
duonsfera	du'on'sfer'a
duonsfero	du'on'sfer'o
duontaga	du'on'tag'a
duontagaj	du'on'tag'a'j
duontage	du'on'tag'e
duontago	du'on'tag'o
duontagon	du'on'tag'o'n
duontempo	du'on'temp'o
duontono	du'on'ton'o
duontonoj	du'on'ton'o'j
duontralasa	du'on'tra'las'a
duonvoĉe	du'on'voĉ'e
duonvoje	du'on'voj'e
duonvokalo	du'on'vokal'o
duonvokaloj	du'on'vokal'o'j
duopa	du'op'a
duopaj	du'op'a'j
duopan	du'op'a'n
duope	du'op'e
duopo	du'op'o
duopoj	du'op'o'j
duparta	du'part'a
dupartia	du'parti'a
dupersona	du'person'a
dupersonaj	du'person'a'j
dupieda	du'pied'a
dupiedulo	du'pied'ul'o
dupolusa	du'polus'a
dupolusan	du'polus'a'n
dupoluso	du'polus'o
dupolusoj	du'polus'o'j
dupunkta	du'punkt'a
dupunkto	du'punkt'o
dupunktoj	du'punkt'o'j
durada	du'rad'a
duseksa	du'seks'a
duseksaj	du'seks'a'j
dusemajna	du'semajn'a
dusemajnan	du'semajn'a'n
dusenca	du'senc'a
dusencaj	du'senc'a'j
dusignifa	du'signif'a
dusilaba	du'silab'a
dusilabaj	du'silab'a'j
duspecaj	du'spec'a'j
duŝtata	du'ŝtat'a
duŝtatan	du'ŝtat'a'n
duŝtupa	du'ŝtup'a
duŝtupan	du'ŝtup'a'n
dusulfido	du'sulf'id'o
dutaga	du'tag'a
dutagan	du'tag'a'n
dutakta	du'takt'a
dutaktaj	du'takt'a'j
dutrifoje	du'tri'foj'e
dutriona	du'tri'on'a
dutrionan	du'tri'on'a'n
duuma	du'um'a
duumaj	du'um'a'j
duuraniato	du'urani'at'o
duvalento	du'valent'o
duvica	du'vic'a
duala	dual'a
dualaj	dual'a'j
dualo	dual'o
dualisma	dual'ism'a
dualismo	dual'ism'o
dualismon	dual'ism'o'n
duato	duat'o
duba	dub'a
dubaj	dub'a'j
duban	dub'a'n
dubas	dub'as
dube	dub'e
dubi	dub'i
dubis	dub'is
dubo	dub'o
duboj	dub'o'j
dubojn	dub'o'j'n
dubon	dub'o'n
dubos	dub'os
dubu	dub'u
dubus	dub'us
dubanta	dub'ant'a
dubante	dub'ant'e
dubema	dub'em'a
dubeme	dub'em'e
dubemo	dub'em'o
dubigas	dub'ig'as
dubinda	dub'ind'a
dubindaj	dub'ind'a'j
dubindajn	dub'ind'a'j'n
dubindan	dub'ind'a'n
dubindas	dub'ind'as
dubinde	dub'ind'e
dubaja	dubaj'a
dubajo	dubaj'o
dublado	dubl'ad'o
dubladon	dubl'ad'o'n
dublita	dubl'it'a
dublitaj	dubl'it'a'j
dublina	dublin'a
dublino	dublin'o
dueli	duel'i
duelo	duel'o
dueloj	duel'o'j
duelon	duel'o'n
duelatestanto	duel'atest'ant'o
dueto	duet'o
dueton	duet'o'n
duka	duk'a
dukaj	duk'a'j
duke	duk'e
duko	duk'o
dukoj	duk'o'j
dukojn	duk'o'j'n
dukon	duk'o'n
dukino	duk'in'o
duklando	duk'land'o
duklandoj	duk'land'o'j
duklandon	duk'land'o'n
dukatoj	dukat'o'j
dukto	dukt'o
duktoj	dukt'o'j
duktojn	dukt'o'j'n
dukton	dukt'o'n
duktila	duktil'a
dum	dum
duma	dum'a
dume	dum'e
dumbatale	dum'batal'e
dumfluga	dum'flug'a
dumflugaj	dum'flug'a'j
dumflugan	dum'flug'a'n
dumfluge	dum'flug'e
dumkongrese	dum'kongres'e
dumlabore	dum'labor'e
dumlonge	dum'long'e
dummilite	dum'milit'e
dummomente	dum'moment'e
dumnokta	dum'nokt'a
dumnokte	dum'nokt'e
dumpase	dum'pas'e
dumsomere	dum'somer'e
dumtaga	dum'tag'a
dumtagaj	dum'tag'a'j
dumtage	dum'tag'e
dumtempa	dum'temp'a
dumtempaj	dum'temp'a'j
dumtempan	dum'temp'a'n
dumtempe	dum'temp'e
dumvintre	dum'vintr'e
dumviva	dum'viv'a
dumvivaj	dum'viv'a'j
dumvivajn	dum'viv'a'j'n
dumvivan	dum'viv'a'n
dumvive	dum'viv'e
dumvoje	dum'voj'e
dumvojaĝe	dum'vojaĝ'e
dumao	duma'o
dumpingo	dumping'o
duno	dun'o
dunoj	dun'o'j
dunojn	dun'o'j'n
dunga	dung'a
dungan	dung'a'n
dungas	dung'as
dungi	dung'i
dungis	dung'is
dungo	dung'o
dungon	dung'o'n
dungos	dung'os
dungu	dung'u
dungus	dung'us
dungado	dung'ad'o
dungadon	dung'ad'o'n
dungadosekcio	dung'ad'o'sekci'o
dunganoncoj	dung'anonc'o'j
dungante	dung'ant'e
dunganto	dung'ant'o
dungantoj	dung'ant'o'j
dungantojn	dung'ant'o'j'n
dunganton	dung'ant'o'n
dungiĝi	dung'iĝ'i
dungiĝis	dung'iĝ'is
dungiĝo	dung'iĝ'o
dunginto	dung'int'o
dungintoj	dung'int'o'j
dungistoj	dung'ist'o'j
dungita	dung'it'a
dungitaj	dung'it'a'j
dungitajn	dung'it'a'j'n
dungite	dung'it'e
dungito	dung'it'o
dungitoj	dung'it'o'j
dungitojn	dung'it'o'j'n
dungiton	dung'it'o'n
dungitara	dung'it'ar'a
dungitaro	dung'it'ar'o
dungitaron	dung'it'ar'o'n
dungiteco	dung'it'ec'o
dungitecon	dung'it'ec'o'n
dungitino	dung'it'in'o
dungokontrakto	dung'o'kontrakt'o
dungosoldatoj	dung'o'soldat'o'j
duodeno	duoden'o
dupleksa	dupleks'a
dupleksaj	dupleks'a'j
duplikatas	duplikat'as
duplikati	duplikat'i
duplikato	duplikat'o
duplikatoj	duplikat'o'j
duplikatita	duplikat'it'a
duplikatitaj	duplikat'it'a'j
dura	dur'a
duraj	dur'a'j
durajn	dur'a'j'n
duran	dur'a'n
dure	dur'e
durdisko	dur'disk'o
durdiskoj	dur'disk'o'j
dureco	dur'ec'o
durligno	dur'lign'o
durlignoj	dur'lign'o'j
duramatro	duramatr'o
durango	durang'o
durero	durer'o
durio	duri'o
duŝas	duŝ'as
duŝi	duŝ'i
duŝis	duŝ'is
duŝo	duŝ'o
duŝoj	duŝ'o'j
duŝon	duŝ'o'n
duŝos	duŝ'os
duŝu	duŝ'u
duŝado	duŝ'ad'o
duŝante	duŝ'ant'e
duŝejo	duŝ'ej'o
duŝejoj	duŝ'ej'o'j
duŝejon	duŝ'ej'o'n
duŝilo	duŝ'il'o