ebena	eben'a
ebenaj	eben'a'j
ebenajn	eben'a'j'n
ebenan	eben'a'n
ebene	eben'e
ebeno	eben'o
ebenoj	eben'o'j
ebenojn	eben'o'j'n
ebenon	eben'o'n
ebenaĵa	eben'aĵ'a
ebenajho	eben'aĵ'o
ebenaĵo	eben'aĵ'o
ebenaĵoj	eben'aĵ'o'j
ebenaĵojn	eben'aĵ'o'j'n
ebenaĵon	eben'aĵ'o'n
ebenejo	eben'ej'o
ebenigas	eben'ig'as
ebenigi	eben'ig'i
ebenigis	eben'ig'is
ebenigado	eben'ig'ad'o
ebenigita	eben'ig'it'a
ebenigitaj	eben'ig'it'a'j
ebla	ebl'a
eblaj	ebl'a'j
eblajn	ebl'a'j'n
eblan	ebl'a'n
eblas	ebl'as
eble	ebl'e
ebli	ebl'i
eblis	ebl'is
eblo	ebl'o
ebloj	ebl'o'j
eblojn	ebl'o'j'n
eblon	ebl'o'n
eblos	ebl'os
eblu	ebl'u
eblus	ebl'us
eblaĵo	ebl'aĵ'o
ebleco	ebl'ec'o
eblecoj	ebl'ec'o'j
eblecojn	ebl'ec'o'j'n
eblecon	ebl'ec'o'n
eblemon	ebl'em'o'n
ebliga	ebl'ig'a
ebligaj	ebl'ig'a'j
ebligas	ebl'ig'as
ebligi	ebl'ig'i
ebligis	ebl'ig'is
ebligo	ebl'ig'o
ebligos	ebl'ig'os
ebligu	ebl'ig'u
ebligus	ebl'ig'us
ebligado	ebl'ig'ad'o
ebliganta	ebl'ig'ant'a
ebligantaj	ebl'ig'ant'a'j
ebligantan	ebl'ig'ant'a'n
ebligante	ebl'ig'ant'e
ebliganto	ebl'ig'ant'o
ebligita	ebl'ig'it'a
ebligitaj	ebl'ig'it'a'j
ebligite	ebl'ig'it'e
ebolo	ebol'o
ebona	ebon'a
ebono	ebon'o
ebria	ebri'a
ebriaj	ebri'a'j
ebrian	ebri'a'n
ebrias	ebri'as
ebrie	ebri'e
ebriis	ebri'is
ebrio	ebri'o
ebrioj	ebri'o'j
ebrion	ebri'o'n
ebrieco	ebri'ec'o
ebriecon	ebri'ec'o'n
ebriega	ebri'eg'a
ebrieta	ebri'et'a
ebriiga	ebri'ig'a
ebriigan	ebri'ig'a'n
ebriigas	ebri'ig'as
ebriigi	ebri'ig'i
ebriigis	ebri'ig'is
ebriiĝas	ebri'iĝ'as
ebriiĝi	ebri'iĝ'i
ebriiĝis	ebri'iĝ'is
ebriiĝo	ebri'iĝ'o
ebriiĝu	ebri'iĝ'u
ebriulo	ebri'ul'o
ebriuloj	ebri'ul'o'j
ebriulon	ebri'ul'o'n
ebura	ebur'a
eburaj	ebur'a'j
eburan	ebur'a'n
eburo	ebur'o
eburon	ebur'o'n
eburbordo	ebur'bord'o
eca	ec'a
ecaj	ec'a'j
ecan	ec'a'n
eco	ec'o
ecoj	ec'o'j
ecojn	ec'o'j'n
econ	ec'o'n
eĉ	eĉ
edo	ed'o
edoperiodo	ed'o'period'o
edemo	edem'o
edena	eden'a
edeno	eden'o
edenon	eden'o'n
edifa	edif'a
edifaj	edif'a'j
edifan	edif'a'n
edifo	edif'o
edikto	edikt'o
ediktoj	edikt'o'j
ediktojn	edikt'o'j'n
edikton	edikt'o'n
ediktita	edikt'it'a
ediloj	edil'o'j
edipo	edip'o
editoro	editor'o
edmundo	edmund'o
edro	edr'o
edroj	edr'o'j
edrojn	edr'o'j'n
eduardo	eduard'o
eduardon	eduard'o'n
eduka	eduk'a
edukaj	eduk'a'j
edukajn	eduk'a'j'n
edukan	eduk'a'n
edukas	eduk'as
eduke	eduk'e
eduki	eduk'i
edukis	eduk'is
eduko	eduk'o
edukojn	eduk'o'j'n
edukon	eduk'o'n
edukos	eduk'os
eduku	eduk'u
edukada	eduk'ad'a
edukadaj	eduk'ad'a'j
edukadi	eduk'ad'i
edukadis	eduk'ad'is
edukado	eduk'ad'o
edukadon	eduk'ad'o'n
edukante	eduk'ant'e
edukanto	eduk'ant'o
edukantoj	eduk'ant'o'j
edukata	eduk'at'a
edukataj	eduk'at'a'j
edukatino	eduk'at'in'o
edukejo	eduk'ej'o
edukejoj	eduk'ej'o'j
edukiĝas	eduk'iĝ'as
edukiĝi	eduk'iĝ'i
edukiĝis	eduk'iĝ'is
edukiĝo	eduk'iĝ'o
edukiĝon	eduk'iĝ'o'n
edukisto	eduk'ist'o
edukistoj	eduk'ist'o'j
edukistojn	eduk'ist'o'j'n
edukistino	eduk'ist'in'o
edukita	eduk'it'a
edukitaj	eduk'it'a'j
edukitajn	eduk'it'a'j'n
edukitan	eduk'it'a'n
edukiteco	eduk'it'ec'o
edukitecon	eduk'it'ec'o'n
edukministerio	eduk'ministeri'o
eduknivelo	eduk'nivel'o
edukniveloj	eduk'nivel'o'j
edukprogramo	eduk'program'o
edukprogramoj	eduk'program'o'j
edukprogramojn	eduk'program'o'j'n
eduksistemo	eduk'sistem'o
eduksistemoj	eduk'sistem'o'j
eduksistemon	eduk'sistem'o'n
edza	edz'a
edzan	edz'a'n
edzo	edz'o
edzoj	edz'o'j
edzojn	edz'o'j'n
edzon	edz'o'n
edzeca	edz'ec'a
edzecaj	edz'ec'a'j
edzecan	edz'ec'a'n
edzeco	edz'ec'o
edzecon	edz'ec'o'n
edzigi	edz'ig'i
edzigis	edz'ig'is
edzigos	edz'ig'os
edzigu	edz'ig'u
edzigita	edz'ig'it'a
edziĝa	edz'iĝ'a
edziĝas	edz'iĝ'as
edziĝi	edz'iĝ'i
edziĝis	edz'iĝ'is
edzigho	edz'iĝ'o
edziĝo	edz'iĝ'o
edziĝoj	edz'iĝ'o'j
edziĝon	edz'iĝ'o'n
edziĝos	edz'iĝ'os
edziĝu	edz'iĝ'u
edziĝus	edz'iĝ'us
edziĝanto	edz'iĝ'ant'o
edziĝfesto	edz'iĝ'fest'o
edziĝinta	edz'iĝ'int'a
edziĝintaj	edz'iĝ'int'a'j
edziĝintajn	edz'iĝ'int'a'j'n
edziĝinte	edz'iĝ'int'e
edziĝonta	edz'iĝ'ont'a
edzina	edz'in'a
edzino	edz'in'o
edzinoj	edz'in'o'j
edzinojn	edz'in'o'j'n
edzinon	edz'in'o'n
edzineco	edz'in'ec'o
edzinecon	edz'in'ec'o'n
edzineto	edz'in'et'o
edzinigas	edz'in'ig'as
edzinigi	edz'in'ig'i
edzinigis	edz'in'ig'is
edzinigo	edz'in'ig'o
edzinigos	edz'in'ig'os
edzinigu	edz'in'ig'u
edzinigita	edz'in'ig'it'a
edziniĝa	edz'in'iĝ'a
edziniĝas	edz'in'iĝ'as
edziniĝi	edz'in'iĝ'i
edziniĝis	edz'in'iĝ'is
edzinigho	edz'in'iĝ'o
edziniĝo	edz'in'iĝ'o
edziniĝon	edz'in'iĝ'o'n
edziniĝos	edz'in'iĝ'os
edziniĝu	edz'in'iĝ'u
edziniĝus	edz'in'iĝ'us
edziniĝinta	edz'in'iĝ'int'a
edziniĝintaj	edz'in'iĝ'int'a'j
edziniĝonta	edz'in'iĝ'ont'a
edzviroj	edz'vir'o'j
efekta	efekt'a
efektas	efekt'as
efektis	efekt'is
efekto	efekt'o
efektoj	efekt'o'j
efektojn	efekt'o'j'n
efekton	efekt'o'n
efektiva	efektiv'a
efektivaj	efektiv'a'j
efektivajn	efektiv'a'j'n
efektivan	efektiv'a'n
efektive	efektiv'e
efektivo	efektiv'o
efektiveco	efektiv'ec'o
efektiviga	efektiv'ig'a
efektivigas	efektiv'ig'as
efektivigi	efektiv'ig'i
efektivigis	efektiv'ig'is
efektivigo	efektiv'ig'o
efektivigoj	efektiv'ig'o'j
efektivigojn	efektiv'ig'o'j'n
efektivigon	efektiv'ig'o'n
efektivigos	efektiv'ig'os
efektivigu	efektiv'ig'u
efektivigus	efektiv'ig'us
efektivigado	efektiv'ig'ad'o
efektiviganta	efektiv'ig'ant'a
efektivigantaj	efektiv'ig'ant'a'j
efektivigante	efektiv'ig'ant'e
efektivigata	efektiv'ig'at'a
efektivigebla	efektiv'ig'ebl'a
efektivigeblaj	efektiv'ig'ebl'a'j
efektivigeblan	efektiv'ig'ebl'a'n
efektivigita	efektiv'ig'it'a
efektivigitaj	efektiv'ig'it'a'j
efektivigitajn	efektiv'ig'it'a'j'n
efektivigitan	efektiv'ig'it'a'n
efektivigite	efektiv'ig'it'e
efektiviĝas	efektiv'iĝ'as
efektiviĝi	efektiv'iĝ'i
efektiviĝis	efektiv'iĝ'is
efektiviĝo	efektiv'iĝ'o
efektiviĝon	efektiv'iĝ'o'n
efektiviĝos	efektiv'iĝ'os
efektiviĝu	efektiv'iĝ'u
efektiviĝus	efektiv'iĝ'us
efemera	efemer'a
efemeraj	efemer'a'j
efemeran	efemer'a'n
efemero	efemer'o
efezo	efez'o
efika	efik'a
efikaj	efik'a'j
efikajn	efik'a'j'n
efikan	efik'a'n
efikas	efik'as
efike	efik'e
efiki	efik'i
efikis	efik'is
efiko	efik'o
efikoj	efik'o'j
efikojn	efik'o'j'n
efikon	efik'o'n
efikos	efik'os
efiku	efik'u
efikus	efik'us
efikanta	efik'ant'a
efikeco	efik'ec'o
efikecoj	efik'ec'o'j
efikecojn	efik'ec'o'j'n
efikecon	efik'ec'o'n
efikigi	efik'ig'i
efikograndeco	efik'o'grand'ec'o
ega	eg'a
egaj	eg'a'j
egajn	eg'a'j'n
egan	eg'a'n
ege	eg'e
ego	eg'o
egon	eg'o'n
eĝaj	eĝ'a'j
eĝo	eĝ'o
eĝoj	eĝ'o'j
eĝojn	eĝ'o'j'n
eĝon	eĝ'o'n
egala	egal'a
egalaj	egal'a'j
egalajn	egal'a'j'n
egalan	egal'a'n
egalas	egal'as
egale	egal'e
egali	egal'i
egalis	egal'is
egalos	egal'os
egalu	egal'u
egalus	egal'us
egalado	egal'ad'o
egalanima	egal'anim'a
egalanta	egal'ant'a
egalante	egal'ant'e
egaleca	egal'ec'a
egalecaj	egal'ec'a'j
egalecan	egal'ec'a'n
egalece	egal'ec'e
egaleco	egal'ec'o
egalecon	egal'ec'o'n
egaligas	egal'ig'as
egaligi	egal'ig'i
egaligis	egal'ig'is
egaligo	egal'ig'o
egaligita	egal'ig'it'a
egaligitaj	egal'ig'it'a'j
egaliĝi	egal'iĝ'i
egalisma	egal'ism'a
egalita	egal'it'a
egalitaj	egal'it'a'j
egallatera	egal'later'a
egalmezura	egal'mezur'a
egalmezure	egal'mezur'e
egalpezo	egal'pez'o
egalrajta	egal'rajt'a
egalrajtaj	egal'rajt'a'j
egalrajtan	egal'rajt'a'n
egalrajte	egal'rajt'e
egalrajteca	egal'rajt'ec'a
egalrajtecaj	egal'rajt'ec'a'j
egalrajteco	egal'rajt'ec'o
egalrajtecon	egal'rajt'ec'o'n
egalrajtigojn	egal'rajt'ig'o'j'n
egalrilatas	egal'rilat'as
egalrilati	egal'rilat'i
egalrilatis	egal'rilat'is
egalrilatanta	egal'rilat'ant'a
egalrilatantaj	egal'rilat'ant'a'j
egalrilatantajn	egal'rilat'ant'a'j'n
egalrilatante	egal'rilat'ant'e
egalulo	egal'ul'o
egaluloj	egal'ul'o'j
egalulojn	egal'ul'o'j'n
egalulon	egal'ul'o'n
egalvalora	egal'valor'a
egalvaloraj	egal'valor'a'j
egalvaloras	egal'valor'as
egea	ege'a
egeaj	ege'a'j
egeo	ege'o
egido	egid'o
egipta	egipt'a
egiptaj	egipt'a'j
egiptajn	egipt'a'j'n
egiptan	egipt'a'n
egipto	egipt'o
egiptoj	egipt'o'j
egiptojn	egipt'o'j'n
egipton	egipt'o'n
egiptanoj	egipt'an'o'j
egiptia	egipt'i'a
egiptiaj	egipt'i'a'j
egiptio	egipt'i'o
egiption	egipt'i'o'n
egiptologoj	egipt'olog'o'j
egiptologio	egipt'olog'i'o
egiptujo	egipt'uj'o
egiptujon	egipt'uj'o'n
egisto	egist'o
egoo	ego'o
egoon	ego'o'n
egocentra	ego'centr'a
egoisma	ego'ism'a
egoismaj	ego'ism'a'j
egoismajn	ego'ism'a'j'n
egoisme	ego'ism'e
egoismo	ego'ism'o
egoismon	ego'ism'o'n
egoista	ego'ist'a
egoistaj	ego'ist'a'j
egoisto	ego'ist'o
egoistoj	ego'ist'o'j
egreto	egret'o
eĥas	eĥ'as
eĥi	eĥ'i
eĥis	eĥ'is
eĥo	eĥ'o
eĥoj	eĥ'o'j
eĥojn	eĥ'o'j'n
eĥon	eĥ'o'n
eĥigas	eĥ'ig'as
eĥolokigo	eĥ'o'lok'ig'o
eĥino	eĥin'o
eĥinoj	eĥin'o'j
ejo	ej'o
ejoj	ej'o'j
ejojn	ej'o'j'n
ejon	ej'o'n
ejakulas	ejakul'as
ejakuli	ejakul'i
ejakulo	ejakul'o
ejakuloj	ejakul'o'j
ejakulado	ejakul'ad'o
ejfelo	ejfel'o
ejfelturo	ejfel'tur'o
ejnŝtejno	ejnŝtejn'o
eka	ek'a
ekas	ek'as
ekde	ek'de
eke	ek'e
eki	ek'i
ekis	ek'is
eko	ek'o
ekon	ek'o'n
ekos	ek'os
eku	ek'u
ekagas	ek'ag'as
ekagi	ek'ag'i
ekagis	ek'ag'is
ekagos	ek'ag'os
ekagu	ek'ag'u
ekaktivis	ek'aktiv'is
ekamas	ek'am'as
ekami	ek'am'i
ekamis	ek'am'is
ekamos	ek'am'os
ekamu	ek'am'u
ekaperas	ek'aper'as
ekaperi	ek'aper'i
ekaperis	ek'aper'is
ekapero	ek'aper'o
ekaperoj	ek'aper'o'j
ekaperojn	ek'aper'o'j'n
ekaperon	ek'aper'o'n
ekaperos	ek'aper'os
ekaperu	ek'aper'u
ekaperus	ek'aper'us
ekaperado	ek'aper'ad'o
ekaperanta	ek'aper'ant'a
ekaperantaj	ek'aper'ant'a'j
ekaperante	ek'aper'ant'e
ekaplaŭdis	ek'aplaŭd'is
ekardis	ek'ard'is
ekaspektis	ek'aspekt'is
ekatakis	ek'atak'is
ekatentis	ek'atent'is
ekaŭdas	ek'aŭd'as
ekaŭdi	ek'aŭd'i
ekaŭdis	ek'aŭd'is
ekaŭdos	ek'aŭd'os
ekaŭdiĝis	ek'aŭd'iĝ'is
ekbabilis	ek'babil'is
ekbalancis	ek'balanc'is
ekbati	ek'bat'i
ekbatis	ek'bat'is
ekbatali	ek'batal'i
ekbatalis	ek'batal'is
ekblekis	ek'blek'is
ekblovis	ek'blov'is
ekblovo	ek'blov'o
ekbojis	ek'boj'is
ekbolis	ek'bol'is
ekbrilas	ek'bril'as
ekbrilis	ek'bril'is
ekbrilo	ek'bril'o
ekbriloj	ek'bril'o'j
ekbrilojn	ek'bril'o'j'n
ekbrilon	ek'bril'o'n
ekbrilos	ek'bril'os
ekbruis	ek'bru'is
ekbrulas	ek'brul'as
ekbruli	ek'brul'i
ekbrulis	ek'brul'is
ekbrulo	ek'brul'o
ekbruligas	ek'brul'ig'as
ekbruligi	ek'brul'ig'i
ekbruligis	ek'brul'ig'is
ekbruligo	ek'brul'ig'o
ekbruligos	ek'brul'ig'os
ekbruligu	ek'brul'ig'u
ekbruligante	ek'brul'ig'ant'e
ekbruligita	ek'brul'ig'it'a
ekbruligitaj	ek'brul'ig'it'a'j
ekbruligite	ek'brul'ig'it'e
ekcelis	ek'cel'is
ekĉesis	ek'ĉes'is
ekdancas	ek'danc'as
ekdancis	ek'danc'is
ekdemandis	ek'demand'is
ekdeziris	ek'dezir'is
ekdeziros	ek'dezir'os
ekdiris	ek'dir'is
ekdisputis	ek'disput'is
ekdoloris	ek'dolor'is
ekdormas	ek'dorm'as
ekdormi	ek'dorm'i
ekdormis	ek'dorm'is
ekdormos	ek'dorm'os
ekdormu	ek'dorm'u
ekdormetis	ek'dorm'et'is
ekdubas	ek'dub'as
ekdubis	ek'dub'is
ekekzistis	ek'ekzist'is
ekemis	ek'em'is
ekenuis	ek'enu'is
ekepizodo	ek'epizod'o
ekestas	ek'est'as
ekesti	ek'est'i
ekestis	ek'est'is
ekesto	ek'est'o
ekestoj	ek'est'o'j
ekestojn	ek'est'o'j'n
ekeston	ek'est'o'n
ekestos	ek'est'os
ekestu	ek'est'u
ekestus	ek'est'us
ekestanta	ek'est'ant'a
ekestantaj	ek'est'ant'a'j
ekestantajn	ek'est'ant'a'j'n
ekestante	ek'est'ant'e
ekestiĝas	ek'est'iĝ'as
ekestiĝi	ek'est'iĝ'i
ekestiĝis	ek'est'iĝ'is
ekestiĝanta	ek'est'iĝ'ant'a
ekestiĝantaj	ek'est'iĝ'ant'a'j
ekestiĝante	ek'est'iĝ'ant'e
ekestinta	ek'est'int'a
ekestintaj	ek'est'int'a'j
ekfajfis	ek'fajf'is
ekfalis	ek'fal'is
ekfaras	ek'far'as
ekfari	ek'far'i
ekfaris	ek'far'is
ekfirmaoj	ek'firma'o'j
ekflagris	ek'flagr'is
ekflama	ek'flam'a
ekflamas	ek'flam'as
ekflami	ek'flam'i
ekflamis	ek'flam'is
ekflamigas	ek'flam'ig'as
ekflamigi	ek'flam'ig'i
ekflamigis	ek'flam'ig'is
ekflamigos	ek'flam'ig'os
ekflamiĝis	ek'flam'iĝ'is
ekflaras	ek'flar'as
ekflaris	ek'flar'is
ekfloras	ek'flor'as
ekflori	ek'flor'i
ekfloris	ek'flor'is
ekfloro	ek'flor'o
ekfloros	ek'flor'os
ekflorado	ek'flor'ad'o
ekfluas	ek'flu'as
ekfluis	ek'flu'is
ekflugas	ek'flug'as
ekflugi	ek'flug'i
ekflugis	ek'flug'is
ekflugo	ek'flug'o
ekflugon	ek'flug'o'n
ekflugos	ek'flug'os
ekflustris	ek'flustr'is
ekforiris	ek'for'ir'is
ekfrapas	ek'frap'as
ekfrapis	ek'frap'is
ekfrapo	ek'frap'o
ekfrotis	ek'frot'is
ekfuĝis	ek'fuĝ'is
ekfulmis	ek'fulm'is
ekfumis	ek'fum'is
ekfunkcias	ek'funkci'as
ekfunkcii	ek'funkci'i
ekfunkciis	ek'funkci'is
ekfunkcios	ek'funkci'os
ekfunkciigas	ek'funkci'ig'as
ekfunkciigi	ek'funkci'ig'i
ekfunkciigis	ek'funkci'ig'is
ekfunkciigo	ek'funkci'ig'o
ekfunkciigita	ek'funkci'ig'it'a
ekfuriozis	ek'furioz'is
ekgalopis	ek'galop'is
ekĝemis	ek'ĝem'is
ekgenuis	ek'genu'is
ekĝermas	ek'ĝerm'as
ekĝermis	ek'ĝerm'is
ekglitis	ek'glit'is
ekĝojis	ek'ĝoj'is
ekĝuis	ek'ĝu'is
ekgvidis	ek'gvid'is
ekhaltas	ek'halt'as
ekhalti	ek'halt'i
ekhaltis	ek'halt'is
ekhaltita	ek'halt'it'a
ekhastis	ek'hast'is
ekhavas	ek'hav'as
ekhavi	ek'hav'i
ekhavis	ek'hav'is
ekhavo	ek'hav'o
ekhavos	ek'hav'os
ekhavu	ek'hav'u
ekhavus	ek'hav'us
ekhavado	ek'hav'ad'o
ekhavante	ek'hav'ant'e
ekhavita	ek'hav'it'a
ekhavitaj	ek'hav'it'a'j
ekhontis	ek'hont'is
ekhurlis	ek'hurl'is
ekigas	ek'ig'as
ekigi	ek'ig'i
ekigis	ek'ig'is
ekigo	ek'ig'o
ekigos	ek'ig'os
ekigado	ek'ig'ad'o
ekiganta	ek'ig'ant'a
ekigante	ek'ig'ant'e
ekigita	ek'ig'it'a
ekigitaj	ek'ig'it'a'j
ekiĝas	ek'iĝ'as
ekiĝis	ek'iĝ'is
ekiĝo	ek'iĝ'o
ekinstruis	ek'instru'is
ekinsultis	ek'insult'is
ekinteresis	ek'interes'is
ekinteresiĝas	ek'interes'iĝ'as
ekinteresiĝis	ek'interes'iĝ'is
ekiras	ek'ir'as
ekiri	ek'ir'i
ekiris	ek'ir'is
ekiro	ek'ir'o
ekiron	ek'ir'o'n
ekiros	ek'ir'os
ekiru	ek'ir'u
ekirante	ek'ir'ant'e
ekironta	ek'ir'ont'a
ekkantas	ek'kant'as
ekkantis	ek'kant'is
ekkaptas	ek'kapt'as
ekkapti	ek'kapt'i
ekkaptis	ek'kapt'is
ekkaptu	ek'kapt'u
ekkaptita	ek'kapt'it'a
ekkarieris	ek'karier'is
ekkaŭris	ek'kaŭr'is
ekkaŭzis	ek'kaŭz'is
ekkisis	ek'kis'is
ekknaris	ek'knar'is
ekkoleras	ek'koler'as
ekkoleris	ek'koler'is
ekkolerema	ek'koler'em'a
ekkomencas	ek'komenc'as
ekkomencis	ek'komenc'is
ekkomenciĝis	ek'komenc'iĝ'is
ekkompatis	ek'kompat'is
ekkomprenas	ek'kompren'as
ekkompreni	ek'kompren'i
ekkomprenis	ek'kompren'is
ekkompreno	ek'kompren'o
ekkomprenos	ek'kompren'os
ekkomprenus	ek'kompren'us
ekkomprenado	ek'kompren'ad'o
ekkomprenante	ek'kompren'ant'e
ekkomprenite	ek'kompren'it'e
ekkonas	ek'kon'as
ekkoni	ek'kon'i
ekkonis	ek'kon'is
ekkono	ek'kon'o
ekkonoj	ek'kon'o'j
ekkonojn	ek'kon'o'j'n
ekkonon	ek'kon'o'n
ekkonos	ek'kon'os
ekkonu	ek'kon'u
ekkonus	ek'kon'us
ekkonatiĝis	ek'kon'at'iĝ'is
ekkonebla	ek'kon'ebl'a
ekkoninta	ek'kon'int'a
ekkoninte	ek'kon'int'e
ekkondukis	ek'konduk'is
ekkonscias	ek'konsci'as
ekkonscii	ek'konsci'i
ekkonsciis	ek'konsci'is
ekkonscios	ek'konsci'os
ekkonsentis	ek'konsent'is
ekkonsideris	ek'konsider'is
ekkonstrui	ek'konstru'i
ekkonstruis	ek'konstru'is
ekkontaktis	ek'kontakt'is
ekkontrolis	ek'kontrol'is
ekkrakis	ek'krak'is
ekkredas	ek'kred'as
ekkredi	ek'kred'i
ekkredis	ek'kred'is
ekkreskas	ek'kresk'as
ekkreskis	ek'kresk'is
ekkria	ek'kri'a
ekkriaj	ek'kri'a'j
ekkrias	ek'kri'as
ekkrii	ek'kri'i
ekkriis	ek'kri'is
ekkrio	ek'kri'o
ekkrioj	ek'kri'o'j
ekkriojn	ek'kri'o'j'n
ekkrion	ek'kri'o'n
ekkrios	ek'kri'os
ekkriante	ek'kri'ant'e
ekkriegis	ek'kri'eg'is
ekkunlaboris	ek'kun'labor'is
ekkuras	ek'kur'as
ekkuris	ek'kur'is
ekkuregis	ek'kur'eg'is
ekkuŝas	ek'kuŝ'as
ekkuŝi	ek'kuŝ'i
ekkuŝis	ek'kuŝ'is
ekkuŝu	ek'kuŝ'u
ekkverelis	ek'kverel'is
eklaboras	ek'labor'as
eklabori	ek'labor'i
eklaboris	ek'labor'is
eklaboro	ek'labor'o
eklaboros	ek'labor'os
eklaboru	ek'labor'u
eklarmis	ek'larm'is
eklegi	ek'leg'i
eklegis	ek'leg'is
eklernas	ek'lern'as
eklerni	ek'lern'i
eklernis	ek'lern'is
eklernos	ek'lern'os
eklevis	ek'lev'is
ekleviĝis	ek'lev'iĝ'is
ekloĝas	ek'loĝ'as
ekloĝi	ek'loĝ'i
ekloĝis	ek'loĝ'is
ekloĝo	ek'loĝ'o
ekloĝos	ek'loĝ'os
ekloĝado	ek'loĝ'ad'o
ekludas	ek'lud'as
ekludis	ek'lud'is
eklumas	ek'lum'as
eklumis	ek'lum'is
eklumigis	ek'lum'ig'is
ekmalamis	ek'mal'am'is
ekmalaperis	ek'mal'aper'is
ekmalfermiĝis	ek'mal'ferm'iĝ'is
ekmaljuniĝo	ek'mal'jun'iĝ'o
ekmalsanis	ek'mal'san'is
ekmalsaniĝis	ek'mal'san'iĝ'is
ekmanĝi	ek'manĝ'i
ekmanĝis	ek'manĝ'is
ekmankas	ek'mank'as
ekmankis	ek'mank'is
ekmarŝis	ek'marŝ'is
ekmeditis	ek'medit'is
ekmemoras	ek'memor'as
ekmemori	ek'memor'i
ekmemoris	ek'memor'is
ekmigris	ek'migr'is
ekmiliti	ek'milit'i
ekmilitis	ek'milit'is
ekmiris	ek'mir'is
ekmiro	ek'mir'o
ekmiregis	ek'mir'eg'is
ekmontris	ek'montr'is
ekmordis	ek'mord'is
ekmovi	ek'mov'i
ekmovis	ek'mov'is
ekmovo	ek'mov'o
ekmoviĝas	ek'mov'iĝ'as
ekmoviĝis	ek'mov'iĝ'is
ekmuĝis	ek'muĝ'is
ekmultiĝo	ek'mult'iĝ'o
ekmurmuris	ek'murmur'is
eknaĝis	ek'naĝ'is
eknavigis	ek'navig'is
ekneĝis	ek'neĝ'is
eknomis	ek'nom'is
eknomiĝis	ek'nom'iĝ'is
ekoficis	ek'ofic'is
ekokupis	ek'okup'is
ekokupiĝi	ek'okup'iĝ'i
ekokupiĝis	ek'okup'iĝ'is
ekpafas	ek'paf'as
ekpafi	ek'paf'i
ekpafis	ek'paf'is
ekpanikis	ek'panik'is
ekparolas	ek'parol'as
ekparoli	ek'parol'i
ekparolis	ek'parol'is
ekparolos	ek'parol'os
ekparolu	ek'parol'u
ekpartoprenis	ek'part'o'pren'is
ekpaŝi	ek'paŝ'i
ekpaŝis	ek'paŝ'is
ekpendis	ek'pend'is
ekpensas	ek'pens'as
ekpensi	ek'pens'i
ekpensis	ek'pens'is
ekpenso	ek'pens'o
ekpensu	ek'pens'u
ekpensante	ek'pens'ant'e
ekperdis	ek'perd'is
ekplaĉis	ek'plaĉ'is
ekploras	ek'plor'as
ekplori	ek'plor'i
ekploris	ek'plor'is
ekploros	ek'plor'os
ekploregis	ek'plor'eg'is
ekpluvas	ek'pluv'as
ekpluvis	ek'pluv'is
ekpluvo	ek'pluv'o
ekpluvos	ek'pluv'os
ekpluvegis	ek'pluv'eg'is
ekportis	ek'port'is
ekposedas	ek'posed'as
ekposedi	ek'posed'i
ekposedis	ek'posed'is
ekposedo	ek'posed'o
ekpovis	ek'pov'is
ekpraktikis	ek'praktik'is
ekpremis	ek'prem'is
ekprenas	ek'pren'as
ekpreni	ek'pren'i
ekprenis	ek'pren'is
ekprenos	ek'pren'os
ekpreparis	ek'prepar'is
ekpromenis	ek'promen'is
ekprospero	ek'prosper'o
ekprosperon	ek'prosper'o'n
ekprotestis	ek'protest'is
ekprovas	ek'prov'as
ekprovis	ek'prov'is
ekpuŝo	ek'puŝ'o
ekpuŝulo	ek'puŝ'ul'o
ekrajdis	ek'rajd'is
ekrakontis	ek'rakont'is
ekrampis	ek'ramp'is
ekrapidis	ek'rapid'is
ekreproduktiĝas	ek're'produkt'iĝ'as
ekregas	ek'reg'as
ekregi	ek'reg'i
ekregis	ek'reg'is
ekrego	ek'reg'o
ekregos	ek'reg'os
ekribelas	ek'ribel'as
ekribelis	ek'ribel'is
ekridas	ek'rid'as
ekridis	ek'rid'is
ekridegis	ek'rid'eg'is
ekridetis	ek'rid'et'is
ekrigardas	ek'rigard'as
ekrigardi	ek'rigard'i
ekrigardis	ek'rigard'is
ekrigardo	ek'rigard'o
ekrigardon	ek'rigard'o'n
ekrigardu	ek'rigard'u
ekrigardinte	ek'rigard'int'e
ekrilati	ek'rilat'i
ekrimarkis	ek'rimark'is
ekruliĝis	ek'rul'iĝ'is
ekŝajnis	ek'ŝajn'is
eksaltas	ek'salt'as
eksalti	ek'salt'i
eksaltis	ek'salt'is
ekŝanceliĝis	ek'ŝancel'iĝ'is
eksangis	ek'sang'is
ekŝatas	ek'ŝat'as
ekŝatis	ek'ŝat'is
ekscias	ek'sci'as
ekscii	ek'sci'i
eksciis	ek'sci'is
ekscio	ek'sci'o
ekscion	ek'sci'o'n
ekscios	ek'sci'os
eksciu	ek'sci'u
ekscius	ek'sci'us
eksciante	ek'sci'ant'e
eksciinte	ek'sci'int'e
eksentas	ek'sent'as
eksenti	ek'sent'i
eksentis	ek'sent'is
eksentos	ek'sent'os
eksentinte	ek'sent'int'e
ekserĉas	ek'serĉ'as
ekserĉis	ek'serĉ'is
ekservis	ek'serv'is
eksiblis	ek'sibl'is
eksidas	ek'sid'as
eksidi	ek'sid'i
eksidis	ek'sid'is
eksidos	ek'sid'os
eksidu	ek'sid'u
eksilentas	ek'silent'as
eksilentis	ek'silent'is
ekskribis	ek'skrib'is
ekskuis	ek'sku'is
ekskuiĝis	ek'sku'iĝ'is
eksonas	ek'son'as
eksonis	ek'son'is
eksonos	ek'son'os
eksonoris	ek'sonor'is
eksopiris	ek'sopir'is
ekspiris	ek'spir'is
ekstaras	ek'star'as
ekstari	ek'star'i
ekstaris	ek'star'is
ekstaros	ek'star'os
ekstaru	ek'star'u
ekstarus	ek'star'us
ekstaradis	ek'star'ad'is
ekstarante	ek'star'ant'e
ekstariĝis	ek'star'iĝ'is
ekstarinte	ek'star'int'e
ekstartis	ek'start'is
eksterna	ek'stern'a
ekstudas	ek'stud'as
ekstudi	ek'stud'i
ekstudis	ek'stud'is
eksuferis	ek'sufer'is
eksuspektis	ek'suspekt'is
eksvingis	ek'sving'is
ektedas	ek'ted'as
ektedis	ek'ted'is
ektenas	ek'ten'as
ekteni	ek'ten'i
ektenis	ek'ten'is
ektenado	ek'ten'ad'o
ektimas	ek'tim'as
ektimis	ek'tim'is
ektimo	ek'tim'o
ektimos	ek'tim'os
ektimigis	ek'tim'ig'is
ektimiĝis	ek'tim'iĝ'is
ektintis	ek'tint'is
ektiris	ek'tir'is
ektiro	ek'tir'o
ektondris	ek'tondr'is
ektremas	ek'trem'as
ektremis	ek'trem'is
ektremetis	ek'trem'et'is
ektrenis	ek'tren'is
ektrinkis	ek'trink'is
ektrotis	ek'trot'is
ektrovis	ek'trov'is
ektroviĝis	ek'trov'iĝ'is
ekturnis	ek'turn'is
ekturniĝis	ek'turn'iĝ'is
ektusis	ek'tus'is
ektuŝas	ek'tuŝ'as
ektuŝi	ek'tuŝ'i
ektuŝis	ek'tuŝ'is
ektuŝo	ek'tuŝ'o
ekuzas	ek'uz'as
ekuzi	ek'uz'i
ekuzis	ek'uz'is
ekuzo	ek'uz'o
ekuzos	ek'uz'os
ekuzu	ek'uz'u
ekuziĝis	ek'uz'iĝ'is
ekvalidas	ek'valid'as
ekvalidis	ek'valid'is
ekvalidos	ek'valid'os
ekvenis	ek'ven'is
ekvendis	ek'vend'is
ekverkis	ek'verk'is
ekveturas	ek'vetur'as
ekveturi	ek'vetur'i
ekveturis	ek'vetur'is
ekveturo	ek'vetur'o
ekveturos	ek'vetur'os
ekveturanta	ek'vetur'ant'a
ekvibris	ek'vibr'is
ekvidas	ek'vid'as
ekvidi	ek'vid'i
ekvidis	ek'vid'is
ekvido	ek'vid'o
ekvidoj	ek'vid'o'j
ekvidos	ek'vid'os
ekvidus	ek'vid'us
ekvidante	ek'vid'ant'e
ekvidinte	ek'vid'int'e
ekvidita	ek'vid'it'a
ekviditaj	ek'vid'it'a'j
ekviglis	ek'vigl'is
ekvivas	ek'viv'as
ekvivis	ek'viv'is
ekvojis	ek'voj'is
ekvojaĝi	ek'vojaĝ'i
ekvojaĝis	ek'vojaĝ'is
ekvojaĝos	ek'vojaĝ'os
ekvokis	ek'vok'is
ekvolis	ek'vol'is
ekvolos	ek'vol'os
ekzumis	ek'zum'is
ekbatano	ekbatan'o
ekinodermoj	ekinoderm'o'j
ekipas	ekip'as
ekipi	ekip'i
ekipis	ekip'is
ekipo	ekip'o
ekipon	ekip'o'n
ekipado	ekip'ad'o
ekipaĵo	ekip'aĵ'o
ekipaĵoj	ekip'aĵ'o'j
ekipaĵojn	ekip'aĵ'o'j'n
ekipaĵon	ekip'aĵ'o'n
ekipaĵaro	ekip'aĵ'ar'o
ekipaĵoproduktantoj	ekip'aĵ'o'produkt'ant'o'j
ekipataj	ekip'at'a'j
ekipita	ekip'it'a
ekipitaj	ekip'it'a'j
ekipitajn	ekip'it'a'j'n
ekipitan	ekip'it'a'n
eklektika	eklektik'a
eklektikan	eklektik'a'n
eklektikismo	eklektik'ism'o
eklezia	eklezi'a
ekleziaj	eklezi'a'j
ekleziajn	eklezi'a'j'n
eklezian	eklezi'a'n
eklezio	eklezi'o
eklezioj	eklezi'o'j
ekleziojn	eklezi'o'j'n
eklezion	eklezi'o'n
ekleziano	eklezi'an'o
eklezianoj	eklezi'an'o'j
ekleziestroj	eklezi'estr'o'j
ekleziulo	eklezi'ul'o
ekleziuloj	eklezi'ul'o'j
ekleziulojn	eklezi'ul'o'j'n
eklipsa	eklips'a
eklipso	eklips'o
eklipsoj	eklips'o'j
eklipson	eklips'o'n
ekliptiko	ekliptik'o
eklogo	eklog'o
eklogismo	eklog'ism'o
ekoregiono	eko'region'o
ekoregionoj	eko'region'o'j
ekoregionojn	eko'region'o'j'n
ekoregionon	eko'region'o'n
ekosistemo	eko'sistem'o
ekosistemoj	eko'sistem'o'j
ekosistemojn	eko'sistem'o'j'n
ekosistemon	eko'sistem'o'n
ekosistemservoj	eko'sistem'serv'o'j
ekoturismo	eko'turism'o
ekozono	eko'zon'o
ekologoj	ekolog'o'j
ekologia	ekolog'i'a
ekologiaj	ekolog'i'a'j
ekologiajn	ekolog'i'a'j'n
ekologian	ekolog'i'a'n
ekologie	ekolog'i'e
ekologio	ekolog'i'o
ekologion	ekolog'i'o'n
ekologiema	ekolog'i'em'a
ekologiemaj	ekolog'i'em'a'j
ekologiisma	ekolog'i'ism'a
ekologiismo	ekolog'i'ism'o
ekologiisto	ekolog'i'ist'o
ekologiistoj	ekolog'i'ist'o'j
ekonomo	ekonom'o
ekonomia	ekonomi'a
ekonomiaj	ekonomi'a'j
ekonomiajn	ekonomi'a'j'n
ekonomian	ekonomi'a'n
ekonomie	ekonomi'e
ekonomio	ekonomi'o
ekonomioj	ekonomi'o'j
ekonomiojn	ekonomi'o'j'n
ekonomion	ekonomi'o'n
ekonomiisto	ekonomi'ist'o
ekonomiistoj	ekonomi'ist'o'j
ekonomika	ekonomik'a
ekonomikaj	ekonomik'a'j
ekonomikajn	ekonomik'a'j'n
ekonomikan	ekonomik'a'n
ekonomike	ekonomik'e
ekonomiko	ekonomik'o
ekonomikon	ekonomik'o'n
ekonomikisto	ekonomik'ist'o
ekonomikistoj	ekonomik'ist'o'j
ekrana	ekran'a
ekranaj	ekran'a'j
ekrano	ekran'o
ekranoj	ekran'o'j
ekranojn	ekran'o'j'n
ekranon	ekran'o'n
ekranego	ekran'eg'o
ekranlegiloj	ekran'leg'il'o'j
ekranmuro	ekran'mur'o
ekranpafo	ekran'paf'o
eksa	eks'a
eksaj	eks'a'j
eksajn	eks'a'j'n
eksan	eks'a'n
eksafikso	eks'afiks'o
eksĉefministro	eks'ĉef'ministr'o
eksedzo	eks'edz'o
eksedziĝi	eks'edz'iĝ'i
eksedziĝis	eks'edz'iĝ'is
eksedziĝo	eks'edz'iĝ'o
eksedziĝon	eks'edz'iĝ'o'n
eksedziĝos	eks'edz'iĝ'os
eksedziĝinta	eks'edz'iĝ'int'a
eksedzino	eks'edz'in'o
eksedziniĝi	eks'edz'in'iĝ'i
eksedziniĝis	eks'edz'in'iĝ'is
eksgeedziĝo	eks'ge'edz'iĝ'o
eksgeedziĝon	eks'ge'edz'iĝ'o'n
eksidinte	eks'id'int'e
eksigi	eks'ig'i
eksigis	eks'ig'is
eksigo	eks'ig'o
eksigon	eks'ig'o'n
eksigita	eks'ig'it'a
eksigitaj	eks'ig'it'a'j
eksiĝas	eks'iĝ'as
eksiĝi	eks'iĝ'i
eksiĝis	eks'iĝ'is
eksiĝo	eks'iĝ'o
eksiĝoj	eks'iĝ'o'j
eksiĝon	eks'iĝ'o'n
eksiĝos	eks'iĝ'os
eksiĝu	eks'iĝ'u
eksiĝinta	eks'iĝ'int'a
eksiĝintaj	eks'iĝ'int'a'j
eksiĝintan	eks'iĝ'int'a'n
ekskolonioj	eks'koloni'o'j
ekskoramiko	eks'kor'amik'o
eksministro	eks'ministr'o
eksmoda	eks'mod'a
eksmodaj	eks'mod'a'j
eksmodajn	eks'mod'a'j'n
eksmodiĝis	eks'mod'iĝ'is
eksprefikso	eks'prefiks'o
eksprezidanto	eks'prezid'ant'o
eksprezidento	eks'prezident'o
eksproprietigo	eks'propriet'ig'o
ekssklavoj	eks'sklav'o'j
ekssovetiaj	eks'soveti'a'j
eksstudento	eks'student'o
eksstudentoj	eks'student'o'j
eksstudentojn	eks'student'o'j'n
ekssufikso	eks'sufiks'o
ekstendaranoj	eks'tend'ar'an'o'j
eksvalidiĝas	eks'valid'iĝ'as
eksvalidiĝi	eks'valid'iĝ'i
eksvalidiĝis	eks'valid'iĝ'is
eksvalidiĝo	eks'valid'iĝ'o
eksvirbovo	eks'vir'bov'o
ekscelenco	ekscelenc'o
ekscentra	ekscentr'a
ekscentraj	ekscentr'a'j
ekscentreco	ekscentr'ec'o
ekscentrulo	ekscentr'ul'o
ekscesa	eksces'a
ekscesaj	eksces'a'j
ekscese	eksces'e
eksceso	eksces'o
ekscesoj	eksces'o'j
ekscesojn	eksces'o'j'n
eksceson	eksces'o'n
ekscita	ekscit'a
ekscitaj	ekscit'a'j
ekscitan	ekscit'a'n
ekscitas	ekscit'as
ekscite	ekscit'e
eksciti	ekscit'i
ekscitis	ekscit'is
ekscito	ekscit'o
ekscitoj	ekscit'o'j
eksciton	ekscit'o'n
ekscitado	ekscit'ad'o
ekscitanta	ekscit'ant'a
ekscitante	ekscit'ant'e
eksciteco	ekscit'ec'o
ekscitiĝas	ekscit'iĝ'as
ekscitiĝi	ekscit'iĝ'i
ekscitiĝis	ekscit'iĝ'is
ekscitigho	ekscit'iĝ'o
ekscitiĝo	ekscit'iĝ'o
ekscitiĝon	ekscit'iĝ'o'n
ekscitiĝu	ekscit'iĝ'u
ekscitita	ekscit'it'a
ekscititaj	ekscit'it'a'j
ekscititajn	ekscit'it'a'j'n
ekscititan	ekscit'it'a'n
ekscitite	ekscit'it'e
eksklavo	eksklav'o
eksklavoj	eksklav'o'j
ekskluda	eksklud'a
ekskludas	eksklud'as
eksklude	eksklud'e
ekskludi	eksklud'i
ekskludis	eksklud'is
ekskludo	eksklud'o
ekskludon	eksklud'o'n
ekskludado	eksklud'ad'o
ekskludanta	eksklud'ant'a
ekskludantaj	eksklud'ant'a'j
ekskludante	eksklud'ant'e
ekskludita	eksklud'it'a
ekskluditaj	eksklud'it'a'j
ekskludprincipo	eksklud'princip'o
ekskluziva	ekskluziv'a
ekskluzivaj	ekskluziv'a'j
ekskluzivajn	ekskluziv'a'j'n
ekskluzivan	ekskluziv'a'n
ekskluzivas	ekskluziv'as
ekskluzive	ekskluziv'e
ekskluzivi	ekskluziv'i
ekskluziveco	ekskluziv'ec'o
ekskluzivita	ekskluziv'it'a
ekskomunikis	ekskomunik'is
ekskomuniko	ekskomunik'o
ekskomunikita	ekskomunik'it'a
ekskomunikitaj	ekskomunik'it'a'j
ekskrementoj	ekskrement'o'j
ekskrementojn	ekskrement'o'j'n
ekskursa	ekskurs'a
ekskursas	ekskurs'as
ekskursi	ekskurs'i
ekskursis	ekskurs'is
ekskurso	ekskurs'o
ekskursoj	ekskurs'o'j
ekskursojn	ekskurs'o'j'n
ekskurson	ekskurs'o'n
ekskursos	ekskurs'os
ekskursantoj	ekskurs'ant'o'j
ekskurseto	ekskurs'et'o
ekskursetoj	ekskurs'et'o'j
ekskursetojn	ekskurs'et'o'j'n
ekskurseton	ekskurs'et'o'n
ekskursoŝipo	ekskurs'o'ŝip'o
ekskursoŝipoj	ekskurs'o'ŝip'o'j
ekskursoŝipon	ekskurs'o'ŝip'o'n
ekskuzas	ekskuz'as
ekskuzi	ekskuz'i
ekskuzis	ekskuz'is
ekskuzo	ekskuz'o
ekskuzoj	ekskuz'o'j
ekskuzojn	ekskuz'o'j'n
ekskuzon	ekskuz'o'n
ekspansia	ekspansi'a
ekspansias	ekspansi'as
ekspansiis	ekspansi'is
ekspansio	ekspansi'o
ekspansion	ekspansi'o'n
ekspansianta	ekspansi'ant'a
ekspansiema	ekspansi'em'a
ekspansiemaj	ekspansi'em'a'j
ekspansiigi	ekspansi'ig'i
ekspansiismo	ekspansi'ism'o
ekspeda	eksped'a
ekspedaj	eksped'a'j
ekspedas	eksped'as
ekspedi	eksped'i
ekspedis	eksped'is
ekspedo	eksped'o
ekspedon	eksped'o'n
ekspedado	eksped'ad'o
ekspedante	eksped'ant'e
ekspediĝas	eksped'iĝ'as
ekspedita	eksped'it'a
ekspeditaj	eksped'it'a'j
ekspedicia	ekspedici'a
ekspedicio	ekspedici'o
ekspedicioj	ekspedici'o'j
ekspediciojn	ekspedici'o'j'n
ekspedicion	ekspedici'o'n
ekspedicianoj	ekspedici'an'o'j
ekspediciestro	ekspedici'estr'o
eksperimenta	eksperiment'a
eksperimentaj	eksperiment'a'j
eksperimentajn	eksperiment'a'j'n
eksperimentan	eksperiment'a'n
eksperimentas	eksperiment'as
eksperimente	eksperiment'e
eksperimenti	eksperiment'i
eksperimentis	eksperiment'is
eksperimento	eksperiment'o
eksperimentoj	eksperiment'o'j
eksperimentojn	eksperiment'o'j'n
eksperimenton	eksperiment'o'n
eksperimentado	eksperiment'ad'o
eksperimentadon	eksperiment'ad'o'n
eksperimentisto	eksperiment'ist'o
eksperimentpsikologio	eksperiment'psik'olog'i'o
eksperta	ekspert'a
eksperto	ekspert'o
ekspertoj	ekspert'o'j
ekspertojn	ekspert'o'j'n
eksperton	ekspert'o'n
ekspertsistemoj	ekspert'sistem'o'j
ekspertizo	ekspertiz'o
ekspertizon	ekspertiz'o'n
ekspertizisto	ekspertiz'ist'o
eksplicita	eksplic'it'a
eksplicitaj	eksplic'it'a'j
eksplicitajn	eksplic'it'a'j'n
eksplicitan	eksplic'it'a'n
eksplicite	eksplic'it'e
eksplikas	eksplik'as
ekspliki	eksplik'i
eksplikis	eksplik'is
ekspliko	eksplik'o
eksplikoj	eksplik'o'j
eksplikojn	eksplik'o'j'n
eksplikon	eksplik'o'n
eksplikos	eksplik'os
ekspliku	eksplik'u
eksplikado	eksplik'ad'o
eksplikante	eksplik'ant'e
eksplikita	eksplik'it'a
eksploda	eksplod'a
eksplodaj	eksplod'a'j
eksplodan	eksplod'a'n
eksplodas	eksplod'as
eksplode	eksplod'e
eksplodi	eksplod'i
eksplodis	eksplod'is
eksplodo	eksplod'o
eksplodoj	eksplod'o'j
eksplodojn	eksplod'o'j'n
eksplodon	eksplod'o'n
eksplodos	eksplod'os
eksplodus	eksplod'us
eksplodado	eksplod'ad'o
eksplodaĵo	eksplod'aĵ'o
eksplodaĵoj	eksplod'aĵ'o'j
eksplodaĵojn	eksplod'aĵ'o'j'n
eksplodaĵon	eksplod'aĵ'o'n
eksplodanta	eksplod'ant'a
eksplodante	eksplod'ant'e
eksplodema	eksplod'em'a
eksplodemaj	eksplod'em'a'j
eksplodemajn	eksplod'em'a'j'n
eksplodeman	eksplod'em'a'n
eksplodeme	eksplod'em'e
eksplodiga	eksplod'ig'a
eksplodigas	eksplod'ig'as
eksplodigi	eksplod'ig'i
eksplodigis	eksplod'ig'is
eksplodigo	eksplod'ig'o
eksplodigos	eksplod'ig'os
eksplodilo	eksplod'il'o
eksplodiloj	eksplod'il'o'j
eksplodilojn	eksplod'il'o'j'n
eksplodilon	eksplod'il'o'n
eksplodinta	eksplod'int'a
eksplodita	eksplod'it'a
eksplodmotoro	eksplod'motor'o
eksplodmotoroj	eksplod'motor'o'j
ekspluata	ekspluat'a
ekspluataj	ekspluat'a'j
ekspluatas	ekspluat'as
ekspluati	ekspluat'i
ekspluatis	ekspluat'is
ekspluato	ekspluat'o
ekspluaton	ekspluat'o'n
ekspluatos	ekspluat'os
ekspluatu	ekspluat'u
ekspluatado	ekspluat'ad'o
ekspluatadoj	ekspluat'ad'o'j
ekspluatadon	ekspluat'ad'o'n
ekspluatantaj	ekspluat'ant'a'j
ekspluatante	ekspluat'ant'e
ekspluatantoj	ekspluat'ant'o'j
ekspluatantojn	ekspluat'ant'o'j'n
ekspluatata	ekspluat'at'a
ekspluatataj	ekspluat'at'a'j
ekspluatebla	ekspluat'ebl'a
ekspluatejo	ekspluat'ej'o
ekspluatejoj	ekspluat'ej'o'j
ekspluatistoj	ekspluat'ist'o'j
ekspluatita	ekspluat'it'a
ekspluatitaj	ekspluat'it'a'j
ekspona	ekspon'a
eksponaj	ekspon'a'j
eksponas	ekspon'as
eksponi	ekspon'i
eksponis	ekspon'is
ekspono	ekspon'o
eksponon	ekspon'o'n
eksponos	ekspon'os
eksponado	ekspon'ad'o
eksponaĵoj	ekspon'aĵ'o'j
eksponaĵojn	ekspon'aĵ'o'j'n
eksponante	ekspon'ant'e
eksponata	ekspon'at'a
eksponataj	ekspon'at'a'j
eksponejo	ekspon'ej'o
eksponiĝas	ekspon'iĝ'as
eksponiĝo	ekspon'iĝ'o
eksponiĝon	ekspon'iĝ'o'n
eksponita	ekspon'it'a
eksponitaj	ekspon'it'a'j
eksponite	ekspon'it'e
eksponperiodo	ekspon'period'o
eksponenta	eksponent'a
eksponentaj	eksponent'a'j
eksponentan	eksponent'a'n
eksponente	eksponent'e
eksponento	eksponent'o
eksponentoj	eksponent'o'j
eksporta	eksport'a
eksportaj	eksport'a'j
eksportan	eksport'a'n
eksportas	eksport'as
eksporti	eksport'i
eksportis	eksport'is
eksporto	eksport'o
eksportoj	eksport'o'j
eksporton	eksport'o'n
eksportado	eksport'ad'o
eksportadoj	eksport'ad'o'j
eksportadon	eksport'ad'o'n
eksportaĵoj	eksport'aĵ'o'j
eksportaĵojn	eksport'aĵ'o'j'n
eksportanto	eksport'ant'o
eksportantoj	eksport'ant'o'j
eksportata	eksport'at'a
eksportataj	eksport'at'a'j
eksportfirmao	eksport'firma'o
eksportfirmaoj	eksport'firma'o'j
eksportisto	eksport'ist'o
eksportita	eksport'it'a
eksportitaj	eksport'it'a'j
ekspozicia	ekspozici'a
ekspoziciaj	ekspozici'a'j
ekspozician	ekspozici'a'n
ekspozicias	ekspozici'as
ekspozicii	ekspozici'i
ekspoziciis	ekspozici'is
ekspozicio	ekspozici'o
ekspozicioj	ekspozici'o'j
ekspoziciojn	ekspozici'o'j'n
ekspozicion	ekspozici'o'n
ekspozicios	ekspozici'os
ekspoziciado	ekspozici'ad'o
ekspoziciaĵo	ekspozici'aĵ'o
ekspoziciaĵoj	ekspozici'aĵ'o'j
ekspoziciaĵojn	ekspozici'aĵ'o'j'n
ekspoziciaĵon	ekspozici'aĵ'o'n
ekspozicianta	ekspozici'ant'a
ekspoziciantaj	ekspozici'ant'a'j
ekspoziciante	ekspozici'ant'e
ekspoziciata	ekspozici'at'a
ekspoziciataj	ekspozici'at'a'j
ekspoziciejo	ekspozici'ej'o
ekspoziciejoj	ekspozici'ej'o'j
ekspoziciejon	ekspozici'ej'o'n
ekspoziciita	ekspozici'it'a
ekspoziciitaj	ekspozici'it'a'j
ekspresa	ekspres'a
ekspresaj	ekspres'a'j
eksprese	ekspres'e
ekspreso	ekspres'o
ekspresoj	ekspres'o'j
ekspresionisma	ekspresionism'a
ekspresionismaj	ekspresionism'a'j
ekspresionismo	ekspresionism'o
ekstaza	ekstaz'a
ekstaze	ekstaz'e
ekstazo	ekstaz'o
ekstazon	ekstaz'o'n
ekster	ekster
ekstera	ekster'a
eksteraj	ekster'a'j
eksterajn	ekster'a'j'n
eksteran	ekster'a'n
ekstere	ekster'e
eksteren	ekster'e'n
ekstero	ekster'o
eksteron	ekster'o'n
eksterafera	ekster'afer'a
eksterafrikaj	ekster'afrik'a'j
eksterajho	ekster'aĵ'o
eksteraĵo	ekster'aĵ'o
eksteraĵoj	ekster'aĵ'o'j
eksteraĵon	ekster'aĵ'o'n
eksterĉela	ekster'ĉel'a
eksterĉelaj	ekster'ĉel'a'j
eksterĉelan	ekster'ĉel'a'n
ekstercentra	ekster'centr'a
ekstercentraj	ekster'centr'a'j
eksterdistrikta	ekster'distrikt'a
eksterdistriktaj	ekster'distrikt'a'j
eksterdoma	ekster'dom'a
eksterdomaj	ekster'dom'a'j
eksterdome	ekster'dom'e
eksterdube	ekster'dub'e
ekstereco	ekster'ec'o
eksterecoj	ekster'ec'o'j
eksterecojn	ekster'ec'o'j'n
ekstereŭropaj	ekster'eŭrop'a'j
ekstereŭropanoj	ekster'eŭrop'an'o'j
ekstergalaksia	ekster'galaksi'a
ekstergeedza	ekster'ge'edz'a
ekstergeedzaj	ekster'ge'edz'a'j
eksterhejme	ekster'hejm'e
eksterkapitalaj	ekster'kapital'a'j
eksterkutima	ekster'kutim'a
eksterkutime	ekster'kutim'e
eksterlanda	ekster'land'a
eksterlandaj	ekster'land'a'j
eksterlandajn	ekster'land'a'j'n
eksterlandan	ekster'land'a'n
eksterlande	ekster'land'e
eksterlanden	ekster'land'e'n
eksterlando	ekster'land'o
eksterlandoj	ekster'land'o'j
eksterlandon	ekster'land'o'n
eksterlandano	ekster'land'an'o
eksterlandanoj	ekster'land'an'o'j
eksterlandanojn	ekster'land'an'o'j'n
eksterlandanoeŭropo	ekster'land'an'o'eŭrop'o
eksterleĝa	ekster'leĝ'a
eksterleĝan	ekster'leĝ'a'n
eksterleĝulo	ekster'leĝ'ul'o
eksterministeria	ekster'ministeri'a
ekstermoda	ekster'mod'a
ekstermovada	ekster'mov'ad'a
ekstermovadaj	ekster'mov'ad'a'j
eksternacia	ekster'naci'a
eksternorma	ekster'norm'a
eksteroministro	ekster'o'ministr'o
eksterordinara	ekster'ordinar'a
eksterordinaraj	ekster'ordinar'a'j
eksterordinarajn	ekster'ordinar'a'j'n
eksterordinaran	ekster'ordinar'a'n
eksterordinare	ekster'ordinar'e
eksterpoli	ekster'pol'i
eksterpolitika	ekster'politik'a
eksterpolitikaj	ekster'politik'a'j
eksterreta	ekster'ret'a
eksterŝipe	ekster'ŝip'e
eksterskeleto	ekster'skelet'o
eksterskeletoj	ekster'skelet'o'j
eksterŝtate	ekster'ŝtat'e
eksterŝtataĵoj	ekster'ŝtat'aĵ'o'j
ekstersunsistema	ekster'sun'sistem'a
ekstersunsistemaj	ekster'sun'sistem'a'j
ekstertema	ekster'tem'a
ekstertemaj	ekster'tem'a'j
ekstertempa	ekster'temp'a
ekstertera	ekster'ter'a
eksterteraj	ekster'ter'a'j
eksterteran	ekster'ter'a'n
eksterterana	ekster'ter'an'a
eksterteranaj	ekster'ter'an'a'j
eksterterano	ekster'ter'an'o
eksterteranoj	ekster'ter'an'o'j
eksterteranojn	ekster'ter'an'o'j'n
eksterteruloj	ekster'ter'ul'o'j
eksterteritoriaj	ekster'teritori'a'j
ekstertropika	ekster'tropik'a
eksterulo	ekster'ul'o
eksteruloj	ekster'ul'o'j
eksterulojn	ekster'ul'o'j'n
eksteruniversitataj	ekster'universitat'a'j
eksterurba	ekster'urb'a
eksterurbaj	ekster'urb'a'j
eksterurbe	ekster'urb'e
eksterutera	ekster'uter'a
eksterma	eksterm'a
ekstermaj	eksterm'a'j
ekstermas	eksterm'as
ekstermi	eksterm'i
ekstermis	eksterm'is
ekstermo	eksterm'o
ekstermon	eksterm'o'n
ekstermos	eksterm'os
ekstermu	eksterm'u
ekstermado	eksterm'ad'o
ekstermadon	eksterm'ad'o'n
ekstermita	eksterm'it'a
ekstermitaj	eksterm'it'a'j
ekstra	ekstr'a
ekstraj	ekstr'a'j
ekstrajn	ekstr'a'j'n
ekstran	ekstr'a'n
ekstraversio	ekstr'a'versi'o
ekstraĵo	ekstr'aĵ'o
ekstraĵoj	ekstr'aĵ'o'j
ekstradicio	ekstradici'o
ekstraktas	ekstrakt'as
ekstrakti	ekstrakt'i
ekstraktis	ekstrakt'is
ekstrakto	ekstrakt'o
ekstraktoj	ekstrakt'o'j
ekstrakton	ekstrakt'o'n
ekstraktado	ekstrakt'ad'o
ekstraktadon	ekstrakt'ad'o'n
ekstraktita	ekstrakt'it'a
ekstraktitaj	ekstrakt'it'a'j
ekstrapolo	ekstrapol'o
ekstravaganca	ekstravaganc'a
ekstravagancaj	ekstravaganc'a'j
ekstravagancan	ekstravaganc'a'n
ekstrema	ekstrem'a
ekstremaj	ekstrem'a'j
ekstremajn	ekstrem'a'j'n
ekstreman	ekstrem'a'n
ekstreme	ekstrem'e
ekstremo	ekstrem'o
ekstremoj	ekstrem'o'j
ekstremojn	ekstrem'o'j'n
ekstremon	ekstrem'o'n
ekstremaĵo	ekstrem'aĵ'o
ekstremaĵoj	ekstrem'aĵ'o'j
ekstremaĵojn	ekstrem'aĵ'o'j'n
ekstremaĵon	ekstrem'aĵ'o'n
ekstremdekstra	ekstrem'dekstr'a
ekstremdekstraj	ekstrem'dekstr'a'j
ekstremdekstruloj	ekstrem'dekstr'ul'o'j
ekstremisma	ekstrem'ism'a
ekstremismaj	ekstrem'ism'a'j
ekstremismo	ekstrem'ism'o
ekstremismon	ekstrem'ism'o'n
ekstremisto	ekstrem'ist'o
ekstremistoj	ekstrem'ist'o'j
ekstremistojn	ekstrem'ist'o'j'n
ekstremaduro	ekstremadur'o
ektopia	ektopi'a
ekumena	ekumen'a
ekumenaj	ekumen'a'j
ekumenajn	ekumen'a'j'n
ekumenan	ekumen'a'n
ekumeno	ekumen'o
ekumenismo	ekumen'ism'o
ekumenismon	ekumen'ism'o'n
ekvacio	ekvaci'o
ekvacioj	ekvaci'o'j
ekvaciojn	ekvaci'o'j'n
ekvacion	ekvaci'o'n
ekvadora	ekvador'a
ekvadoro	ekvador'o
ekvatora	ekvator'a
ekvatoraj	ekvator'a'j
ekvatoran	ekvator'a'n
ekvatoro	ekvator'o
ekvatoron	ekvator'o'n
ekvilibra	ekvilibr'a
ekvilibraj	ekvilibr'a'j
ekvilibrajn	ekvilibr'a'j'n
ekvilibran	ekvilibr'a'n
ekvilibras	ekvilibr'as
ekvilibre	ekvilibr'e
ekvilibro	ekvilibr'o
ekvilibroj	ekvilibr'o'j
ekvilibrojn	ekvilibr'o'j'n
ekvilibron	ekvilibr'o'n
ekvilibrigas	ekvilibr'ig'as
ekvilibrigi	ekvilibr'ig'i
ekvilibrigo	ekvilibr'ig'o
ekvilibrigita	ekvilibr'ig'it'a
ekvilibrita	ekvilibr'it'a
ekvinokso	ekvinoks'o
ekvinoksoj	ekvinoks'o'j
ekvivalenta	ekvivalent'a
ekvivalentaj	ekvivalent'a'j
ekvivalentajn	ekvivalent'a'j'n
ekvivalentan	ekvivalent'a'n
ekvivalentas	ekvivalent'as
ekvivalente	ekvivalent'e
ekvivalento	ekvivalent'o
ekvivalentoj	ekvivalent'o'j
ekvivalentojn	ekvivalent'o'j'n
ekvivalenton	ekvivalent'o'n
ekvivalenteco	ekvivalent'ec'o
ekvivalentecon	ekvivalent'ec'o'n
ekvivalentprincipo	ekvivalent'princip'o
ekvivalentrilato	ekvivalent'rilat'o
ekzakta	ekzakt'a
ekzaktaj	ekzakt'a'j
ekzaktajn	ekzakt'a'j'n
ekzaktan	ekzakt'a'n
ekzakte	ekzakt'e
ekzakteco	ekzakt'ec'o
ekzaktecon	ekzakt'ec'o'n
ekzaltas	ekzalt'as
ekzaltiĝo	ekzalt'iĝ'o
ekzaltita	ekzalt'it'a
ekzaltitaj	ekzalt'it'a'j
ekzamena	ekzamen'a
ekzamenaj	ekzamen'a'j
ekzamenajn	ekzamen'a'j'n
ekzamenan	ekzamen'a'n
ekzamenas	ekzamen'as
ekzameni	ekzamen'i
ekzamenis	ekzamen'is
ekzameno	ekzamen'o
ekzamenoj	ekzamen'o'j
ekzamenojn	ekzamen'o'j'n
ekzamenon	ekzamen'o'n
ekzamenos	ekzamen'os
ekzamenu	ekzamen'u
ekzamenus	ekzamen'us
ekzamenado	ekzamen'ad'o
ekzamenadon	ekzamen'ad'o'n
ekzamenanta	ekzamen'ant'a
ekzamenantaj	ekzamen'ant'a'j
ekzamenante	ekzamen'ant'e
ekzamenanto	ekzamen'ant'o
ekzamenantoj	ekzamen'ant'o'j
ekzamenantaro	ekzamen'ant'ar'o
ekzamenata	ekzamen'at'a
ekzamenataj	ekzamen'at'a'j
ekzamenatoj	ekzamen'at'o'j
ekzameniĝi	ekzamen'iĝ'i
ekzameniĝis	ekzamen'iĝ'is
ekzameninte	ekzamen'int'e
ekzamenita	ekzamen'it'a
ekzamenitaj	ekzamen'it'a'j
ekzamenite	ekzamen'it'e
ekzamensistemo	ekzamen'sistem'o
ekzegezo	ekzegez'o
ekzegezistoj	ekzegez'ist'o'j
ekzekutas	ekzekut'as
ekzekuti	ekzekut'i
ekzekutis	ekzekut'is
ekzekuto	ekzekut'o
ekzekutoj	ekzekut'o'j
ekzekutojn	ekzekut'o'j'n
ekzekuton	ekzekut'o'n
ekzekutado	ekzekut'ad'o
ekzekutejo	ekzekut'ej'o
ekzekutisto	ekzekut'ist'o
ekzekutistoj	ekzekut'ist'o'j
ekzekutistojn	ekzekut'ist'o'j'n
ekzekutiston	ekzekut'ist'o'n
ekzekutita	ekzekut'it'a
ekzekutitaj	ekzekut'it'a'j
ekzekutiva	ekzekutiv'a
ekzekutivo	ekzekutiv'o
ekzemo	ekzem'o
ekzempla	ekzempl'a
ekzemplaj	ekzempl'a'j
ekzemplajn	ekzempl'a'j'n
ekzemplan	ekzempl'a'n
ekzemplas	ekzempl'as
ekzemple	ekzempl'e
ekzempli	ekzempl'i
ekzemplo	ekzempl'o
ekzemploj	ekzempl'o'j
ekzemplojn	ekzempl'o'j'n
ekzemplon	ekzempl'o'n
ekzempligas	ekzempl'ig'as
ekzempligi	ekzempl'ig'i
ekzempligis	ekzempl'ig'is
ekzempligita	ekzempl'ig'it'a
ekzempligitaj	ekzempl'ig'it'a'j
ekzempligite	ekzempl'ig'it'e
ekzemplocele	ekzempl'o'cel'e
ekzemplodona	ekzempl'o'don'a
ekzemplofrazoj	ekzempl'o'fraz'o'j
ekzemplero	ekzempler'o
ekzempleroj	ekzempler'o'j
ekzemplerojn	ekzempler'o'j'n
ekzempleron	ekzempler'o'n
ekzerca	ekzerc'a
ekzercas	ekzerc'as
ekzerci	ekzerc'i
ekzercis	ekzerc'is
ekzerco	ekzerc'o
ekzercoj	ekzerc'o'j
ekzercojn	ekzerc'o'j'n
ekzercon	ekzerc'o'n
ekzercos	ekzerc'os
ekzercu	ekzerc'u
ekzercadi	ekzerc'ad'i
ekzercadis	ekzerc'ad'is
ekzercado	ekzerc'ad'o
ekzercadon	ekzerc'ad'o'n
ekzercanta	ekzerc'ant'a
ekzercante	ekzerc'ant'e
ekzercaro	ekzerc'ar'o
ekzercaron	ekzerc'ar'o'n
ekzercejo	ekzerc'ej'o
ekzerciĝas	ekzerc'iĝ'as
ekzerciĝi	ekzerc'iĝ'i
ekzerciĝis	ekzerc'iĝ'is
ekzercita	ekzerc'it'a
ekzercitaj	ekzerc'it'a'j
ekzerciteco	ekzerc'it'ec'o
ekzila	ekzil'a
ekzili	ekzil'i
ekzilis	ekzil'is
ekzilo	ekzil'o
ekziloj	ekzil'o'j
ekzilon	ekzil'o'n
ekziligis	ekzil'ig'is
ekziliĝi	ekzil'iĝ'i
ekziliĝis	ekzil'iĝ'is
ekzilita	ekzil'it'a
ekzilitaj	ekzil'it'a'j
ekzilito	ekzil'it'o
ekzilitoj	ekzil'it'o'j
ekzilota	ekzil'ot'a
ekzilregistaro	ekzil'reg'ist'ar'o
ekzista	ekzist'a
ekzistaj	ekzist'a'j
ekzistajn	ekzist'a'j'n
ekzistan	ekzist'a'n
ekzistas	ekzist'as
ekzisti	ekzist'i
ekzistis	ekzist'is
ekzisto	ekzist'o
ekziston	ekzist'o'n
ekzistos	ekzist'os
ekzistu	ekzist'u
ekzistus	ekzist'us
ekzistado	ekzist'ad'o
ekzistadoj	ekzist'ad'o'j
ekzistadon	ekzist'ad'o'n
ekzistadismo	ekzist'ad'ism'o
ekzistaĵo	ekzist'aĵ'o
ekzistanta	ekzist'ant'a
ekzistantaj	ekzist'ant'a'j
ekzistantajn	ekzist'ant'a'j'n
ekzistantan	ekzist'ant'a'n
ekzistante	ekzist'ant'e
ekzisteca	ekzist'ec'a
ekzistecaj	ekzist'ec'a'j
ekzistecan	ekzist'ec'a'n
ekzisteco	ekzist'ec'o
ekzistecon	ekzist'ec'o'n
ekzistinta	ekzist'int'a
ekzistintaj	ekzist'int'a'j
ekzistintus	ekzist'int'us
ekzistorajton	ekzist'o'rajt'o'n
ekzorco	ekzorc'o
ekzorcoj	ekzorc'o'j
ekzorcisto	ekzorc'ist'o
ekzota	ekzot'a
ekzotaj	ekzot'a'j
ekzotajn	ekzot'a'j'n
ekzotan	ekzot'a'n
ekzotismo	ekzot'ism'o
ekzoterma	ekzoterm'a
ekzotika	ekzotik'a
ekzotikaj	ekzotik'a'j
ekzotikajn	ekzotik'a'j'n
ekzotikan	ekzotik'a'n
el	el
elaĉeta	el'aĉet'a
elaĉeti	el'aĉet'i
elaĉetis	el'aĉet'is
elaĉeto	el'aĉet'o
elaĉeton	el'aĉet'o'n
elaĉetanto	el'aĉet'ant'o
elaĉetinto	el'aĉet'int'o
elaĉetita	el'aĉet'it'a
elaĉetitaj	el'aĉet'it'a'j
elaĉetomono	el'aĉet'o'mon'o
elaĉetomonon	el'aĉet'o'mon'o'n
elamasigis	el'amas'ig'is
elamasigita	el'amas'ig'it'a
elaŭskultis	el'aŭskult'is
elbabilis	el'babil'is
elbakis	el'bak'is
elbakitaj	el'bak'it'a'j
elbatis	el'bat'is
elbusiĝis	el'bus'iĝ'is
elbuŝigas	el'buŝ'ig'as
elbuŝigi	el'buŝ'ig'i
elbuŝigis	el'buŝ'ig'is
elcento	el'cent'o
elcentoj	el'cent'o'j
elcentojn	el'cent'o'j'n
elcenton	el'cent'o'n
elcentaĵo	el'cent'aĵ'o
elĉerpa	el'ĉerp'a
elĉerpas	el'ĉerp'as
elĉerpi	el'ĉerp'i
elĉerpis	el'ĉerp'is
elĉerpante	el'ĉerp'ant'e
elĉerpigas	el'ĉerp'ig'as
elĉerpigis	el'ĉerp'ig'is
elĉerpiĝas	el'ĉerp'iĝ'as
elĉerpiĝis	el'ĉerp'iĝ'is
elĉerpiĝo	el'ĉerp'iĝ'o
elĉerpiĝon	el'ĉerp'iĝ'o'n
elĉerpiĝos	el'ĉerp'iĝ'os
elĉerpita	el'ĉerp'it'a
elĉerpitaj	el'ĉerp'it'a'j
elĉerpitajn	el'ĉerp'it'a'j'n
elĉerpitan	el'ĉerp'it'a'n
elĉerpite	el'ĉerp'it'e
elĉizita	el'ĉiz'it'a
eldetruita	el'detru'it'a
eldevigis	el'dev'ig'is
eldiras	el'dir'as
eldiri	el'dir'i
eldiris	el'dir'is
eldiro	el'dir'o
eldiroj	el'dir'o'j
eldirojn	el'dir'o'j'n
eldiron	el'dir'o'n
eldiros	el'dir'os
eldiru	el'dir'u
eldirado	el'dir'ad'o
eldiraĵo	el'dir'aĵ'o
eldiraĵoj	el'dir'aĵ'o'j
eldiraĵojn	el'dir'aĵ'o'j'n
eldiraĵon	el'dir'aĵ'o'n
eldirante	el'dir'ant'e
eldirita	el'dir'it'a
eldiritaj	el'dir'it'a'j
eldiritajn	el'dir'it'a'j'n
eldona	el'don'a
eldonaj	el'don'a'j
eldonan	el'don'a'n
eldonas	el'don'as
eldoni	el'don'i
eldonis	el'don'is
eldono	el'don'o
eldonoj	el'don'o'j
eldonojn	el'don'o'j'n
eldonon	el'don'o'n
eldonos	el'don'os
eldonu	el'don'u
eldonadi	el'don'ad'i
eldonadis	el'don'ad'is
eldonado	el'don'ad'o
eldonadon	el'don'ad'o'n
eldonagado	el'don'ag'ad'o
eldonaĵo	el'don'aĵ'o
eldonaĵoj	el'don'aĵ'o'j
eldonaĵojn	el'don'aĵ'o'j'n
eldonaĵon	el'don'aĵ'o'n
eldonante	el'don'ant'e
eldonanto	el'don'ant'o
eldonantoj	el'don'ant'o'j
eldonata	el'don'at'a
eldonataj	el'don'at'a'j
eldoneja	el'don'ej'a
eldonejo	el'don'ej'o
eldonejoj	el'don'ej'o'j
eldonejojn	el'don'ej'o'j'n
eldonejon	el'don'ej'o'n
eldonigis	el'don'ig'is
eldoniĝas	el'don'iĝ'as
eldoniĝis	el'don'iĝ'is
eldoniĝos	el'don'iĝ'os
eldonindustrio	el'don'industri'o
eldoninto	el'don'int'o
eldonintoj	el'don'int'o'j
eldonisto	el'don'ist'o
eldonistoj	el'don'ist'o'j
eldonistojn	el'don'ist'o'j'n
eldoniston	el'don'ist'o'n
eldonita	el'don'it'a
eldonitaj	el'don'it'a'j
eldonitajn	el'don'it'a'j'n
eldonitan	el'don'it'a'n
eldonite	el'don'it'e
eldonjaro	el'don'jar'o
eldonkooperativo	el'don'kooperativ'o
eldonkvanto	el'don'kvant'o
eldonkvantoj	el'don'kvant'o'j
eldonkvanton	el'don'kvant'o'n
eldonota	el'don'ot'a
eldormiĝis	el'dorm'iĝ'is
elekstere	el'ekster'e
elelektita	el'elekt'it'a
elelektitaj	el'elekt'it'a'j
elfalas	el'fal'as
elfali	el'fal'i
elfalis	el'fal'is
elfandado	el'fand'ad'o
elfaras	el'far'as
elfari	el'far'i
elfaris	el'far'is
elfaro	el'far'o
elfaron	el'far'o'n
elfaros	el'far'os
elfaru	el'far'u
elfarus	el'far'us
elfarado	el'far'ad'o
elfaranta	el'far'ant'a
elfarantaj	el'far'ant'a'j
elfarante	el'far'ant'e
elfarita	el'far'it'a
elfazigita	el'faz'ig'it'a
elfazigitaj	el'faz'ig'it'a'j
elfluas	el'flu'as
elflui	el'flu'i
elfluis	el'flu'is
elfluo	el'flu'o
elfluoj	el'flu'o'j
elfluon	el'flu'o'n
elfluado	el'flu'ad'o
elfluadon	el'flu'ad'o'n
elfluanta	el'flu'ant'a
elfluejo	el'flu'ej'o
elflugas	el'flug'as
elflugis	el'flug'is
elformi	el'form'i
elformis	el'form'is
elformiĝas	el'form'iĝ'as
elformiĝis	el'form'iĝ'is
elfosas	el'fos'as
elfosi	el'fos'i
elfosis	el'fos'is
elfosado	el'fos'ad'o
elfosadoj	el'fos'ad'o'j
elfosadojn	el'fos'ad'o'j'n
elfosadon	el'fos'ad'o'n
elfosaĵo	el'fos'aĵ'o
elfosaĵoj	el'fos'aĵ'o'j
elfosejoj	el'fos'ej'o'j
elfosita	el'fos'it'a
elfositaj	el'fos'it'a'j
elglitas	el'glit'as
elglitis	el'glit'is
elgrimpis	el'grimp'is
elhakis	el'hak'is
eliga	el'ig'a
eligas	el'ig'as
eligi	el'ig'i
eligis	el'ig'is
eligo	el'ig'o
eligoj	el'ig'o'j
eligon	el'ig'o'n
eligos	el'ig'os
eligu	el'ig'u
eligadis	el'ig'ad'is
eligado	el'ig'ad'o
eliganta	el'ig'ant'a
eligantaj	el'ig'ant'a'j
eligante	el'ig'ant'e
eligata	el'ig'at'a
eligita	el'ig'it'a
eligitaj	el'ig'it'a'j
eliĝas	el'iĝ'as
eliĝi	el'iĝ'i
eliĝis	el'iĝ'is
eliĝo	el'iĝ'o
eliĝu	el'iĝ'u
eliĝanta	el'iĝ'ant'a
elingigis	el'ing'ig'is
elinterne	el'intern'e
elira	el'ir'a
eliraj	el'ir'a'j
eliras	el'ir'as
eliri	el'ir'i
eliris	el'ir'is
eliro	el'ir'o
eliroj	el'ir'o'j
elirojn	el'ir'o'j'n
eliron	el'ir'o'n
eliros	el'ir'os
eliru	el'ir'u
elirus	el'ir'us
eliradis	el'ir'ad'is
elirado	el'ir'ad'o
eliradon	el'ir'ad'o'n
eliranta	el'ir'ant'a
elirantaj	el'ir'ant'a'j
elirantajn	el'ir'ant'a'j'n
elirantan	el'ir'ant'a'n
elirante	el'ir'ant'e
elirejo	el'ir'ej'o
elirejoj	el'ir'ej'o'j
elirejojn	el'ir'ej'o'j'n
elirejon	el'ir'ej'o'n
elirigas	el'ir'ig'as
elirigi	el'ir'ig'i
elirigis	el'ir'ig'is
elirinta	el'ir'int'a
elirintaj	el'ir'int'a'j
elirinte	el'ir'int'e
elirmalpermeso	el'ir'mal'permes'o
elirmalpermeson	el'ir'mal'permes'o'n
elironta	el'ir'ont'a
elirpunkto	el'ir'punkt'o
elirpunktoj	el'ir'punkt'o'j
elirpunkton	el'ir'punkt'o'n
elirvojo	el'ir'voj'o
elirvojon	el'ir'voj'o'n
elĵetas	el'ĵet'as
elĵeti	el'ĵet'i
elĵetis	el'ĵet'is
elĵeto	el'ĵet'o
elĵeton	el'ĵet'o'n
elĵetu	el'ĵet'u
elĵetante	el'ĵet'ant'e
elĵetita	el'ĵet'it'a
elĵetitaj	el'ĵet'it'a'j
elkalkuli	el'kalkul'i
elkalkulis	el'kalkul'is
elkonduki	el'konduk'i
elkondukis	el'konduk'is
elkonduko	el'konduk'o
elkondukoj	el'konduk'o'j
elkonduku	el'konduk'u
elkora	el'kor'a
elkorajn	el'kor'a'j'n
elkoran	el'kor'a'n
elkore	el'kor'e
elkovas	el'kov'as
elkovi	el'kov'i
elkovis	el'kov'is
elkoviĝas	el'kov'iĝ'as
elkoviĝis	el'kov'iĝ'is
elkreskas	el'kresk'as
elkreski	el'kresk'i
elkreskis	el'kresk'is
elkreskos	el'kresk'os
elkreskaĵo	el'kresk'aĵ'o
elkreskaĵoj	el'kresk'aĵ'o'j
elkreskinta	el'kresk'int'a
elkreskintaj	el'kresk'int'a'j
elkrias	el'kri'as
elkriis	el'kri'is
elkrucigo	el'kruc'ig'o
elkulturis	el'kultur'is
elkuras	el'kur'as
elkuris	el'kur'is
ellaboras	el'labor'as
ellabori	el'labor'i
ellaboris	el'labor'is
ellaboro	el'labor'o
ellaboron	el'labor'o'n
ellaboros	el'labor'os
ellaboru	el'labor'u
ellaborado	el'labor'ad'o
ellaboradon	el'labor'ad'o'n
ellaborante	el'labor'ant'e
ellaboranto	el'labor'ant'o
ellaborata	el'labor'at'a
ellaborataj	el'labor'at'a'j
ellaboriĝis	el'labor'iĝ'is
ellaborita	el'labor'it'a
ellaboritaj	el'labor'it'a'j
ellaboritajn	el'labor'it'a'j'n
ellaboritan	el'labor'it'a'n
ellaciĝo	el'lac'iĝ'o
ellandigo	el'land'ig'o
ellasa	el'las'a
ellasan	el'las'a'n
ellasas	el'las'as
ellasi	el'las'i
ellasis	el'las'is
ellaso	el'las'o
ellason	el'las'o'n
ellasos	el'las'os
ellasu	el'las'u
ellasante	el'las'ant'e
ellasejo	el'las'ej'o
ellasejoj	el'las'ej'o'j
ellasejojn	el'las'ej'o'j'n
ellasejon	el'las'ej'o'n
ellasgaso	el'las'gas'o
ellasgasoj	el'las'gas'o'j
ellasilo	el'las'il'o
ellasiloj	el'las'il'o'j
ellasilon	el'las'il'o'n
ellasita	el'las'it'a
ellasitaj	el'las'it'a'j
ellasoredukto	el'las'o'redukt'o
ellastruo	el'las'tru'o
ellastruoj	el'las'tru'o'j
ellavita	el'lav'it'a
ellavitaj	el'lav'it'a'j
ellegis	el'leg'is
ellernas	el'lern'as
ellerni	el'lern'i
ellernis	el'lern'is
ellerno	el'lern'o
ellernos	el'lern'os
ellernu	el'lern'u
ellernado	el'lern'ad'o
ellernebla	el'lern'ebl'a
ellitiĝas	el'lit'iĝ'as
ellitiĝi	el'lit'iĝ'i
ellitiĝis	el'lit'iĝ'is
ellitiĝo	el'lit'iĝ'o
ellitiĝos	el'lit'iĝ'os
ellitiĝu	el'lit'iĝ'u
ellogas	el'log'as
ellogi	el'log'i
ellogis	el'log'is
ellogita	el'log'it'a
ellogitaj	el'log'it'a'j
elluktis	el'lukt'is
elluktita	el'lukt'it'a
elluktitaj	el'lukt'it'a'j
elmetas	el'met'as
elmeti	el'met'i
elmetis	el'met'is
elmetos	el'met'os
elmetu	el'met'u
elmetataj	el'met'at'a'j
elmetita	el'met'it'a
elmetitaj	el'met'it'a'j
elmigras	el'migr'as
elmigri	el'migr'i
elmigris	el'migr'is
elmigro	el'migr'o
elmigrado	el'migr'ad'o
elmigradon	el'migr'ad'o'n
elmigranto	el'migr'ant'o
elmigrantoj	el'migr'ant'o'j
elmigrinta	el'migr'int'a
elmigrintaj	el'migr'int'a'j
elmigrinto	el'migr'int'o
elmigrintoj	el'migr'int'o'j
elminigado	el'min'ig'ad'o
elminita	el'min'it'a
elmontras	el'montr'as
elmontri	el'montr'i
elmontris	el'montr'is
elmontro	el'montr'o
elmontroj	el'montr'o'j
elmontron	el'montr'o'n
elmontros	el'montr'os
elmontru	el'montr'u
elmontrus	el'montr'us
elmontrado	el'montr'ad'o
elmontranta	el'montr'ant'a
elmontrantaj	el'montr'ant'a'j
elmontrante	el'montr'ant'e
elmontriĝis	el'montr'iĝ'is
elmontrita	el'montr'it'a
elmontritaj	el'montr'it'a'j
elmontrite	el'montr'it'e
elnaĝis	el'naĝ'is
elnestiĝas	el'nest'iĝ'as
elnestiĝo	el'nest'iĝ'o
elnodiĝo	el'nod'iĝ'o
elnombrado	el'nombr'ad'o
elorienteŭropaj	el'orient'eŭrop'a'j
eloviĝas	el'ov'iĝ'as
eloviĝo	el'ov'iĝ'o
eloviĝintaj	el'ov'iĝ'int'a'j
elpagi	el'pag'i
elpakis	el'pak'is
elparolaj	el'parol'a'j
elparolas	el'parol'as
elparoli	el'parol'i
elparolis	el'parol'is
elparolo	el'parol'o
elparoloj	el'parol'o'j
elparolojn	el'parol'o'j'n
elparolon	el'parol'o'n
elparolu	el'parol'u
elparolado	el'parol'ad'o
elparolata	el'parol'at'a
elparolataj	el'parol'at'a'j
elparolebla	el'parol'ebl'a
elparolita	el'parol'it'a
elpaŝas	el'paŝ'as
elpaŝi	el'paŝ'i
elpaŝis	el'paŝ'is
elpasho	el'paŝ'o
elpaŝo	el'paŝ'o
elpaŝoj	el'paŝ'o'j
elpaŝojn	el'paŝ'o'j'n
elpaŝon	el'paŝ'o'n
elpelas	el'pel'as
elpeli	el'pel'i
elpelis	el'pel'is
elpelo	el'pel'o
elpeloj	el'pel'o'j
elpelojn	el'pel'o'j'n
elpelon	el'pel'o'n
elpelos	el'pel'os
elpelu	el'pel'u
elpelita	el'pel'it'a
elpelitaj	el'pel'it'a'j
elpensas	el'pens'as
elpensi	el'pens'i
elpensis	el'pens'is
elpenso	el'pens'o
elpensos	el'pens'os
elpensu	el'pens'u
elpensus	el'pens'us
elpensado	el'pens'ad'o
elpensaĵo	el'pens'aĵ'o
elpensaĵoj	el'pens'aĵ'o'j
elpensante	el'pens'ant'e
elpensinta	el'pens'int'a
elpensinto	el'pens'int'o
elpensita	el'pens'it'a
elpensitaj	el'pens'it'a'j
elpensitajn	el'pens'it'a'j'n
elpensitan	el'pens'it'a'n
elpensite	el'pens'it'e
elpetas	el'pet'as
elpeti	el'pet'i
elpetis	el'pet'is
elpetu	el'pet'u
elpikis	el'pik'is
elportas	el'port'as
elporti	el'port'i
elportis	el'port'is
elportu	el'port'u
elpoŝigas	el'poŝ'ig'as
elpoŝigis	el'poŝ'ig'is
elpostenigis	el'posten'ig'is
elpostenigita	el'posten'ig'it'a
elpremas	el'prem'as
elpremi	el'prem'i
elpremis	el'prem'is
elpremita	el'prem'it'a
elprenas	el'pren'as
elpreni	el'pren'i
elprenis	el'pren'is
elpreno	el'pren'o
elprenu	el'pren'u
elprenado	el'pren'ad'o
elprenante	el'pren'ant'e
elpreninte	el'pren'int'e
elprenita	el'pren'it'a
elprenitaj	el'pren'it'a'j
elprovas	el'prov'as
elprovi	el'prov'i
elprovis	el'prov'is
elprovo	el'prov'o
elprovoj	el'prov'o'j
elprovon	el'prov'o'n
elprovu	el'prov'u
elprovado	el'prov'ad'o
elprovilo	el'prov'il'o
elproviloj	el'prov'il'o'j
elprovita	el'prov'it'a
elprovitaj	el'prov'it'a'j
elpurigas	el'pur'ig'as
elpurigis	el'pur'ig'is
elpurigo	el'pur'ig'o
elpurigitaj	el'pur'ig'it'a'j
elpuŝas	el'puŝ'as
elpuŝis	el'puŝ'is
elpuŝos	el'puŝ'os
elrabis	el'rab'is
elradias	el'radi'as
elradiis	el'radi'is
elradikigas	el'radik'ig'as
elradikigi	el'radik'ig'i
elradikigitaj	el'radik'ig'it'a'j
elrajdis	el'rajd'is
elrampis	el'ramp'is
elreliĝis	el'rel'iĝ'is
elreviga	el'rev'ig'a
elrevigas	el'rev'ig'as
elrevigi	el'rev'ig'i
elrevigis	el'rev'ig'is
elrevigita	el'rev'ig'it'a
elrevigitaj	el'rev'ig'it'a'j
elreviĝis	el'rev'iĝ'is
elreviĝo	el'rev'iĝ'o
elreviĝon	el'rev'iĝ'o'n
elreviĝinta	el'rev'iĝ'int'a
elrigardas	el'rigard'as
elrigardi	el'rigard'i
elrigardis	el'rigard'is
elrigardon	el'rigard'o'n
elsaltas	el'salt'as
elsalti	el'salt'i
elsaltis	el'salt'is
elŝalti	el'ŝalt'i
elŝaltis	el'ŝalt'is
elŝaltu	el'ŝalt'u
elsarki	el'sark'i
elsavi	el'sav'i
elsaviĝo	el'sav'iĝ'o
elsekiĝo	el'sek'iĝ'o
elsenda	el'send'a
elsendas	el'send'as
elsendi	el'send'i
elsendis	el'send'is
elsendo	el'send'o
elsendoj	el'send'o'j
elsendojn	el'send'o'j'n
elsendon	el'send'o'n
elsendos	el'send'os
elsendu	el'send'u
elsendus	el'send'us
elsendado	el'send'ad'o
elsendadon	el'send'ad'o'n
elsendaĵo	el'send'aĵ'o
elsendaĵoj	el'send'aĵ'o'j
elsendanta	el'send'ant'a
elsendante	el'send'ant'e
elsendata	el'send'at'a
elsendataj	el'send'at'a'j
elsendfluo	el'send'flu'o
elsendiĝas	el'send'iĝ'as
elsendiĝis	el'send'iĝ'is
elsendita	el'send'it'a
elsenditaj	el'send'it'a'j
elsenditajn	el'send'it'a'j'n
elsenditan	el'send'it'a'n
elsendite	el'send'it'e
elserĉas	el'serĉ'as
elserĉi	el'serĉ'i
elserĉis	el'serĉ'is
elŝipiĝas	el'ŝip'iĝ'as
elŝipiĝi	el'ŝip'iĝ'i
elŝipiĝis	el'ŝip'iĝ'is
elŝipiĝo	el'ŝip'iĝ'o
elŝiras	el'ŝir'as
elŝiri	el'ŝir'i
elŝiris	el'ŝir'is
elŝiriĝis	el'ŝir'iĝ'is
elŝirita	el'ŝir'it'a
elŝiritaj	el'ŝir'it'a'j
elŝovas	el'ŝov'as
elŝovi	el'ŝov'i
elŝovis	el'ŝov'is
elŝoviĝis	el'ŝov'iĝ'is
elspeza	el'spez'a
elspezas	el'spez'as
elspeze	el'spez'e
elspezi	el'spez'i
elspezis	el'spez'is
elspezo	el'spez'o
elspezoj	el'spez'o'j
elspezojn	el'spez'o'j'n
elspezon	el'spez'o'n
elspezos	el'spez'os
elspezu	el'spez'u
elspezus	el'spez'us
elspezado	el'spez'ad'o
elspezadon	el'spez'ad'o'n
elspezante	el'spez'ant'e
elspezita	el'spez'it'a
elspezitaj	el'spez'it'a'j
elspiras	el'spir'as
elspiri	el'spir'i
elspiris	el'spir'is
elspiro	el'spir'o
elspiron	el'spir'o'n
elspiru	el'spir'u
elspirado	el'spir'ad'o
elspirita	el'spir'it'a
elŝprucis	el'ŝpruc'is
elspuri	el'spur'i
elŝrankigo	el'ŝrank'ig'o
elstara	el'star'a
elstaraj	el'star'a'j
elstarajn	el'star'a'j'n
elstaran	el'star'a'n
elstaras	el'star'as
elstare	el'star'e
elstari	el'star'i
elstaris	el'star'is
elstaraĵo	el'star'aĵ'o
elstaraĵoj	el'star'aĵ'o'j
elstaraĵojn	el'star'aĵ'o'j'n
elstaraĵon	el'star'aĵ'o'n
elstaranta	el'star'ant'a
elstarantaj	el'star'ant'a'j
elstarantajn	el'star'ant'a'j'n
elstarantan	el'star'ant'a'n
elstarante	el'star'ant'e
elstareco	el'star'ec'o
elstarecon	el'star'ec'o'n
elstarega	el'star'eg'a
elstarfiguroj	el'star'figur'o'j
elstarigas	el'star'ig'as
elstarigi	el'star'ig'i
elstarigis	el'star'ig'is
elstarigado	el'star'ig'ad'o
elstarigante	el'star'ig'ant'e
elstarigita	el'star'ig'it'a
elstarigitaj	el'star'ig'it'a'j
elstariĝas	el'star'iĝ'as
elstariĝis	el'star'iĝ'is
elstarita	el'star'it'a
elstarulo	el'star'ul'o
elstaruloj	el'star'ul'o'j
elsuĉas	el'suĉ'as
elŝutas	el'ŝut'as
elŝuti	el'ŝut'i
elŝutis	el'ŝut'is
elŝuto	el'ŝut'o
elŝutu	el'ŝut'u
elŝutado	el'ŝut'ad'o
elŝutante	el'ŝut'ant'e
elŝutebla	el'ŝut'ebl'a
elŝuteblaj	el'ŝut'ebl'a'j
elŝuteblas	el'ŝut'ebl'as
elŝutita	el'ŝut'it'a
elŝutitaj	el'ŝut'it'a'j
eltenas	el'ten'as
elteni	el'ten'i
eltenis	el'ten'is
elteno	el'ten'o
eltenos	el'ten'os
eltenu	el'ten'u
eltenus	el'ten'us
eltenado	el'ten'ad'o
eltenanta	el'ten'ant'a
eltenante	el'ten'ant'e
eltenebla	el'ten'ebl'a
elteneblas	el'ten'ebl'as
eltenema	el'ten'em'a
eltenemaj	el'ten'em'a'j
elteneman	el'ten'em'a'n
eltenemo	el'ten'em'o
eltenemon	el'ten'em'o'n
eltenita	el'ten'it'a
elterigis	el'ter'ig'is
elterigitaj	el'ter'ig'it'a'j
eltiras	el'tir'as
eltiri	el'tir'i
eltiris	el'tir'is
eltiro	el'tir'o
eltiros	el'tir'os
eltiru	el'tir'u
eltirus	el'tir'us
eltirado	el'tir'ad'o
eltiraĵo	el'tir'aĵ'o
eltiraĵoj	el'tir'aĵ'o'j
eltiraĵojn	el'tir'aĵ'o'j'n
eltiraĵon	el'tir'aĵ'o'n
eltirante	el'tir'ant'e
eltiriĝis	el'tir'iĝ'is
eltirita	el'tir'it'a
eltiritaj	el'tir'it'a'j
eltondis	el'tond'is
eltondaĵoj	el'tond'aĵ'o'j
eltrajniĝis	el'trajn'iĝ'is
eltranĉi	el'tranĉ'i
eltranĉis	el'tranĉ'is
eltranĉaĵo	el'tranĉ'aĵ'o
eltranĉaĵoj	el'tranĉ'aĵ'o'j
eltranĉita	el'tranĉ'it'a
eltranĉitaj	el'tranĉ'it'a'j
eltrenis	el'tren'is
eltrinkas	el'trink'as
eltrinki	el'trink'i
eltrinkis	el'trink'is
eltrinkinte	el'trink'int'e
eltrovas	el'trov'as
eltrovi	el'trov'i
eltrovis	el'trov'is
eltrovo	el'trov'o
eltrovoj	el'trov'o'j
eltrovojn	el'trov'o'j'n
eltrovon	el'trov'o'n
eltrovos	el'trov'os
eltrovu	el'trov'u
eltrovus	el'trov'us
eltrovaĵo	el'trov'aĵ'o
eltrovaĵoj	el'trov'aĵ'o'j
eltrovaĵojn	el'trov'aĵ'o'j'n
eltrovaĵon	el'trov'aĵ'o'n
eltrovema	el'trov'em'a
eltrovemo	el'trov'em'o
eltrovemon	el'trov'em'o'n
eltrovinto	el'trov'int'o
eltrovintoj	el'trov'int'o'j
eltrovita	el'trov'it'a
eltrovitaj	el'trov'it'a'j
eltrudado	el'trud'ad'o
elturmentita	el'turment'it'a
elturniĝas	el'turn'iĝ'as
elturniĝi	el'turn'iĝ'i
elturniĝis	el'turn'iĝ'is
elturniĝo	el'turn'iĝ'o
elturniĝoj	el'turn'iĝ'o'j
elturniĝon	el'turn'iĝ'o'n
elturniĝos	el'turn'iĝ'os
elturniĝu	el'turn'iĝ'u
elturniĝus	el'turn'iĝ'us
elturniĝema	el'turn'iĝ'em'a
eluza	el'uz'a
eluzas	el'uz'as
eluzi	el'uz'i
eluzis	el'uz'is
eluzo	el'uz'o
eluzos	el'uz'os
eluzu	el'uz'u
eluzus	el'uz'us
eluzado	el'uz'ad'o
eluzanta	el'uz'ant'a
eluzantaj	el'uz'ant'a'j
eluzante	el'uz'ant'e
eluzata	el'uz'at'a
eluziĝas	el'uz'iĝ'as
eluziĝis	el'uz'iĝ'is
eluziĝo	el'uz'iĝ'o
eluziĝon	el'uz'iĝ'o'n
eluzita	el'uz'it'a
eluzitaj	el'uz'it'a'j
eluzitajn	el'uz'it'a'j'n
eluzitan	el'uz'it'a'n
eluzite	el'uz'it'e
elvenas	el'ven'as
elveni	el'ven'i
elvenis	el'ven'is
elvenos	el'ven'os
elvenu	el'ven'u
elverŝas	el'verŝ'as
elverŝi	el'verŝ'i
elverŝis	el'verŝ'is
elverŝiĝis	el'verŝ'iĝ'is
elverŝita	el'verŝ'it'a
elveturas	el'vetur'as
elveturis	el'vetur'is
elvido	el'vid'o
elvira	el'vir'a
elvokas	el'vok'as
elvoki	el'vok'i
elvokis	el'vok'is
elvoko	el'vok'o
elvokos	el'vok'os
elvoku	el'vok'u
elvokado	el'vok'ad'o
elvokante	el'vok'ant'e
elvokita	el'vok'it'a
elvokitaj	el'vok'it'a'j
elvolvas	el'volv'as
elvolvi	el'volv'i
elvolvis	el'volv'is
elamo	elam'o
elano	elan'o
elanon	elan'o'n
elasta	elast'a
elastaj	elast'a'j
elastajn	elast'a'j'n
elastan	elast'a'n
elaste	elast'e
elasteco	elast'ec'o
elastecoj	elast'ec'o'j
elastecon	elast'ec'o'n
elba	elb'a
elbe	elb'e
elbo	elb'o
elefanta	elefant'a
elefantaj	elefant'a'j
elefanto	elefant'o
elefantoj	elefant'o'j
elefantojn	elefant'o'j'n
elefanton	elefant'o'n
eleganta	elegant'a
elegantaj	elegant'a'j
elegantajn	elegant'a'j'n
elegantan	elegant'a'n
elegante	elegant'e
eleganto	elegant'o
eleganteco	elegant'ec'o
elegantecon	elegant'ec'o'n
elegia	elegi'a
elegio	elegi'o
elegioj	elegi'o'j
elekta	elekt'a
elektaj	elekt'a'j
elektan	elekt'a'n
elektas	elekt'as
elekti	elekt'i
elektis	elekt'is
elekto	elekt'o
elektoj	elekt'o'j
elektojn	elekt'o'j'n
elekton	elekt'o'n
elektos	elekt'os
elektu	elekt'u
elektus	elekt'us
elektada	elekt'ad'a
elektadis	elekt'ad'is
elektado	elekt'ad'o
elektadon	elekt'ad'o'n
elektanta	elekt'ant'a
elektantaj	elekt'ant'a'j
elektante	elekt'ant'e
elektanto	elekt'ant'o
elektantoj	elekt'ant'o'j
elektantaro	elekt'ant'ar'o
elektata	elekt'at'a
elektataj	elekt'at'a'j
elektebla	elekt'ebl'a
elekteblaj	elekt'ebl'a'j
elekteblajn	elekt'ebl'a'j'n
elekteblo	elekt'ebl'o
elektebloj	elekt'ebl'o'j
elekteblojn	elekt'ebl'o'j'n
elekteblon	elekt'ebl'o'n
elektebleco	elekt'ebl'ec'o
elektema	elekt'em'a
elektemaj	elekt'em'a'j
elektiĝas	elekt'iĝ'as
elektiĝi	elekt'iĝ'i
elektiĝis	elekt'iĝ'is
elektiĝo	elekt'iĝ'o
elektiĝos	elekt'iĝ'os
elektinta	elekt'int'a
elektinte	elekt'int'e
elektintoj	elekt'int'o'j
elektisto	elekt'ist'o
elektistoj	elekt'ist'o'j
elektistaro	elekt'ist'ar'o
elektita	elekt'it'a
elektitaj	elekt'it'a'j
elektitajn	elekt'it'a'j'n
elektitan	elekt'it'a'n
elektite	elekt'it'e
elektito	elekt'it'o
elektitoj	elekt'it'o'j
elektitojn	elekt'it'o'j'n
elektiton	elekt'it'o'n
elektodistrikto	elekt'o'distrikt'o
elektodistriktoj	elekt'o'distrikt'o'j
elektokampanjo	elekt'o'kampanj'o
elektokomisiono	elekt'o'komision'o
elektoprinclando	elekt'o'princ'land'o
elektosistemo	elekt'o'sistem'o
elektota	elekt'ot'a
elektotaj	elekt'ot'a'j
elektra	elektr'a
elektraj	elektr'a'j
elektrajn	elektr'a'j'n
elektran	elektr'a'n
elektre	elektr'e
elektro	elektr'o
elektron	elektr'o'n
elektraenergia	elektr'a'energi'a
elektraĵo	elektr'aĵ'o
elektrejo	elektr'ej'o
elektrejoj	elektr'ej'o'j
elektrigita	elektr'ig'it'a
elektrigitaj	elektr'ig'it'a'j
elektristo	elektr'ist'o
elektrizo	elektr'iz'o
elektroaparatoj	elektr'o'aparat'o'j
elektrocentralo	elektr'o'central'o
elektrocentraloj	elektr'o'central'o'j
elektrocentralojn	elektr'o'central'o'j'n
elektrocentralon	elektr'o'central'o'n
elektrodinamiko	elektr'o'dinamik'o
elektroencefalografio	elektr'o'encefal'o'graf'i'o
elektroenergia	elektr'o'energi'a
elektroenergio	elektr'o'energi'o
elektrofiziologiaj	elektr'o'fiziolog'i'a'j
elektrofonto	elektr'o'font'o
elektrogenerado	elektr'o'gener'ad'o
elektrokardiografo	elektr'o'kardi'o'graf'o
elektrokardiografio	elektr'o'kardi'o'graf'i'o
elektrokemia	elektr'o'kemi'a
elektrokemiaj	elektr'o'kemi'a'j
elektrokemiajn	elektr'o'kemi'a'j'n
elektrokemian	elektr'o'kemi'a'n
elektrokemie	elektr'o'kemi'e
elektrokompanio	elektr'o'kompani'o
elektrokonsumo	elektr'o'konsum'o
elektrokonsumon	elektr'o'konsum'o'n
elektromagneta	elektr'o'magnet'a
elektromagnetaj	elektr'o'magnet'a'j
elektromagnetajn	elektr'o'magnet'a'j'n
elektromagnetan	elektr'o'magnet'a'n
elektromagnete	elektr'o'magnet'e
elektromagneto	elektr'o'magnet'o
elektromagnetoj	elektr'o'magnet'o'j
elektromagnetismo	elektr'o'magnet'ism'o
elektromekanika	elektr'o'mekanik'a
elektromekanikaj	elektr'o'mekanik'a'j
elektromotoro	elektr'o'motor'o
elektromotoroj	elektr'o'motor'o'j
elektromotorojn	elektr'o'motor'o'j'n
elektromotoron	elektr'o'motor'o'n
elektronegativeco	elektr'o'negativ'ec'o
elektropaneo	elektr'o'pane'o
elektroproduktado	elektr'o'produkt'ad'o
elektroprovizo	elektr'o'proviz'o
elektroprovizoj	elektr'o'proviz'o'j
elektroreto	elektr'o'ret'o
elektroretoj	elektr'o'ret'o'j
elektrosektoro	elektr'o'sektor'o
elektrostatika	elektr'o'statik'a
elektrostatikaj	elektr'o'statik'a'j
elektrostatikan	elektr'o'statik'a'n
elektrotekniko	elektr'o'teknik'o
elektrotrajnoj	elektr'o'trajn'o'j
elektrovarmo	elektr'o'varm'o
elektrodo	elektrod'o
elektrodoj	elektrod'o'j
elektrodojn	elektrod'o'j'n
elektrodon	elektrod'o'n
elektrolito	elektrolit'o
elektrolitoj	elektrolit'o'j
elektroliton	elektrolit'o'n
elektroliza	elektroliz'a
elektrolizaj	elektroliz'a'j
elektrolizo	elektroliz'o
elektrona	elektron'a
elektronaj	elektron'a'j
elektronajn	elektron'a'j'n
elektronan	elektron'a'n
elektrono	elektron'o
elektronoj	elektron'o'j
elektronojn	elektron'o'j'n
elektronon	elektron'o'n
elektronika	elektron'ik'a
elektronikaj	elektron'ik'a'j
elektronikajn	elektron'ik'a'j'n
elektronikan	elektron'ik'a'n
elektronike	elektron'ik'e
elektroniko	elektron'ik'o
elektronikon	elektron'ik'o'n
elektronikaĵoj	elektron'ik'aĵ'o'j
elektronikoindustrio	elektron'ik'o'industri'o
elektronkanono	elektron'kanon'o
elektronmikroskopio	elektron'mikro'skop'i'o
elektronradio	elektron'radi'o
elektronradion	elektron'radi'o'n
elektrontubo	elektron'tub'o
elektrontuboj	elektron'tub'o'j
elementa	element'a
elementaj	element'a'j
elementajn	element'a'j'n
elementan	element'a'n
elemente	element'e
elemento	element'o
elementoj	element'o'j
elementojn	element'o'j'n
elementon	element'o'n
elementlernejanoj	element'lern'ej'an'o'j
eleonora	eleonor'a
elfa	elf'a
elfaj	elf'a'j
elfo	elf'o
elfoj	elf'o'j
elfojn	elf'o'j'n
elio	eli'o
eliksiro	eliksir'o
eliksiron	eliksir'o'n
elimina	elimin'a
eliminas	elimin'as
elimini	elimin'i
eliminis	elimin'is
elimino	elimin'o
eliminon	elimin'o'n
eliminos	elimin'os
eliminus	elimin'us
eliminado	elimin'ad'o
eliminanta	elimin'ant'a
eliminante	elimin'ant'e
eliminita	elimin'it'a
eliminitaj	elimin'it'a'j
elipsa	elips'a
elipsaj	elips'a'j
elipsajn	elips'a'j'n
elipsan	elips'a'n
elipso	elips'o
elipsoido	elips'oid'o
elita	elit'a
elitaj	elit'a'j
elitajn	elit'a'j'n
elitan	elit'a'n
elito	elit'o
elitoj	elit'o'j
elitojn	elit'o'j'n
eliton	elit'o'n
elitismo	elit'ism'o
elituloj	elit'ul'o'j
elitroj	elitr'o'j
elizeaj	elize'a'j
elizeo	elize'o
elizio	elizi'o
elizion	elizi'o'n
eliziita	elizi'it'a
elokventa	elokvent'a
elokventaj	elokvent'a'j
elokventan	elokvent'a'n
elokvente	elokvent'e
elokvento	elokvent'o
elokventon	elokvent'o'n
elokventeco	elokvent'ec'o
elokventecon	elokvent'ec'o'n
ema	em'a
emaj	em'a'j
emas	em'as
eme	em'e
emi	em'i
emis	em'is
emo	em'o
emoj	em'o'j
emojn	em'o'j'n
emon	em'o'n
emos	em'os
emu	em'u
emigas	em'ig'as
emita	em'it'a
emajlo	emajl'o
emajloj	emajl'o'j
emajlon	emajl'o'n
emajlita	emajl'it'a
emanas	eman'as
emanado	eman'ad'o
emanaĵo	eman'aĵ'o
emancipa	emancip'a
emancipado	emancip'ad'o
emancipiĝi	emancip'iĝ'i
emancipiĝo	emancip'iĝ'o
emancipiĝon	emancip'iĝ'o'n
emancipita	emancip'it'a
emancipitaj	emancip'it'a'j
embarasa	embaras'a
embarasaj	embaras'a'j
embarasajn	embaras'a'j'n
embarasan	embaras'a'n
embarasas	embaras'as
embarase	embaras'e
embarasi	embaras'i
embarasis	embaras'is
embaraso	embaras'o
embarasoj	embaras'o'j
embarasojn	embaras'o'j'n
embarason	embaras'o'n
embarasata	embaras'at'a
embarasiĝas	embaras'iĝ'as
embarasiĝis	embaras'iĝ'is
embarasita	embaras'it'a
embarasitaj	embaras'it'a'j
embarasite	embaras'it'e
embargo	embarg'o
embargon	embarg'o'n
emberizo	emberiz'o
emblema	emblem'a
emblemo	emblem'o
emblemoj	emblem'o'j
emblemojn	emblem'o'j'n
emblemon	emblem'o'n
emblemgrafikaj	emblem'grafik'a'j
embolio	emboli'o
embrazuro	embrazur'o
embrazuroj	embrazur'o'j
embria	embri'a
embriaj	embri'a'j
embrio	embri'o
embrioj	embri'o'j
embriojn	embri'o'j'n
embrion	embri'o'n
embriologio	embri'olog'i'o
embuskas	embusk'as
embuske	embusk'e
embuski	embusk'i
embuskis	embusk'is
embusko	embusk'o
embuskoj	embusk'o'j
embuskon	embusk'o'n
embuskita	embusk'it'a
emerĝa	emerĝ'a
emerĝaj	emerĝ'a'j
emerĝajn	emerĝ'a'j'n
emerĝas	emerĝ'as
emerĝis	emerĝ'is
emerĝanta	emerĝ'ant'a
emerĝantaj	emerĝ'ant'a'j
emerĝantajn	emerĝ'ant'a'j'n
emerĝantan	emerĝ'ant'a'n
emerita	emerit'a
emeritaj	emerit'a'j
emeritan	emerit'a'n
emerito	emerit'o
emeritoj	emerit'o'j
emeriteco	emerit'ec'o
emeritigis	emerit'ig'is
emeritiĝi	emerit'iĝ'i
emeritiĝis	emerit'iĝ'is
emeritiĝo	emerit'iĝ'o
emeritiĝon	emerit'iĝ'o'n
emeritiĝos	emerit'iĝ'os
emeritiĝinta	emerit'iĝ'int'a
emerituloj	emerit'ul'o'j
emfaza	emfaz'a
emfazaj	emfaz'a'j
emfazan	emfaz'a'n
emfazas	emfaz'as
emfaze	emfaz'e
emfazi	emfaz'i
emfazis	emfaz'is
emfazo	emfaz'o
emfazoj	emfaz'o'j
emfazojn	emfaz'o'j'n
emfazon	emfaz'o'n
emfazu	emfaz'u
emfazus	emfaz'us
emfazado	emfaz'ad'o
emfazanta	emfaz'ant'a
emfazante	emfaz'ant'e
emfazata	emfaz'at'a
emfazita	emfaz'it'a
emfazitaj	emfaz'it'a'j
emfazitan	emfaz'it'a'n
emfazite	emfaz'it'e
emilo	emil'o
emilon	emil'o'n
emilia	emili'a
emilio	emili'o
emiliano	emilian'o
eminenco	eminenc'o
eminenta	eminent'a
eminentaj	eminent'a'j
eminentajn	eminent'a'j'n
eminentan	eminent'a'n
eminentas	eminent'as
eminente	eminent'e
eminentis	eminent'is
eminenteco	eminent'ec'o
eminentecon	eminent'ec'o'n
eminentiĝis	eminent'iĝ'is
eminentulo	eminent'ul'o
eminentuloj	eminent'ul'o'j
eminentulojn	eminent'ul'o'j'n
eminentulon	eminent'ul'o'n
emiro	emir'o
emiroj	emir'o'j
emirlando	emir'land'o
emirlandoj	emir'land'o'j
emisia	emisi'a
emisiaj	emisi'a'j
emisias	emisi'as
emisii	emisi'i
emisiis	emisi'is
emisio	emisi'o
emisioj	emisi'o'j
emisiojn	emisi'o'j'n
emision	emisi'o'n
emisiado	emisi'ad'o
emisianto	emisi'ant'o
emisiemo	emisi'em'o
emisiita	emisi'it'a
emisiitaj	emisi'it'a'j
emitoro	emitor'o
emitoroj	emitor'o'j
emocia	emoci'a
emociaj	emoci'a'j
emociajn	emoci'a'j'n
emocian	emoci'a'n
emocias	emoci'as
emocie	emoci'e
emocii	emoci'i
emociis	emoci'is
emocio	emoci'o
emocioj	emoci'o'j
emociojn	emoci'o'j'n
emocion	emoci'o'n
emociema	emoci'em'a
emociiga	emoci'ig'a
emociigas	emoci'ig'as
emociigis	emoci'ig'is
emociiĝas	emoci'iĝ'as
emociiĝis	emoci'iĝ'is
emociiĝo	emoci'iĝ'o
emociita	emoci'it'a
emociitaj	emoci'it'a'j
emociite	emoci'it'e
emociplena	emoci'plen'a
emociplenaj	emoci'plen'a'j
empira	empir'a
empire	empir'e
empiro	empir'o
empiron	empir'o'n
empirea	empire'a
empiria	empiri'a
empiriaj	empiri'a'j
empiriajn	empiri'a'j'n
empirian	empiri'a'n
empirie	empiri'e
empirio	empiri'o
emuo	emu'o
emuoj	emu'o'j
emulsio	emulsi'o
emulsioj	emulsi'o'j
emulsianto	emulsi'ant'o
en	en
ena	en'a
enaj	en'a'j
enan	en'a'n
enas	en'as
ene	en'e
enis	en'is
eno	en'o
enoj	en'o'j
enojn	en'o'j'n
enon	en'o'n
enakva	en'akv'a
enakvaj	en'akv'a'j
enakve	en'akv'e
enakvigita	en'akv'ig'it'a
enamigita	en'am'ig'it'a
enamiĝas	en'am'iĝ'as
enamiĝi	en'am'iĝ'i
enamiĝis	en'am'iĝ'is
enamiĝo	en'am'iĝ'o
enamiĝoj	en'am'iĝ'o'j
enamiĝon	en'am'iĝ'o'n
enamiĝos	en'am'iĝ'os
enamiĝu	en'am'iĝ'u
enamiĝinta	en'am'iĝ'int'a
enamiĝintaj	en'am'iĝ'int'a'j
enamiĝinte	en'am'iĝ'int'e
enamiĝinto	en'am'iĝ'int'o
enamiĝintoj	en'am'iĝ'int'o'j
enamiĝlingvo	en'am'iĝ'lingv'o
enamiĝlingvoj	en'am'iĝ'lingv'o'j
enaŭtiĝis	en'aŭt'iĝ'is
enaviadiliĝis	en'aviad'il'iĝ'is
enbalzamigo	en'balzam'ig'o
enbati	en'bat'i
enbatis	en'bat'is
enblovis	en'blov'is
enboteligita	en'botel'ig'it'a
enbusiĝis	en'bus'iĝ'is
enbuŝe	en'buŝ'e
enbuŝigas	en'buŝ'ig'as
enbuŝigis	en'buŝ'ig'is
enbuŝiĝas	en'buŝ'iĝ'as
enĉambra	en'ĉambr'a
enĉiele	en'ĉiel'e
endanĝera	en'danĝer'a
endanĝeraj	en'danĝer'a'j
endanĝerigas	en'danĝer'ig'as
endanĝerigi	en'danĝer'ig'i
endanĝerigis	en'danĝer'ig'is
endanĝerigo	en'danĝer'ig'o
endanĝerigos	en'danĝer'ig'os
endanĝerigus	en'danĝer'ig'us
endanĝerigado	en'danĝer'ig'ad'o
endanĝerigante	en'danĝer'ig'ant'e
endanĝerigata	en'danĝer'ig'at'a
endanĝerigataj	en'danĝer'ig'at'a'j
endanĝerigita	en'danĝer'ig'it'a
endanĝerigitaj	en'danĝer'ig'it'a'j
endanĝerigitajn	en'danĝer'ig'it'a'j'n
endanĝerigitan	en'danĝer'ig'it'a'n
endanĝeriĝas	en'danĝer'iĝ'as
endanĝerita	en'danĝer'it'a
endanĝeritaj	en'danĝer'it'a'j
endatenigiloj	en'daten'ig'il'o'j
endoma	en'dom'a
endomaj	en'dom'a'j
endomajn	en'dom'a'j'n
endoman	en'dom'a'n
endome	en'dom'e
endorme	en'dorm'e
endormiĝas	en'dorm'iĝ'as
endormiĝi	en'dorm'iĝ'i
endormiĝis	en'dorm'iĝ'is
endormiĝo	en'dorm'iĝ'o
endormiĝos	en'dorm'iĝ'os
endormiĝinta	en'dorm'iĝ'int'a
enestas	en'est'as
enesti	en'est'i
enestis	en'est'is
enesto	en'est'o
enfalas	en'fal'as
enfalis	en'fal'is
enfalinta	en'fal'int'a
enfermas	en'ferm'as
enfermi	en'ferm'i
enfermis	en'ferm'is
enfermo	en'ferm'o
enfermon	en'ferm'o'n
enfermaĵo	en'ferm'aĵ'o
enfermaĵoj	en'ferm'aĵ'o'j
enfermaĵon	en'ferm'aĵ'o'n
enfermanta	en'ferm'ant'a
enfermita	en'ferm'it'a
enfermitaj	en'ferm'it'a'j
enfermitan	en'ferm'it'a'n
enfiltriĝo	en'filtr'iĝ'o
enfiltriĝon	en'filtr'iĝ'o'n
enfine	en'fin'e
enfluas	en'flu'as
enfluis	en'flu'is
enfluo	en'flu'o
enfluoj	en'flu'o'j
enfluon	en'flu'o'n
enfluejo	en'flu'ej'o
enflugis	en'flug'is
enfokusigas	en'fokus'ig'as
enfokusigi	en'fokus'ig'i
enfokusigis	en'fokus'ig'is
enfokusigo	en'fokus'ig'o
enfokusigado	en'fokus'ig'ad'o
enfokusigante	en'fokus'ig'ant'e
enfokusigita	en'fokus'ig'it'a
enfokusigitaj	en'fokus'ig'it'a'j
enfokusiĝas	en'fokus'iĝ'as
enfokusiĝis	en'fokus'iĝ'is
enfosis	en'fos'is
enfosita	en'fos'it'a
enfositaj	en'fos'it'a'j
englitis	en'glit'is
englutas	en'glut'as
engluti	en'glut'i
englutis	en'glut'is
engluto	en'glut'o
englutos	en'glut'os
englutu	en'glut'u
englutado	en'glut'ad'o
englutita	en'glut'it'a
englutitaj	en'glut'it'a'j
engrimpis	en'grimp'is
engrunda	en'grund'a
engrunde	en'grund'e
enhava	en'hav'a
enhavaj	en'hav'a'j
enhavan	en'hav'a'n
enhavas	en'hav'as
enhave	en'hav'e
enhavi	en'hav'i
enhavis	en'hav'is
enhavo	en'hav'o
enhavoj	en'hav'o'j
enhavojn	en'hav'o'j'n
enhavon	en'hav'o'n
enhavos	en'hav'os
enhavu	en'hav'u
enhavus	en'hav'us
enhavado	en'hav'ad'o
enhavaĵoj	en'hav'aĵ'o'j
enhavanta	en'hav'ant'a
enhavantaj	en'hav'ant'a'j
enhavantajn	en'hav'ant'a'j'n
enhavantan	en'hav'ant'a'n
enhavante	en'hav'ant'e
enhavata	en'hav'at'a
enhavataj	en'hav'at'a'j
enhaveroj	en'hav'er'o'j
enhavita	en'hav'it'a
enhavitaj	en'hav'it'a'j
enhavitajn	en'hav'it'a'j'n
enhavitan	en'hav'it'a'n
enhavoriĉa	en'hav'o'riĉ'a
enhavoriĉaj	en'hav'o'riĉ'a'j
enhavoriĉan	en'hav'o'riĉ'a'n
enhavosubstancoj	en'hav'o'substanc'o'j
enhavtabelo	en'hav'tabel'o
enhavtabeloj	en'hav'tabel'o'j
enhavtabelon	en'hav'tabel'o'n
enhejma	en'hejm'a
enhospitaligis	en'hospital'ig'is
enhospitaligon	en'hospital'ig'o'n
enhospitaligita	en'hospital'ig'it'a
enhospitaligitaj	en'hospital'ig'it'a'j
enhospitaliĝis	en'hospital'iĝ'is
eniga	en'ig'a
enigan	en'ig'a'n
enigas	en'ig'as
enigi	en'ig'i
enigis	en'ig'is
enigo	en'ig'o
enigon	en'ig'o'n
enigu	en'ig'u
enigado	en'ig'ad'o
enigaĵo	en'ig'aĵ'o
enigaĵoj	en'ig'aĵ'o'j
enigaĵojn	en'ig'aĵ'o'j'n
enigaĵon	en'ig'aĵ'o'n
enigante	en'ig'ant'e
enigataj	en'ig'at'a'j
enigita	en'ig'it'a
enigitaj	en'ig'it'a'j
enigite	en'ig'it'e
eniĝas	en'iĝ'as
eniĝi	en'iĝ'i
eniĝis	en'iĝ'is
eniĝado	en'iĝ'ad'o
eniĝante	en'iĝ'ant'e
enira	en'ir'a
eniran	en'ir'a'n
eniras	en'ir'as
eniri	en'ir'i
eniris	en'ir'is
eniro	en'ir'o
eniroj	en'ir'o'j
eniron	en'ir'o'n
eniros	en'ir'os
eniru	en'ir'u
enirus	en'ir'us
eniradis	en'ir'ad'is
enirado	en'ir'ad'o
eniranta	en'ir'ant'a
enirantaj	en'ir'ant'a'j
enirantajn	en'ir'ant'a'j'n
enirantan	en'ir'ant'a'n
enirante	en'ir'ant'e
enirbileto	en'ir'bilet'o
enirbiletoj	en'ir'bilet'o'j
enirbiletojn	en'ir'bilet'o'j'n
enirbileton	en'ir'bilet'o'n
enirdatumoj	en'ir'datum'o'j
enireja	en'ir'ej'a
enirejo	en'ir'ej'o
enirejoj	en'ir'ej'o'j
enirejojn	en'ir'ej'o'j'n
enirejon	en'ir'ej'o'n
enirekzameno	en'ir'ekzamen'o
enirekzamenon	en'ir'ekzamen'o'n
enirhalo	en'ir'hal'o
enirigas	en'ir'ig'as
enirigi	en'ir'ig'i
enirigis	en'ir'ig'is
enirigu	en'ir'ig'u
enirinta	en'ir'int'a
enirintaj	en'ir'int'a'j
enirinte	en'ir'int'e
enirita	en'ir'it'a
eniritaj	en'ir'it'a'j
enirkontrolas	en'ir'kontrol'as
enirmetodoj	en'ir'metod'o'j
enironta	en'ir'ont'a
enirpermesilo	en'ir'permes'il'o
enirpermesiloj	en'ir'permes'il'o'j
enirpermesilojn	en'ir'permes'il'o'j'n
enirpermesilon	en'ir'permes'il'o'n
enirpordo	en'ir'pord'o
enĵeti	en'ĵet'i
enĵetis	en'ĵet'is
enkadre	en'kadr'e
enkadrigas	en'kadr'ig'as
enkadrigi	en'kadr'ig'i
enkadrigis	en'kadr'ig'is
enkadrigo	en'kadr'ig'o
enkadrigon	en'kadr'ig'o'n
enkadrigita	en'kadr'ig'it'a
enkadrigitaj	en'kadr'ig'it'a'j
enkadriĝas	en'kadr'iĝ'as
enkadriĝi	en'kadr'iĝ'i
enkadriĝis	en'kadr'iĝ'is
enkadrita	en'kadr'it'a
enkalkulas	en'kalkul'as
enkalkuli	en'kalkul'i
enkalkulis	en'kalkul'is
enkalkulos	en'kalkul'os
enkalkulus	en'kalkul'us
enkalkulado	en'kalkul'ad'o
enkalkulanta	en'kalkul'ant'a
enkalkulante	en'kalkul'ant'e
enkalkulita	en'kalkul'it'a
enkalkulitaj	en'kalkul'it'a'j
enkanaligas	en'kanal'ig'as
enkanaligi	en'kanal'ig'i
enkanaligita	en'kanal'ig'it'a
enkanaligitaj	en'kanal'ig'it'a'j
enkape	en'kap'e
enkapigi	en'kap'ig'i
enkapsuligas	en'kapsul'ig'as
enkapsuligis	en'kapsul'ig'is
enkapsuligo	en'kapsul'ig'o
enkapsuligita	en'kapsul'ig'it'a
enkapsuligitaj	en'kapsul'ig'it'a'j
enkarcerigi	en'karcer'ig'i
enkarcerigis	en'karcer'ig'is
enkarcerigo	en'karcer'ig'o
enkarcerigita	en'karcer'ig'it'a
enkarcerigitaj	en'karcer'ig'it'a'j
enkarcerigitoj	en'karcer'ig'it'o'j
enkarceriĝo	en'karcer'iĝ'o
enkarnigas	en'karn'ig'as
enkarnigi	en'karn'ig'i
enkarnigis	en'karn'ig'is
enkarnigita	en'karn'ig'it'a
enkarnigitaj	en'karn'ig'it'a'j
enkarnigitan	en'karn'ig'it'a'n
enkarniĝis	en'karn'iĝ'is
enkarniĝo	en'karn'iĝ'o
enkarniĝoj	en'karn'iĝ'o'j
enkarniĝon	en'karn'iĝ'o'n
enkarniĝinta	en'karn'iĝ'int'a
enkasigas	en'kas'ig'as
enkasigi	en'kas'ig'i
enkasigis	en'kas'ig'is
enklasigis	en'klas'ig'is
enklasigita	en'klas'ig'it'a
enklasigitaj	en'klas'ig'it'a'j
enkomputiligis	en'komput'il'ig'is
enkonduka	en'konduk'a
enkondukaj	en'konduk'a'j
enkondukajn	en'konduk'a'j'n
enkondukan	en'konduk'a'n
enkondukas	en'konduk'as
enkonduke	en'konduk'e
enkonduki	en'konduk'i
enkondukis	en'konduk'is
enkonduko	en'konduk'o
enkondukoj	en'konduk'o'j
enkondukojn	en'konduk'o'j'n
enkondukon	en'konduk'o'n
enkondukos	en'konduk'os
enkonduku	en'konduk'u
enkondukus	en'konduk'us
enkondukado	en'konduk'ad'o
enkondukanta	en'konduk'ant'a
enkondukante	en'konduk'ant'e
enkondukata	en'konduk'at'a
enkondukiĝas	en'konduk'iĝ'as
enkondukiĝis	en'konduk'iĝ'is
enkondukilo	en'konduk'il'o
enkondukinta	en'konduk'int'a
enkondukita	en'konduk'it'a
enkondukitaj	en'konduk'it'a'j
enkondukitajn	en'konduk'it'a'j'n
enkonstruas	en'konstru'as
enkonstrui	en'konstru'i
enkonstruis	en'konstru'is
enkonstruado	en'konstru'ad'o
enkonstruante	en'konstru'ant'e
enkonstruita	en'konstru'it'a
enkonstruitaj	en'konstru'it'a'j
enkonstruitajn	en'konstru'it'a'j'n
enkonstruitan	en'konstru'it'a'n
enkora	en'kor'a
enkore	en'kor'e
enkorpa	en'korp'a
enkorpigas	en'korp'ig'as
enkorpigi	en'korp'ig'i
enkorpigis	en'korp'ig'is
enkorpigo	en'korp'ig'o
enkorpigita	en'korp'ig'it'a
enkorpigitaj	en'korp'ig'it'a'j
enkorpiĝas	en'korp'iĝ'as
enkorpiĝis	en'korp'iĝ'is
enkorpiĝo	en'korp'iĝ'o
enkulturigo	en'kultur'ig'o
enkuris	en'kur'is
enkursigilo	en'kurs'ig'il'o
enkursigiloj	en'kurs'ig'il'o'j
enlanda	en'land'a
enlandaj	en'land'a'j
enlandajn	en'land'a'j'n
enlandan	en'land'a'n
enlande	en'land'e
enlanden	en'land'e'n
enlando	en'land'o
enlandanoj	en'land'an'o'j
enlasas	en'las'as
enlasi	en'las'i
enlasis	en'las'is
enlasos	en'las'os
enlasu	en'las'u
enlinia	en'lini'a
enliniaj	en'lini'a'j
enlinio	en'lini'o
enlistigas	en'list'ig'as
enlistigi	en'list'ig'i
enlistigis	en'list'ig'is
enlistigita	en'list'ig'it'a
enlistigitaj	en'list'ig'it'a'j
enlita	en'lit'a
enlite	en'lit'e
enliten	en'lit'e'n
enlitigi	en'lit'ig'i
enlitigis	en'lit'ig'is
enlitiĝas	en'lit'iĝ'as
enlitiĝi	en'lit'iĝ'i
enlitiĝis	en'lit'iĝ'is
enlitiĝo	en'lit'iĝ'o
enlitiĝos	en'lit'iĝ'os
enlitiĝu	en'lit'iĝ'u
enlitii	en'liti'i
enlitiis	en'liti'is
enloĝas	en'loĝ'as
enloĝi	en'loĝ'i
enloĝis	en'loĝ'is
enloĝanta	en'loĝ'ant'a
enloĝantaj	en'loĝ'ant'a'j
enloĝante	en'loĝ'ant'e
enloĝanto	en'loĝ'ant'o
enloĝantoj	en'loĝ'ant'o'j
enloĝantojn	en'loĝ'ant'o'j'n
enloĝantaro	en'loĝ'ant'ar'o
enloĝata	en'loĝ'at'a
enloĝebla	en'loĝ'ebl'a
enloĝiĝi	en'loĝ'iĝ'i
enloĝiĝis	en'loĝ'iĝ'is
enmane	en'man'e
enmanigas	en'man'ig'as
enmanigi	en'man'ig'i
enmanigis	en'man'ig'is
enmara	en'mar'a
enmaraj	en'mar'a'j
enmarajn	en'mar'a'j'n
enmaran	en'mar'a'n
enmare	en'mar'e
enmarŝo	en'marŝ'o
enmatĉa	en'matĉ'a
enmatĉaj	en'matĉ'a'j
enmatĉan	en'matĉ'a'n
enmemorigi	en'memor'ig'i
enmemorigis	en'memor'ig'is
enmense	en'mens'e
enmensigas	en'mens'ig'as
enmensigi	en'mens'ig'i
enmensigis	en'mens'ig'is
enmetas	en'met'as
enmeti	en'met'i
enmetis	en'met'is
enmeto	en'met'o
enmetoj	en'met'o'j
enmeton	en'met'o'n
enmetos	en'met'os
enmetu	en'met'u
enmetadis	en'met'ad'is
enmetado	en'met'ad'o
enmetante	en'met'ant'e
enmetataj	en'met'at'a'j
enmetita	en'met'it'a
enmetitaj	en'met'it'a'j
enmetitajn	en'met'it'a'j'n
enmetitan	en'met'it'a'n
enmigri	en'migr'i
enmigris	en'migr'is
enmigrado	en'migr'ad'o
enmigradon	en'migr'ad'o'n
enmigrantoj	en'migr'ant'o'j
enmigrantojn	en'migr'ant'o'j'n
enmigrintaj	en'migr'int'a'j
enmigrinto	en'migr'int'o
enmigrintoj	en'migr'int'o'j
enmigrintojn	en'migr'int'o'j'n
enmiksas	en'miks'as
enmiksi	en'miks'i
enmiksis	en'miks'is
enmiksu	en'miks'u
enmiksiĝas	en'miks'iĝ'as
enmiksiĝi	en'miks'iĝ'i
enmiksiĝis	en'miks'iĝ'is
enmiksiĝo	en'miks'iĝ'o
enmiksiĝon	en'miks'iĝ'o'n
enmiksiĝu	en'miks'iĝ'u
ennaskita	en'nask'it'a
ennodiĝo	en'nod'iĝ'o
enoficigas	en'ofic'ig'as
enoficigi	en'ofic'ig'i
enoficigis	en'ofic'ig'is
enoficigo	en'ofic'ig'o
enoficigita	en'ofic'ig'it'a
enoficigitaj	en'ofic'ig'it'a'j
enoficiĝa	en'ofic'iĝ'a
enoficiĝis	en'ofic'iĝ'is
enoficiĝo	en'ofic'iĝ'o
enorbita	en'orbit'a
enorbitaj	en'orbit'a'j
enorbitajn	en'orbit'a'j'n
enorbitan	en'orbit'a'n
enordas	en'ord'as
enorde	en'ord'e
enordigas	en'ord'ig'as
enordigi	en'ord'ig'i
enordigis	en'ord'ig'is
enordigo	en'ord'ig'o
enordigu	en'ord'ig'u
enordiĝos	en'ord'iĝ'os
enpafis	en'paf'is
enpagoj	en'pag'o'j
enpagojn	en'pag'o'j'n
enpaĝigo	en'paĝ'ig'o
enpaĝigoj	en'paĝ'ig'o'j
enpaĝigon	en'paĝ'ig'o'n
enpakas	en'pak'as
enpaki	en'pak'i
enpakis	en'pak'is
enpaku	en'pak'u
enpakado	en'pak'ad'o
enpakadon	en'pak'ad'o'n
enpakante	en'pak'ant'e
enpakita	en'pak'it'a
enpakitaj	en'pak'it'a'j
enpaŝas	en'paŝ'as
enpaŝi	en'paŝ'i
enpaŝis	en'paŝ'is
enpaŝo	en'paŝ'o
enpenetra	en'penetr'a
enpenetraj	en'penetr'a'j
enpenetran	en'penetr'a'n
enpenetras	en'penetr'as
enpenetri	en'penetr'i
enpenetris	en'penetr'is
enpense	en'pens'e
enpensiĝi	en'pens'iĝ'i
enpensiĝis	en'pens'iĝ'is
enpensiĝinta	en'pens'iĝ'int'a
enpensiĝinte	en'pens'iĝ'int'e
enpensiis	en'pensi'is
enpikis	en'pik'is
enpikiĝis	en'pik'iĝ'is
enplanti	en'plant'i
enplantis	en'plant'is
enplantado	en'plant'ad'o
enplantaĵo	en'plant'aĵ'o
enplantaĵoj	en'plant'aĵ'o'j
enplantaĵon	en'plant'aĵ'o'n
enplantiĝas	en'plant'iĝ'as
enplantiĝi	en'plant'iĝ'i
enplantiĝis	en'plant'iĝ'is
enplantita	en'plant'it'a
enplantitaj	en'plant'it'a'j
enplekti	en'plekt'i
enplektis	en'plekt'is
enplektiĝas	en'plekt'iĝ'as
enplektiĝis	en'plekt'iĝ'is
enplektita	en'plekt'it'a
enplektitaj	en'plekt'it'a'j
enportas	en'port'as
enporti	en'port'i
enportis	en'port'is
enpoŝe	en'poŝ'e
enpoŝigas	en'poŝ'ig'as
enpoŝigi	en'poŝ'ig'i
enpoŝigis	en'poŝ'ig'is
enpoŝtigi	en'poŝt'ig'i
enpostenigo	en'posten'ig'o
enpostenigita	en'posten'ig'it'a
enposteniĝis	en'posten'iĝ'is
enposteniĝo	en'posten'iĝ'o
enpremis	en'prem'is
enprenas	en'pren'as
enpreni	en'pren'i
enprenis	en'pren'is
enprizonigis	en'prizon'ig'is
enprizonigo	en'prizon'ig'o
enprizonigita	en'prizon'ig'it'a
enprizonigitaj	en'prizon'ig'it'a'j
enproblemigita	en'problem'ig'it'a
enprofundigis	en'profund'ig'is
enprofundiĝas	en'profund'iĝ'as
enprofundiĝi	en'profund'iĝ'i
enprofundiĝis	en'profund'iĝ'is
enprofundiĝo	en'profund'iĝ'o
enpuŝi	en'puŝ'i
enpuŝis	en'puŝ'is
enradikigi	en'radik'ig'i
enradikigita	en'radik'ig'it'a
enradikiĝas	en'radik'iĝ'as
enradikiĝi	en'radik'iĝ'i
enradikiĝis	en'radik'iĝ'is
enradikiĝo	en'radik'iĝ'o
enradikiĝinta	en'radik'iĝ'int'a
enradikiĝintaj	en'radik'iĝ'int'a'j
enrampi	en'ramp'i
enrampis	en'ramp'is
enrangigo	en'rang'ig'o
enreta	en'ret'a
enretaj	en'ret'a'j
enretan	en'ret'a'n
enrete	en'ret'e
enretigas	en'ret'ig'as
enretigi	en'ret'ig'i
enretigis	en'ret'ig'is
enretigo	en'ret'ig'o
enrigardas	en'rigard'as
enrigardi	en'rigard'i
enrigardis	en'rigard'is
enrigardojn	en'rigard'o'j'n
enrigardon	en'rigard'o'n
enriskiĝis	en'risk'iĝ'is
enrompis	en'romp'is
enrompo	en'romp'o
enrubigita	en'rub'ig'it'a
enrubigitaj	en'rub'ig'it'a'j
ensalti	en'salt'i
ensaltis	en'salt'is
enŝaltas	en'ŝalt'as
enŝalti	en'ŝalt'i
enŝaltis	en'ŝalt'is
enŝaltu	en'ŝalt'u
enŝaltado	en'ŝalt'ad'o
enŝaltita	en'ŝalt'it'a
enŝaltitaj	en'ŝalt'it'a'j
enŝaltite	en'ŝalt'it'e
ensalutas	en'salut'as
ensaluti	en'salut'i
ensalutis	en'salut'is
ensaluto	en'salut'o
enscenigas	en'scen'ig'as
enscenigi	en'scen'ig'i
enscenigis	en'scen'ig'is
enscenigo	en'scen'ig'o
enscenigado	en'scen'ig'ad'o
enscenigita	en'scen'ig'it'a
enscenigitaj	en'scen'ig'it'a'j
ensemado	en'sem'ad'o
enŝipe	en'ŝip'e
enŝipiĝas	en'ŝip'iĝ'as
enŝipiĝi	en'ŝip'iĝ'i
enŝipiĝis	en'ŝip'iĝ'is
enskribas	en'skrib'as
enskribi	en'skrib'i
enskribis	en'skrib'is
enskribo	en'skrib'o
enskriboj	en'skrib'o'j
enskribojn	en'skrib'o'j'n
enskribu	en'skrib'u
enskribaĵo	en'skrib'aĵ'o
enskribaĵoj	en'skrib'aĵ'o'j
enskribiĝas	en'skrib'iĝ'as
enskribiĝi	en'skrib'iĝ'i
enskribiĝis	en'skrib'iĝ'is
enskribiĝo	en'skrib'iĝ'o
enskribiĝos	en'skrib'iĝ'os
enskribita	en'skrib'it'a
enskribitaj	en'skrib'it'a'j
enŝlosas	en'ŝlos'as
enŝlosi	en'ŝlos'i
enŝlosis	en'ŝlos'is
enŝlosita	en'ŝlos'it'a
enŝlositaj	en'ŝlos'it'a'j
ensorbas	en'sorb'as
ensorbi	en'sorb'i
ensorbis	en'sorb'is
ensorbigi	en'sorb'ig'i
ensorbigis	en'sorb'ig'is
ensorĉita	en'sorĉ'it'a
ensorĉitaj	en'sorĉ'it'a'j
enŝovas	en'ŝov'as
enŝovi	en'ŝov'i
enŝovis	en'ŝov'is
enŝovu	en'ŝov'u
enŝovante	en'ŝov'ant'e
enŝoviĝas	en'ŝov'iĝ'as
enŝoviĝis	en'ŝov'iĝ'is
enŝovita	en'ŝov'it'a
enŝovitaj	en'ŝov'it'a'j
enspaca	en'spac'a
enspeza	en'spez'a
enspezaj	en'spez'a'j
enspezan	en'spez'a'n
enspezas	en'spez'as
enspezi	en'spez'i
enspezis	en'spez'is
enspezo	en'spez'o
enspezoj	en'spez'o'j
enspezojn	en'spez'o'j'n
enspezon	en'spez'o'n
enspezos	en'spez'os
enspezaro	en'spez'ar'o
enspezdistribuo	en'spez'distribu'o
enspeziga	en'spez'ig'a
enspezigaj	en'spez'ig'a'j
enspezigajn	en'spez'ig'a'j'n
enspezigan	en'spez'ig'a'n
enspezigas	en'spez'ig'as
enspezige	en'spez'ig'e
enspezigis	en'spez'ig'is
enspezimposto	en'spez'impost'o
enspezimpostoj	en'spez'impost'o'j
enspezimposton	en'spez'impost'o'n
enspezofonto	en'spez'o'font'o
enspezofontoj	en'spez'o'font'o'j
enspezofonton	en'spez'o'font'o'n
enspiras	en'spir'as
enspiri	en'spir'i
enspiris	en'spir'is
enspiro	en'spir'o
enspiron	en'spir'o'n
enspiru	en'spir'u
enspirado	en'spir'ad'o
enspirante	en'spir'ant'e
enspirita	en'spir'it'a
enspiritaj	en'spir'it'a'j
enŝteliĝas	en'ŝtel'iĝ'as
enŝteliĝis	en'ŝtel'iĝ'is
enŝtopanto	en'ŝtop'ant'o
ensuĉas	en'suĉ'as
ensuĉis	en'suĉ'is
enŝuldiĝinta	en'ŝuld'iĝ'int'a
ensume	en'sum'e
entajpas	en'tajp'as
entajpi	en'tajp'i
entajpado	en'tajp'ad'o
entenas	en'ten'as
enteni	en'ten'i
entenis	en'ten'is
enteno	en'ten'o
entenu	en'ten'u
entenanta	en'ten'ant'a
entenantaj	en'ten'ant'a'j
entenantan	en'ten'ant'a'n
entenata	en'ten'at'a
entenataj	en'ten'at'a'j
entenatajn	en'ten'at'a'j'n
enteriga	en'ter'ig'a
enterigas	en'ter'ig'as
enterigi	en'ter'ig'i
enterigis	en'ter'ig'is
enterigo	en'ter'ig'o
enterigoj	en'ter'ig'o'j
enterigon	en'ter'ig'o'n
enterigos	en'ter'ig'os
enterigu	en'ter'ig'u
enterigita	en'ter'ig'it'a
enterigitaj	en'ter'ig'it'a'j
enteriĝis	en'ter'iĝ'is
entiras	en'tir'as
entiri	en'tir'i
entiris	en'tir'is
entombiga	en'tomb'ig'a
entombigaj	en'tomb'ig'a'j
entombigas	en'tomb'ig'as
entombigi	en'tomb'ig'i
entombigis	en'tomb'ig'is
entombigo	en'tomb'ig'o
entombigoj	en'tomb'ig'o'j
entombigojn	en'tomb'ig'o'j'n
entombigon	en'tomb'ig'o'n
entombigu	en'tomb'ig'u
entombigado	en'tomb'ig'ad'o
entombigita	en'tomb'ig'it'a
entombigitaj	en'tomb'ig'it'a'j
entombigitis	en'tomb'ig'it'is
entombiĝis	en'tomb'iĝ'is
entrajniĝis	en'trajn'iĝ'is
entrudis	en'trud'is
entrudiĝaj	en'trud'iĝ'a'j
entrudiĝas	en'trud'iĝ'as
entrudiĝi	en'trud'iĝ'i
entrudiĝis	en'trud'iĝ'is
entrudiĝo	en'trud'iĝ'o
entrudiĝoj	en'trud'iĝ'o'j
entrudiĝon	en'trud'iĝ'o'n
entrudiĝinto	en'trud'iĝ'int'o
entrudiĝintoj	en'trud'iĝ'int'o'j
entrudulo	en'trud'ul'o
entruduloj	en'trud'ul'o'j
entuta	en'tut'a
entutaj	en'tut'a'j
entutan	en'tut'a'n
entute	en'tut'e
enuniversitata	en'universitat'a
enuniversitataj	en'universitat'a'j
enurba	en'urb'a
enurbaj	en'urb'a'j
enurbe	en'urb'e
envagoniĝi	en'vagon'iĝ'i
envazaj	en'vaz'a'j
envena	en'ven'a
envenas	en'ven'as
enveni	en'ven'i
envenis	en'ven'is
enveno	en'ven'o
envenos	en'ven'os
envenu	en'ven'u
envenanta	en'ven'ant'a
envenantaj	en'ven'ant'a'j
envenantan	en'ven'ant'a'n
envere	en'ver'e
enverŝas	en'verŝ'as
enverŝi	en'verŝ'i
enverŝis	en'verŝ'is
enverŝu	en'verŝ'u
enveturas	en'vetur'as
enveturis	en'vetur'is
envice	en'vic'e
envicigi	en'vic'ig'i
envicigis	en'vic'ig'is
envicigita	en'vic'ig'it'a
enviciĝas	en'vic'iĝ'as
enviciĝi	en'vic'iĝ'i
enviciĝis	en'vic'iĝ'is
enviciĝu	en'vic'iĝ'u
envojaĝas	en'vojaĝ'as
envojaĝi	en'vojaĝ'i
envojaĝis	en'vojaĝ'is
envojaĝado	en'vojaĝ'ad'o
envolvas	en'volv'as
envolvi	en'volv'i
envolvis	en'volv'is
envolvaĵo	en'volv'aĵ'o
envolvante	en'volv'ant'e
envolviĝis	en'volv'iĝ'is
envolvita	en'volv'it'a
envolvitaj	en'volv'it'a'j
envolvitan	en'volv'it'a'n
encefalito	encefal'it'o
encefalopatio	encefal'o'pati'o
encelado	encelad'o
encikliko	enciklik'o
enciklikoj	enciklik'o'j
enciklikon	enciklik'o'n
enciklopedia	enciklopedi'a
enciklopediaj	enciklopedi'a'j
enciklopedio	enciklopedi'o
enciklopedioj	enciklopedi'o'j
enciklopediojn	enciklopedi'o'j'n
enciklopedion	enciklopedi'o'n
enciklopedieca	enciklopedi'ec'a
enciklopedieto	enciklopedi'et'o
enda	end'a
endas	end'as
ende	end'e
endis	end'is
endo	end'o
endus	end'us
endemia	endemi'a
endemiaj	endemi'a'j
endemiajn	endemi'a'j'n
endemio	endemi'o
endemioj	endemi'o'j
endimiono	endimion'o
endodermiso	endoderm'is'o
endogamio	endogami'o
endogamion	endogami'o'n
endogena	endogen'a
endogenaj	endogen'a'j
endokrina	endokrin'a
endokrinaj	endokrin'a'j
endoktrinigo	endoktrin'ig'o
endometria	endometri'a
endometrio	endometri'o
endoplasma	endoplasm'a
endotelio	endoteli'o
endoterma	endoterm'a
endotermaj	endoterm'a'j
energetiko	energetik'o
energia	energi'a
energiaj	energi'a'j
energiajn	energi'a'j'n
energian	energi'a'n
energie	energi'e
energio	energi'o
energioj	energi'o'j
energiojn	energi'o'j'n
energion	energi'o'n
energibezono	energi'bezon'o
energibezonoj	energi'bezon'o'j
energicentraloj	energi'central'o'j
energiefika	energi'efik'a
energiefikaj	energi'efik'a'j
energiefikeco	energi'efik'ec'o
energiefikecon	energi'efik'ec'o'n
energienhavo	energi'en'hav'o
energienhavon	energi'en'hav'o'n
energifonto	energi'font'o
energifontoj	energi'font'o'j
energifontojn	energi'font'o'j'n
energifonton	energi'font'o'n
energiintenso	energi'intens'o
energiintenson	energi'intens'o'n
energikonsumo	energi'konsum'o
energikonsumon	energi'konsum'o'n
energikonverto	energi'konvert'o
energikostoj	energi'kost'o'j
energinivelo	energi'nivel'o
energiniveloj	energi'nivel'o'j
energinivelojn	energi'nivel'o'j'n
energiogeneracio	energi'o'generaci'o
energiouzo	energi'o'uz'o
energiouzon	energi'o'uz'o'n
energiplena	energi'plen'a
energipolitiko	energi'politik'o
energiproduktado	energi'produkt'ad'o
energisektoro	energi'sektor'o
energisistemoj	energi'sistem'o'j
energiŝpara	energi'ŝpar'a
energiŝparaj	energi'ŝpar'a'j
energiŝparo	energi'ŝpar'o
energiŝparado	energi'ŝpar'ad'o
energistato	energi'stat'o
energistatoj	energi'stat'o'j
energitransigo	energi'trans'ig'o
energiuzokutimo	energi'uz'o'kutim'o
engaĝas	engaĝ'as
engaĝi	engaĝ'i
engaĝis	engaĝ'is
engaĝo	engaĝ'o
engaĝado	engaĝ'ad'o
engaĝante	engaĝ'ant'e
engaĝiĝas	engaĝ'iĝ'as
engaĝiĝi	engaĝ'iĝ'i
engaĝiĝis	engaĝ'iĝ'is
engaĝiĝo	engaĝ'iĝ'o
engaĝiĝoj	engaĝ'iĝ'o'j
engaĝiĝojn	engaĝ'iĝ'o'j'n
engaĝiĝon	engaĝ'iĝ'o'n
engaĝiĝinta	engaĝ'iĝ'int'a
engaĝita	engaĝ'it'a
engaĝitaj	engaĝ'it'a'j
engaĝitajn	engaĝ'it'a'j'n
engaĝitan	engaĝ'it'a'n
engaĝiteco	engaĝ'it'ec'o
enigma	enigm'a
enigmaj	enigm'a'j
enigman	enigm'a'n
enigme	enigm'e
enigmo	enigm'o
enigmoj	enigm'o'j
enigmojn	enigm'o'j'n
enigmon	enigm'o'n
enketa	enket'a
enketan	enket'a'n
enketas	enket'as
enketi	enket'i
enketis	enket'is
enketo	enket'o
enketoj	enket'o'j
enketojn	enket'o'j'n
enketon	enket'o'n
enketu	enket'u
enketado	enket'ad'o
enketadon	enket'ad'o'n
enketema	enket'em'a
enketilo	enket'il'o
enketiloj	enket'il'o'j
enketilon	enket'il'o'n
enketisto	enket'ist'o
enketistoj	enket'ist'o'j
enketistojn	enket'ist'o'j'n
enketitaj	enket'it'a'j
enketitoj	enket'it'o'j
enklavo	enklav'o
enklavoj	enklav'o'j
enklavojn	enklav'o'j'n
enklavon	enklav'o'n
enorma	enorm'a
enormaj	enorm'a'j
enormajn	enorm'a'j'n
enorman	enorm'a'n
enorme	enorm'e
ensemble	ensembl'e
ensemblo	ensembl'o
ensembloj	ensembl'o'j
ensemblojn	ensembl'o'j'n
ensemblon	ensembl'o'n
ento	ent'o
entoj	ent'o'j
entojn	ent'o'j'n
enton	ent'o'n
entaĵo	ent'aĵ'o
entaĵoj	ent'aĵ'o'j
entablemento	entablement'o
entalpio	entalpi'o
entento	entent'o
entjera	entjer'a
entjeraj	entjer'a'j
entjero	entjer'o
entjeroj	entjer'o'j
entjeron	entjer'o'n
entomologio	entomolog'i'o
entreprena	entrepren'a
entreprenaj	entrepren'a'j
entreprenajn	entrepren'a'j'n
entreprenan	entrepren'a'n
entreprenas	entrepren'as
entrepreni	entrepren'i
entreprenis	entrepren'is
entrepreno	entrepren'o
entreprenoj	entrepren'o'j
entreprenojn	entrepren'o'j'n
entreprenon	entrepren'o'n
entreprenos	entrepren'os
entreprenu	entrepren'u
entreprenus	entrepren'us
entreprenado	entrepren'ad'o
entreprenadon	entrepren'ad'o'n
entreprenante	entrepren'ant'e
entreprenaro	entrepren'ar'o
entreprenema	entrepren'em'a
entreprenemaj	entrepren'em'a'j
entreprenemo	entrepren'em'o
entreprenemon	entrepren'em'o'n
entreprenista	entrepren'ist'a
entreprenisto	entrepren'ist'o
entreprenistoj	entrepren'ist'o'j
entreprenistojn	entrepren'ist'o'j'n
entrepreniston	entrepren'ist'o'n
entreprenita	entrepren'it'a
entreprenitaj	entrepren'it'a'j
entreprenitajn	entrepren'it'a'j'n
entropio	entropi'o
entropion	entropi'o'n
entuziasma	entuziasm'a
entuziasmaj	entuziasm'a'j
entuziasmajn	entuziasm'a'j'n
entuziasman	entuziasm'a'n
entuziasmas	entuziasm'as
entuziasme	entuziasm'e
entuziasmis	entuziasm'is
entuziasmo	entuziasm'o
entuziasmon	entuziasm'o'n
entuziasmiga	entuziasm'ig'a
entuziasmigas	entuziasm'ig'as
entuziasmigi	entuziasm'ig'i
entuziasmigis	entuziasm'ig'is
entuziasmigita	entuziasm'ig'it'a
entuziasmiĝas	entuziasm'iĝ'as
entuziasmiĝis	entuziasm'iĝ'is
entuziasmulo	entuziasm'ul'o
entuziasmuloj	entuziasm'ul'o'j
entuziasmulojn	entuziasm'ul'o'j'n
enua	enu'a
enuaj	enu'a'j
enuan	enu'a'n
enuas	enu'as
enue	enu'e
enui	enu'i
enuis	enu'is
enuo	enu'o
enuon	enu'o'n
enuos	enu'os
enuanta	enu'ant'a
enuiga	enu'ig'a
enuigaj	enu'ig'a'j
enuigajn	enu'ig'a'j'n
enuigan	enu'ig'a'n
enuigas	enu'ig'as
enuige	enu'ig'e
enuigis	enu'ig'is
enuigita	enu'ig'it'a
enuiĝas	enu'iĝ'as
enuiĝis	enu'iĝ'is
envia	envi'a
enviaj	envi'a'j
envias	envi'as
envie	envi'e
envii	envi'i
enviis	envi'is
envio	envi'o
envion	envi'o'n
enviu	envi'u
enviante	envi'ant'e
enviema	envi'em'a
enviinda	envi'ind'a
enviindan	envi'ind'a'n
enzima	enzim'a
enzimo	enzim'o
enzimoj	enzim'o'j
enzimojn	enzim'o'j'n
enzimon	enzim'o'n
enzimeca	enzim'ec'a
eoceno	eocen'o
eola	eol'a
eolo	eol'o
eono	eon'o
eonoj	eon'o'j
eosta	eost'a
epidemia	epidemi'a
epidemiaj	epidemi'a'j
epidemio	epidemi'o
epidemioj	epidemi'o'j
epidemiojn	epidemi'o'j'n
epidemion	epidemi'o'n
epidemiologia	epidemi'olog'i'a
epidemiologiaj	epidemi'olog'i'a'j
epidemiologio	epidemi'olog'i'o
epiderma	epiderm'a
epidermaj	epiderm'a'j
epidermo	epiderm'o
epifanio	epifani'o
epigeneza	epigenez'a
epigenezaj	epigenez'a'j
epigono	epigon'o
epigonoj	epigon'o'j
epigrafo	epigraf'o
epigrafoj	epigraf'o'j
epigramo	epigram'o
epigramoj	epigram'o'j
epigramojn	epigram'o'j'n
epika	epik'a
epikaj	epik'a'j
epikuro	epikur'o
epilepsia	epilepsi'a
epilepsio	epilepsi'o
epilepsion	epilepsi'o'n
epilepsiatakoj	epilepsi'atak'o'j
epilepsiatakojn	epilepsi'atak'o'j'n
epilogo	epilog'o
epiro	epir'o
episkopa	episkop'a
episkopaj	episkop'a'j
episkopajn	episkop'a'j'n
episkopan	episkop'a'n
episkopo	episkop'o
episkopoj	episkop'o'j
episkopojn	episkop'o'j'n
episkopon	episkop'o'n
episkopara	episkop'ar'a
episkoparo	episkop'ar'o
episkoparoj	episkop'ar'o'j
episkopejo	episkop'ej'o
episkopejoj	episkop'ej'o'j
episkopejon	episkop'ej'o'n
episkoplando	episkop'land'o
episkopujo	episkop'uj'o
episkopujoj	episkop'uj'o'j
epistemologia	epistemologi'a
epistemologiaj	epistemologi'a'j
epistemologio	epistemologi'o
epistolo	epistol'o
epistoloj	epistol'o'j
epistolojn	epistol'o'j'n
epitafo	epitaf'o
epitafoj	epitaf'o'j
epitelio	epiteli'o
epitelion	epiteli'o'n
epiteliĉeloj	epiteli'ĉel'o'j
epitetas	epitet'as
epiteti	epitet'i
epiteto	epitet'o
epitetoj	epitet'o'j
epiteton	epitet'o'n
epitomo	epitom'o
epitomoj	epitom'o'j
epizoda	epizod'a
epizodaj	epizod'a'j
epizodan	epizod'a'n
epizodo	epizod'o
epizodoj	epizod'o'j
epizodojn	epizod'o'j'n
epizodon	epizod'o'n
epoka	epok'a
epokaj	epok'a'j
epokan	epok'a'n
epoke	epok'e
epoko	epok'o
epokoj	epok'o'j
epokojn	epok'o'j'n
epokon	epok'o'n
epokfara	epok'far'a
epoksio	epoksi'o
epoletoj	epolet'o'j
epopea	epope'a
epopeo	epope'o
epopeoj	epope'o'j
epopeojn	epope'o'j'n
epopeon	epope'o'n
eposa	epos'a
eposaj	epos'a'j
eposo	epos'o
eposoj	epos'o'j
era	er'a
eran	er'a'n
ero	er'o
eroj	er'o'j
erojn	er'o'j'n
eron	er'o'n
erao	era'o
eraoj	era'o'j
eraon	era'o'n
erara	erar'a
eraraj	erar'a'j
erarajn	erar'a'j'n
eraran	erar'a'n
eraras	erar'as
erare	erar'e
erari	erar'i
eraris	erar'is
eraro	erar'o
eraroj	erar'o'j
erarojn	erar'o'j'n
eraron	erar'o'n
eraros	erar'os
eraru	erar'u
erarus	erar'us
erarego	erar'eg'o
erarema	erar'em'a
erareto	erar'et'o
eraretoj	erar'et'o'j
eraretojn	erar'et'o'j'n
erareton	erar'et'o'n
erariga	erar'ig'a
erarigaj	erar'ig'a'j
erarigas	erar'ig'as
erarigi	erar'ig'i
erarigis	erar'ig'is
erarinta	erar'int'a
erarofteco	erar'oft'ec'o
erarrezista	erar'rezist'a
erarvagis	erar'vag'is
erasmo	erasm'o
eratosteno	eratosten'o
erco	erc'o
ercoj	erc'o'j
ercojn	erc'o'j'n
ercon	erc'o'n
ergo	erg'o
ergonomio	ergonomi'o
erika	erik'a
eriko	erik'o
erikejo	erik'ej'o
erikejoj	erik'ej'o'j
erikejon	erik'ej'o'n
erinaco	erinac'o
erinacoj	erinac'o'j
erinacon	erinac'o'n
eritrea	eritre'a
eritreo	eritre'o
eritrocitoj	eritrocit'o'j
ermeno	ermen'o
ermenoj	ermen'o'j
ermita	ermit'a
ermite	ermit'e
ermito	ermit'o
ermitoj	ermit'o'j
ermiton	ermit'o'n
ermitejo	ermit'ej'o
ermitejoj	ermit'ej'o'j
ernesto	ernest'o
ernestino	ernest'in'o
eroto	erot'o
erotika	erotik'a
erotikaj	erotik'a'j
erotikajn	erotik'a'j'n
erotikan	erotik'a'n
erotiko	erotik'o
erotikon	erotik'o'n
eroziaj	erozi'a'j
erozias	erozi'as
erozii	erozi'i
eroziis	erozi'is
erozio	erozi'o
erozion	erozi'o'n
eroziita	erozi'it'a
eroziitaj	erozi'it'a'j
erudita	erud'it'a
erudicia	erudici'a
erudiciaj	erudici'a'j
erudiciajn	erudici'a'j'n
erudician	erudici'a'n
erudicio	erudici'o
erudicion	erudici'o'n
erudiciulo	erudici'ul'o
erudiciuloj	erudici'ul'o'j
erupcia	erupci'a
erupcias	erupci'as
erupciis	erupci'is
erupcio	erupci'o
erupcioj	erupci'o'j
erupciojn	erupci'o'j'n
erupcion	erupci'o'n
eŝafodo	eŝafod'o
eŝafodoj	eŝafod'o'j
escepta	escept'a
esceptaj	escept'a'j
esceptajn	escept'a'j'n
esceptan	escept'a'n
esceptas	escept'as
escepte	escept'e
escepti	escept'i
escepto	escept'o
esceptoj	escept'o'j
esceptojn	escept'o'j'n
escepton	escept'o'n
esceptante	escept'ant'e
esceptigi	escept'ig'i
esceptigita	escept'ig'it'a
esceptita	escept'it'a
esceptitaj	escept'it'a'j
esceptokaze	escept'okaz'e
eseo	ese'o
eseoj	ese'o'j
eseojn	ese'o'j'n
eseon	ese'o'n
esearo	ese'ar'o
eseisto	ese'ist'o
esenoj	esen'o'j
esenca	esenc'a
esencaj	esenc'a'j
esencajn	esenc'a'j'n
esencan	esenc'a'n
esencas	esenc'as
esence	esenc'e
esenco	esenc'o
esencoj	esenc'o'j
esencojn	esenc'o'j'n
esencon	esenc'o'n
esencismo	esenc'ism'o
esencoleoj	esenc'ole'o'j
eskadro	eskadr'o
eskadroj	eskadr'o'j
eskadrojn	eskadr'o'j'n
eskadron	eskadr'o'n
eskalo	eskal'o
eskalon	eskal'o'n
eskaladi	eskal'ad'i
eskaladis	eskal'ad'is
eskalado	eskal'ad'o
eskaladon	eskal'ad'o'n
eskapa	eskap'a
eskapas	eskap'as
eskapi	eskap'i
eskapis	eskap'is
eskapo	eskap'o
eskapon	eskap'o'n
eskapos	eskap'os
eskapu	eskap'u
eskapus	eskap'us
eskapado	eskap'ad'o
eskapante	eskap'ant'e
eskapinta	eskap'int'a
eskapintaj	eskap'int'a'j
eskarpo	eskarp'o
eskatologia	eskatologi'a
eskatologio	eskatologi'o
eskimaj	eskim'a'j
eskimo	eskim'o
eskimoj	eskim'o'j
eskorti	eskort'i
eskortis	eskort'is
eskorto	eskort'o
eskortita	eskort'it'a
eskviro	eskvir'o
esotera	esoter'a
esoteraj	esoter'a'j
esoteran	esoter'a'n
esoterismo	esoter'ism'o
espera	esper'a
esperan	esper'a'n
esperas	esper'as
espere	esper'e
esperi	esper'i
esperis	esper'is
espero	esper'o
esperoj	esper'o'j
esperojn	esper'o'j'n
esperon	esper'o'n
esperu	esper'u
esperus	esper'us
esperanta	esper'ant'a
esperantaj	esper'ant'a'j
esperantajn	esper'ant'a'j'n
esperantan	esper'ant'a'n
esperante	esper'ant'e
esperantoj	esper'ant'o'j
esperanton	esper'ant'o'n
esperata	esper'at'a
esperdona	esper'don'a
esperebla	esper'ebl'a
espereble	esper'ebl'e
esperemaj	esper'em'a'j
esperiga	esper'ig'a
esperigaj	esper'ig'a'j
esperigajn	esper'ig'a'j'n
esperigan	esper'ig'a'n
esperigas	esper'ig'as
esperigis	esper'ig'is
esperita	esper'it'a
esperite	esper'it'e
esperoplena	esper'o'plen'a
esperplena	esper'plen'a
esperplenaj	esper'plen'a'j
esperanta	esperant'a
esperantaj	esperant'a'j
esperantajn	esperant'a'j'n
esperantan	esperant'a'n
esperante	esperant'e
esperanten	esperant'e'n
esperanto	esperant'o
esperantoj	esperant'o'j
esperanton	esperant'o'n
esperantaĵoj	esperant'aĵ'o'j
esperantaĵojn	esperant'aĵ'o'j'n
esperanteca	esperant'ec'a
esperantio	esperant'i'o
esperantion	esperant'i'o'n
esperantiano	esperant'i'an'o
esperantianoj	esperant'i'an'o'j
esperantidoj	esperant'id'o'j
esperantigas	esperant'ig'as
esperantigi	esperant'ig'i
esperantigis	esperant'ig'is
esperantigo	esperant'ig'o
esperantigoj	esperant'ig'o'j
esperantigon	esperant'ig'o'n
esperantigu	esperant'ig'u
esperantigebla	esperant'ig'ebl'a
esperantigita	esperant'ig'it'a
esperantigitaj	esperant'ig'it'a'j
esperantigitajn	esperant'ig'it'a'j'n
esperantigitan	esperant'ig'it'a'n
esperantigite	esperant'ig'it'e
esperantilo	esperant'il'o
esperantilon	esperant'il'o'n
esperantisma	esperant'ism'a
esperantismo	esperant'ism'o
esperantismon	esperant'ism'o'n
esperantista	esperant'ist'a
esperantistaj	esperant'ist'a'j
esperantistajn	esperant'ist'a'j'n
esperantistan	esperant'ist'a'n
esperantisto	esperant'ist'o
esperantistoj	esperant'ist'o'j
esperantistojn	esperant'ist'o'j'n
esperantiston	esperant'ist'o'n
esperantistaro	esperant'ist'ar'o
esperantistaron	esperant'ist'ar'o'n
esperantisteco	esperant'ist'ec'o
esperantistecon	esperant'ist'ec'o'n
esperantistiĝis	esperant'ist'iĝ'is
esperantistiĝo	esperant'ist'iĝ'o
esperantistino	esperant'ist'in'o
esperantistinoj	esperant'ist'in'o'j
esperantlingva	esperant'lingv'a
esperantlingvaj	esperant'lingv'a'j
esperantlingvajn	esperant'lingv'a'j'n
esperantlingvan	esperant'lingv'a'n
esperantlingve	esperant'lingv'e
esperantlingvanoj	esperant'lingv'an'o'j
esperantoagado	esperant'o'ag'ad'o
esperantoagadon	esperant'o'ag'ad'o'n
esperantoaktivuloj	esperant'o'aktiv'ul'o'j
esperantoanekdotoj	esperant'o'anekdot'o'j
esperantoaranĝo	esperant'o'aranĝ'o
esperantoaranĝoj	esperant'o'aranĝ'o'j
esperantoaranĝon	esperant'o'aranĝ'o'n
esperantoasocio	esperant'o'asoci'o
esperantoasocioj	esperant'o'asoci'o'j
esperantoasocion	esperant'o'asoci'o'n
esperantobiblioteko	esperant'o'bibliotek'o
esperantobibliotekoj	esperant'o'bibliotek'o'j
esperantocentro	esperant'o'centr'o
esperantocentroj	esperant'o'centr'o'j
esperantocentron	esperant'o'centr'o'n
esperantodomo	esperant'o'dom'o
esperantodomon	esperant'o'dom'o'n
esperantoelsendo	esperant'o'el'send'o
esperantoelsendoj	esperant'o'el'send'o'j
esperantoelsendojn	esperant'o'el'send'o'j'n
esperantoeventoj	esperant'o'event'o'j
esperantofako	esperant'o'fak'o
esperantofakgrupo	esperant'o'fak'grup'o
esperantofederacio	esperant'o'federaci'o
esperantofestivalo	esperant'o'festival'o
esperantoflago	esperant'o'flag'o
esperantoforumo	esperant'o'forum'o
esperantogazeto	esperant'o'gazet'o
esperantogazetoj	esperant'o'gazet'o'j
esperantogazetaro	esperant'o'gazet'ar'o
esperantogramatiko	esperant'o'gramatik'o
esperantogrupo	esperant'o'grup'o
esperantogrupoj	esperant'o'grup'o'j
esperantogrupon	esperant'o'grup'o'n
esperantohistorio	esperant'o'histori'o
esperantoinformado	esperant'o'inform'ad'o
esperantoinstituto	esperant'o'institut'o
esperantoinstruado	esperant'o'instru'ad'o
esperantoinstruisto	esperant'o'instru'ist'o
esperantoinstruistoj	esperant'o'instru'ist'o'j
esperantoinsulo	esperant'o'insul'o
esperantointerreto	esperant'o'inter'ret'o
esperantojunularo	esperant'o'jun'ul'ar'o
esperantoklubo	esperant'o'klub'o
esperantokluboj	esperant'o'klub'o'j
esperantoklubon	esperant'o'klub'o'n
esperantokomunumo	esperant'o'komun'um'o
esperantokomunumon	esperant'o'komun'um'o'n
esperantokonferenco	esperant'o'konferenc'o
esperantokongreso	esperant'o'kongres'o
esperantokongresoj	esperant'o'kongres'o'j
esperantokongreson	esperant'o'kongres'o'n
esperantokulturo	esperant'o'kultur'o
esperantokulturon	esperant'o'kultur'o'n
esperantokurso	esperant'o'kurs'o
esperantokursoj	esperant'o'kurs'o'j
esperantokursojn	esperant'o'kurs'o'j'n
esperantokurson	esperant'o'kurs'o'n
esperantolando	esperant'o'land'o
esperantolernado	esperant'o'lern'ad'o
esperantolernantoj	esperant'o'lern'ant'o'j
esperantolernejo	esperant'o'lern'ej'o
esperantolernolibroj	esperant'o'lern'o'libr'o'j
esperantolibro	esperant'o'libr'o
esperantolibroj	esperant'o'libr'o'j
esperantolibrojn	esperant'o'libr'o'j'n
esperantoligo	esperant'o'lig'o
esperantoligon	esperant'o'lig'o'n
esperantoliteraturo	esperant'o'literatur'o
esperantoluna	esperant'o'lun'a
esperantomedio	esperant'o'medi'o
esperantomondo	esperant'o'mond'o
esperantomovado	esperant'o'mov'ad'o
esperantomovadoj	esperant'o'mov'ad'o'j
esperantomovadon	esperant'o'mov'ad'o'n
esperantomuzeo	esperant'o'muze'o
esperantomuziko	esperant'o'muzik'o
esperantomuzikon	esperant'o'muzik'o'n
esperantoorganizo	esperant'o'organiz'o
esperantoorganizoj	esperant'o'organiz'o'j
esperantoorganizaĵo	esperant'o'organiz'aĵ'o
esperantoorganizaĵoj	esperant'o'organiz'aĵ'o'j
esperantoparolanto	esperant'o'parol'ant'o
esperantoparolantoj	esperant'o'parol'ant'o'j
esperantoparolantojn	esperant'o'parol'ant'o'j'n
esperantoperiodaĵoj	esperant'o'period'aĵ'o'j
esperantopoezio	esperant'o'poezi'o
esperantoprogramo	esperant'o'program'o
esperantoprogramoj	esperant'o'program'o'j
esperantoprojektoj	esperant'o'projekt'o'j
esperantoredakcio	esperant'o'redakci'o
esperantorenkontiĝo	esperant'o'renkont'iĝ'o
esperantorenkontiĝoj	esperant'o'renkont'iĝ'o'j
esperantorevuo	esperant'o'revu'o
esperantorevuoj	esperant'o'revu'o'j
esperantorondo	esperant'o'rond'o
esperantosekcio	esperant'o'sekci'o
esperantosocieto	esperant'o'societ'o
esperantosocietoj	esperant'o'societ'o'j
esperantosocieton	esperant'o'societ'o'n
esperantostudado	esperant'o'stud'ad'o
esperantotago	esperant'o'tag'o
esperantoteatro	esperant'o'teatr'o
esperantotraduko	esperant'o'traduk'o
esperantounio	esperant'o'uni'o
esperantounuiĝo	esperant'o'unu'iĝ'o
esperantourbo	esperant'o'urb'o
esperantouzantoj	esperant'o'uz'ant'o'j
esperantoversio	esperant'o'versi'o
esperantovivo	esperant'o'viv'o
esperantovivon	esperant'o'viv'o'n
esperantologo	esperant'olog'o
esperantologoj	esperant'olog'o'j
esperantologia	esperant'olog'i'a
esperantologiaj	esperant'olog'i'a'j
esperantologian	esperant'olog'i'a'n
esperantologio	esperant'olog'i'o
esperantuja	esperant'uj'a
esperantujo	esperant'uj'o
esperantujon	esperant'uj'o'n
esperantuloj	esperant'ul'o'j
esperantumi	esperant'um'i
esplanado	esplanad'o
esplora	esplor'a
esploraj	esplor'a'j
esplorajn	esplor'a'j'n
esploran	esplor'a'n
esploras	esplor'as
esplore	esplor'e
esplori	esplor'i
esploris	esplor'is
esploro	esplor'o
esploroj	esplor'o'j
esplorojn	esplor'o'j'n
esploron	esplor'o'n
esploros	esplor'os
esploru	esplor'u
esplorus	esplor'us
esplorada	esplor'ad'a
esploradaj	esplor'ad'a'j
esploradas	esplor'ad'as
esploradi	esplor'ad'i
esplorado	esplor'ad'o
esploradoj	esplor'ad'o'j
esploradojn	esplor'ad'o'j'n
esploradon	esplor'ad'o'n
esploradorganizoj	esplor'ad'organiz'o'j
esploraktiveco	esplor'aktiv'ec'o
esploraktivecoj	esplor'aktiv'ec'o'j
esploranta	esplor'ant'a
esplorantaj	esplor'ant'a'j
esplorantan	esplor'ant'a'n
esplorante	esplor'ant'e
esploranto	esplor'ant'o
esplorantoj	esplor'ant'o'j
esplorartikoloj	esplor'artikol'o'j
esplorata	esplor'at'a
esplorataj	esplor'at'a'j
esplorceloj	esplor'cel'o'j
esplorcentro	esplor'centr'o
esplorcentroj	esplor'centr'o'j
esplordemandi	esplor'demand'i
esplordemandado	esplor'demand'ad'o
esplordemandadon	esplor'demand'ad'o'n
esplorejo	esplor'ej'o
esploreltrovoj	esplor'el'trov'o'j
esplorenda	esplor'end'a
esplorfinancado	esplor'financ'ad'o
esplorgrupo	esplor'grup'o
esplorgrupoj	esplor'grup'o'j
esplorilo	esplor'il'o
esplorinda	esplor'ind'a
esplorinstalaĵo	esplor'instal'aĵ'o
esplorinstalaĵoj	esplor'instal'aĵ'o'j
esplorinstitucioj	esplor'instituci'o'j
esplorinstituto	esplor'institut'o
esplorinstitutoj	esplor'institut'o'j
esplorinte	esplor'int'e
esplorinteresoj	esplor'interes'o'j
esplorinvestoj	esplor'invest'o'j
esploristo	esplor'ist'o
esploristoj	esplor'ist'o'j
esploristojn	esplor'ist'o'j'n
esploriston	esplor'ist'o'n
esploristino	esplor'ist'in'o
esplorita	esplor'it'a
esploritaj	esplor'it'a'j
esplorkampo	esplor'kamp'o
esplorkomisiono	esplor'komision'o
esplorkomunumo	esplor'komun'um'o
esplorlaboro	esplor'labor'o
esplorlaboratorio	esplor'laboratori'o
esplorlaboratorioj	esplor'laboratori'o'j
esplormetodo	esplor'metod'o
esplormetodoj	esplor'metod'o'j
esplororezultojn	esplor'o'rezult'o'j'n
esplorobjekto	esplor'objekt'o
esplorprogramo	esplor'program'o
esplorprogramoj	esplor'program'o'j
esplorprogramojn	esplor'program'o'j'n
esplorprogramon	esplor'program'o'n
esplorprojekto	esplor'projekt'o
esplorprojektoj	esplor'projekt'o'j
esplorprojektojn	esplor'projekt'o'j'n
esplorrezultoj	esplor'rezult'o'j
esplorstudoj	esplor'stud'o'j
esplorsubvencioj	esplor'subvenci'o'j
esplorteamo	esplor'team'o
esplortemo	esplor'tem'o
esplortemoj	esplor'tem'o'j
esploruniversitato	esplor'universitat'o
esploruniversitatoj	esplor'universitat'o'j
esplorveturilo	esplor'vetur'il'o
esplorveturiloj	esplor'vetur'il'o'j
esplorvojaĝo	esplor'vojaĝ'o
esprima	esprim'a
esprimas	esprim'as
esprime	esprim'e
esprimi	esprim'i
esprimis	esprim'is
esprimo	esprim'o
esprimoj	esprim'o'j
esprimojn	esprim'o'j'n
esprimon	esprim'o'n
esprimos	esprim'os
esprimu	esprim'u
esprimus	esprim'us
esprimado	esprim'ad'o
esprimadon	esprim'ad'o'n
esprimanta	esprim'ant'a
esprimantaj	esprim'ant'a'j
esprimantajn	esprim'ant'a'j'n
esprimantan	esprim'ant'a'n
esprimante	esprim'ant'e
esprimata	esprim'at'a
esprimataj	esprim'at'a'j
esprimebla	esprim'ebl'a
esprimeblaj	esprim'ebl'a'j
esprimeblas	esprim'ebl'as
esprimiĝas	esprim'iĝ'as
esprimiĝi	esprim'iĝ'i
esprimiĝis	esprim'iĝ'is
esprimiĝo	esprim'iĝ'o
esprimilo	esprim'il'o
esprimiloj	esprim'il'o'j
esprimilon	esprim'il'o'n
espriminta	esprim'int'a
esprimita	esprim'it'a
esprimitaj	esprim'it'a'j
esprimitajn	esprim'it'a'j'n
esprimitan	esprim'it'a'n
esprimite	esprim'it'e
esprimkapablo	esprim'kapabl'o
esprimkapablon	esprim'kapabl'o'n
esprimlibero	esprim'liber'o
esprimlibereco	esprim'liber'ec'o
esprimmaniero	esprim'manier'o
esprimmanieroj	esprim'manier'o'j
esprimmanierojn	esprim'manier'o'j'n
esprimmanieron	esprim'manier'o'n
esprimomaniero	esprim'o'manier'o
esprimplena	esprim'plen'a
esprimplenaj	esprim'plen'a'j
esprimplenajn	esprim'plen'a'j'n
esprimplenan	esprim'plen'a'n
esprimpova	esprim'pov'a
esprimpovo	esprim'pov'o
esprimpovon	esprim'pov'o'n
esta	est'a
estas	est'as
este	est'e
esti	est'i
estis	est'is
estkiel	est'kiel
esto	est'o
estoj	est'o'j
eston	est'o'n
estos	est'os
estu	est'u
estus	est'us
estadas	est'ad'as
estadi	est'ad'i
estadis	est'ad'is
estado	est'ad'o
estadoj	est'ad'o'j
estadon	est'ad'o'n
estajho	est'aĵ'o
estaĵo	est'aĵ'o
estaĵoj	est'aĵ'o'j
estaĵojn	est'aĵ'o'j'n
estaĵon	est'aĵ'o'n
estanta	est'ant'a
estantaj	est'ant'a'j
estantajn	est'ant'a'j'n
estantan	est'ant'a'n
estante	est'ant'e
estanto	est'ant'o
estanteco	est'ant'ec'o
estantecon	est'ant'ec'o'n
estate	est'at'e
estejo	est'ej'o
estejon	est'ej'o'n
estigas	est'ig'as
estigi	est'ig'i
estigis	est'ig'is
estigo	est'ig'o
estigon	est'ig'o'n
estigos	est'ig'os
estigu	est'ig'u
estigus	est'ig'us
estigante	est'ig'ant'e
estigita	est'ig'it'a
estigitaj	est'ig'it'a'j
estigitan	est'ig'it'a'n
estiĝas	est'iĝ'as
estiĝi	est'iĝ'i
estiĝis	est'iĝ'is
estiĝo	est'iĝ'o
estiĝon	est'iĝ'o'n
estiĝos	est'iĝ'os
estiĝu	est'iĝ'u
estiĝus	est'iĝ'us
estiĝadis	est'iĝ'ad'is
estiĝanta	est'iĝ'ant'a
estiĝantaj	est'iĝ'ant'a'j
estiĝinta	est'iĝ'int'a
estiĝintaj	est'iĝ'int'a'j
estinta	est'int'a
estintaj	est'int'a'j
estintan	est'int'a'n
estinte	est'int'e
estinti	est'int'i
estintis	est'int'is
estinto	est'int'o
estintus	est'int'us
estinteco	est'int'ec'o
estintecon	est'int'ec'o'n
estita	est'it'a
estonta	est'ont'a
estontaj	est'ont'a'j
estontajn	est'ont'a'j'n
estontan	est'ont'a'n
estonte	est'ont'e
estonto	est'ont'o
estonton	est'ont'o'n
estonteca	est'ont'ec'a
estontecaj	est'ont'ec'a'j
estontece	est'ont'ec'e
estontecen	est'ont'ec'e'n
estonteco	est'ont'ec'o
estontecon	est'ont'ec'o'n
estulo	est'ul'o
estuloj	est'ul'o'j
estulojn	est'ul'o'j'n
estulon	est'ul'o'n
establas	establ'as
establi	establ'i
establis	establ'is
establo	establ'o
establoj	establ'o'j
establojn	establ'o'j'n
establon	establ'o'n
establos	establ'os
establu	establ'u
establus	establ'us
establado	establ'ad'o
establadoj	establ'ad'o'j
establadon	establ'ad'o'n
establaĵo	establ'aĵ'o
establaĵoj	establ'aĵ'o'j
establaĵojn	establ'aĵ'o'j'n
establanta	establ'ant'a
establante	establ'ant'e
establigo	establ'ig'o
establiĝas	establ'iĝ'as
establiĝis	establ'iĝ'is
establiĝo	establ'iĝ'o
establinta	establ'int'a
establita	establ'it'a
establitaj	establ'it'a'j
establitajn	establ'it'a'j'n
establitan	establ'it'a'n
establite	establ'it'e
estera	ester'a
estero	ester'o
esteroj	ester'o'j
esterojn	ester'o'j'n
estetika	estetik'a
estetikaj	estetik'a'j
estetikajn	estetik'a'j'n
estetikan	estetik'a'n
estetike	estetik'e
estetiko	estetik'o
estetikon	estetik'o'n
estiel	estiel
estimas	estim'as
estime	estim'e
estimi	estim'i
estimis	estim'is
estimo	estim'o
estimon	estim'o'n
estimu	estim'u
estimata	estim'at'a
estimataj	estim'at'a'j
estiminda	estim'ind'a
estimindaj	estim'ind'a'j
estimita	estim'it'a
estingas	esting'as
estingi	esting'i
estingis	esting'is
estingo	esting'o
estingos	esting'os
estingu	esting'u
estingado	esting'ad'o
estingante	esting'ant'e
estingiĝas	esting'iĝ'as
estingiĝi	esting'iĝ'i
estingiĝis	esting'iĝ'is
estingiĝo	esting'iĝ'o
estingiĝos	esting'iĝ'os
estingiĝanta	esting'iĝ'ant'a
estingiĝinta	esting'iĝ'int'a
estingita	esting'it'a
estingitaj	esting'it'a'j
estona	eston'a
estonaj	eston'a'j
estonan	eston'a'n
estono	eston'o
estonoj	eston'o'j
estonia	eston'i'a
estonio	eston'i'o
estonion	eston'i'o'n
estonujo	eston'uj'o
estra	estr'a
estraj	estr'a'j
estran	estr'a'n
estras	estr'as
estre	estr'e
estri	estr'i
estris	estr'is
estro	estr'o
estroj	estr'o'j
estrojn	estr'o'j'n
estron	estr'o'n
estros	estr'os
estrada	estr'ad'a
estrado	estr'ad'o
estradon	estr'ad'o'n
estrara	estr'ar'a
estraraj	estr'ar'a'j
estraran	estr'ar'a'n
estraro	estr'ar'o
estraroj	estr'ar'o'j
estrarojn	estr'ar'o'j'n
estraron	estr'ar'o'n
estrarano	estr'ar'an'o
estraranoj	estr'ar'an'o'j
estraranojn	estr'ar'an'o'j'n
estraranon	estr'ar'an'o'n
estraraneco	estr'ar'an'ec'o
estraranino	estr'ar'an'in'o
estrarkunsido	estr'ar'kun'sid'o
estrarkunsidoj	estr'ar'kun'sid'o'j
estrarkunveno	estr'ar'kun'ven'o
estrata	estr'at'a
estrataj	estr'at'a'j
estreco	estr'ec'o
estrema	estr'em'a
estrino	estr'in'o
estrinon	estr'in'o'n
estrita	estr'it'a
estritaj	estr'it'a'j
estrosistemo	estr'o'sistem'o
estrosistemoj	estr'o'sistem'o'j
estrosistemon	estr'o'sistem'o'n
estrada	estrad'a
estrado	estrad'o
estradon	estrad'o'n
estrogeno	estrogen'o
estuaro	estuar'o
estuaroj	estuar'o'j
estuarojn	estuar'o'j'n
eta	et'a
etaj	et'a'j
etajn	et'a'j'n
etan	et'a'n
etas	et'as
ete	et'e
eti	et'i
etis	et'is
eto	et'o
eton	et'o'n
etagho	et'aĝ'o
etaĵo	et'aĵ'o
etaĵoj	et'aĵ'o'j
etanolo	et'an'ol'o
etanolon	et'an'ol'o'n
etanolproduktado	et'an'ol'produkt'ad'o
etburĝa	et'burĝ'a
etburĝaj	et'burĝ'a'j
etburĝoj	et'burĝ'o'j
eteco	et'ec'o
etenergia	et'energi'a
etenergiaj	et'energi'a'j
eteta	et'et'a
etetaj	et'et'a'j
etfingro	et'fingr'o
etfingron	et'fingr'o'n
etfrekvencaj	et'frekvenc'a'j
etila	et'il'a
etileno	et'il'en'o
etilenoksido	et'il'en'oksid'o
etmanĝaĵoj	et'manĝ'aĵ'o'j
etmanĝaĵojn	et'manĝ'aĵ'o'j'n
etskalaj	et'skal'a'j
etulo	et'ul'o
etuloj	et'ul'o'j
etulojn	et'ul'o'j'n
etulon	et'ul'o'n
etulino	et'ul'in'o
etvortaro	et'vort'ar'o
etaĝa	etaĝ'a
etaĝo	etaĝ'o
etaĝoj	etaĝ'o'j
etaĝojn	etaĝ'o'j'n
etaĝon	etaĝ'o'n
etaĝdomoj	etaĝ'dom'o'j
etaĝkonstruaĵoj	etaĝ'konstru'aĵ'o'j
etapa	etap'a
etapaj	etap'a'j
etapo	etap'o
etapoj	etap'o'j
etapojn	etap'o'j'n
etapon	etap'o'n
etato	etat'o
etenda	etend'a
etendaj	etend'a'j
etendajn	etend'a'j'n
etendan	etend'a'n
etendas	etend'as
etende	etend'e
etendi	etend'i
etendis	etend'is
etendo	etend'o
etendoj	etend'o'j
etendon	etend'o'n
etendos	etend'os
etendu	etend'u
etendus	etend'us
etendado	etend'ad'o
etendaĵo	etend'aĵ'o
etendaĵoj	etend'aĵ'o'j
etendaĵojn	etend'aĵ'o'j'n
etendaĵon	etend'aĵ'o'n
etendanta	etend'ant'a
etendantaj	etend'ant'a'j
etendantan	etend'ant'a'n
etendante	etend'ant'e
etendaro	etend'ar'o
etendaroj	etend'ar'o'j
etendigita	etend'ig'it'a
etendigitaj	etend'ig'it'a'j
etendiĝas	etend'iĝ'as
etendiĝi	etend'iĝ'i
etendiĝis	etend'iĝ'is
etendiĝo	etend'iĝ'o
etendiĝos	etend'iĝ'os
etendiĝu	etend'iĝ'u
etendiĝanta	etend'iĝ'ant'a
etendiĝantaj	etend'iĝ'ant'a'j
etendiĝante	etend'iĝ'ant'e
etendiĝinta	etend'iĝ'int'a
etendiĝintaj	etend'iĝ'int'a'j
etendinte	etend'int'e
etendita	etend'it'a
etenditaj	etend'it'a'j
etenditan	etend'it'a'n
etendite	etend'it'e
etera	eter'a
etero	eter'o
eteroj	eter'o'j
eterreto	eter'ret'o
eterna	etern'a
eternaj	etern'a'j
eternajn	etern'a'j'n
eternan	etern'a'n
eternas	etern'as
eterne	etern'e
eterno	etern'o
eternon	etern'o'n
eterneco	etern'ec'o
eternecon	etern'ec'o'n
eternigas	etern'ig'as
eternigi	etern'ig'i
eternigis	etern'ig'is
eternigado	etern'ig'ad'o
eternigita	etern'ig'it'a
eternigitaj	etern'ig'it'a'j
eternulo	etern'ul'o
eternuloj	etern'ul'o'j
eternulon	etern'ul'o'n
etika	etik'a
etikaj	etik'a'j
etikajn	etik'a'j'n
etikan	etik'a'n
etike	etik'e
etiko	etik'o
etikon	etik'o'n
etikistoj	etik'ist'o'j
etikeda	etiked'a
etikedas	etiked'as
etikedi	etiked'i
etikedis	etiked'is
etikedo	etiked'o
etikedoj	etiked'o'j
etikedojn	etiked'o'j'n
etikedon	etiked'o'n
etikedado	etiked'ad'o
etikedadon	etiked'ad'o'n
etikedadolingvoj	etiked'ad'o'lingv'o'j
etikedita	etiked'it'a
etikeditaj	etiked'it'a'j
etiketa	etiket'a
etiketo	etiket'o
etiketoj	etiket'o'j
etiketojn	etiket'o'j'n
etiketon	etiket'o'n
etimo	etim'o
etimologia	etim'olog'i'a
etimologiaj	etim'olog'i'a'j
etimologian	etim'olog'i'a'n
etimologie	etim'olog'i'e
etimologio	etim'olog'i'o
etimologioj	etim'olog'i'o'j
etimologion	etim'olog'i'o'n
etiologio	etiolog'i'o
etiopa	etiop'a
etiopaj	etiop'a'j
etiopan	etiop'a'n
etiopo	etiop'o
etiopoj	etiop'o'j
etiopanoj	etiop'an'o'j
etiopia	etiop'i'a
etiopiaj	etiop'i'a'j
etiopio	etiop'i'o
etiopion	etiop'i'o'n
etiopujo	etiop'uj'o
etna	etn'a
etnaj	etn'a'j
etnajn	etn'a'j'n
etnan	etn'a'n
etne	etn'e
etno	etn'o
etnoj	etn'o'j
etnojn	etn'o'j'n
etnon	etn'o'n
etneco	etn'ec'o
etnecoj	etn'ec'o'j
etnecojn	etn'ec'o'j'n
etnecon	etn'ec'o'n
etnismo	etn'ism'o
etnocentrismo	etn'o'centr'ism'o
etnogenezo	etn'o'genez'o
etnografo	etn'o'graf'o
etnografoj	etn'o'graf'o'j
etnografia	etn'o'graf'i'a
etnografiaj	etn'o'graf'i'a'j
etnografiajn	etn'o'graf'i'a'j'n
etnografian	etn'o'graf'i'a'n
etnografio	etn'o'graf'i'o
etnolingva	etn'o'lingv'a
etnolingvaj	etn'o'lingv'a'j
etnolingvo	etn'o'lingv'o
etnolingvoj	etn'o'lingv'o'j
etnomuzikologio	etn'o'muzik'olog'i'o
etnologoj	etn'olog'o'j
etnologiaj	etn'olog'i'a'j
etnologio	etn'olog'i'o
etologio	etologi'o
etosa	etos'a
etoso	etos'o
etosoj	etos'o'j
etosojn	etos'o'j'n
etoson	etos'o'n
etruska	etrusk'a
etruskaj	etrusk'a'j
etrusko	etrusk'o
etruskoj	etrusk'o'j
eua	eu'a
euaj	eu'a'j
euon	eu'o'n
eucivitanoj	eu'civit'an'o'j
eugvidantoj	eu'gvid'ant'o'j
euinstancoj	eu'instanc'o'j
euinstitucioj	eu'instituci'o'j
eukomisiono	eu'komision'o
eukomisionano	eu'komision'an'o
eulando	eu'land'o
eulandoj	eu'land'o'j
eulingvo	eu'lingv'o
eulingvoj	eu'lingv'o'j
eumembroj	eu'membr'o'j
eumembreco	eu'membr'ec'o
eumembroŝtato	eu'membr'o'ŝtat'o
eumembroŝtatoj	eu'membr'o'ŝtat'o'j
euparlamento	eu'parlament'o
euparlamentanoj	eu'parlament'an'o'j
eusocieco	eu'soci'ec'o
euŝtatoj	eu'ŝtat'o'j
eŭfemisme	eŭfemism'e
eŭfemismo	eŭfemism'o
eŭfemismoj	eŭfemism'o'j
eŭfrata	eŭfrat'a
eŭfrato	eŭfrat'o
eŭgeno	eŭgen'o
eŭgenikismo	eŭgenik'ism'o
eŭkalipto	eŭkalipt'o
eŭkaliptoj	eŭkalipt'o'j
eŭkariota	eŭkariot'a
eŭkariotaj	eŭkariot'a'j
eŭkariotoj	eŭkariot'o'j
eŭkaristia	eŭkaristi'a
eŭkaristiaj	eŭkaristi'a'j
eŭkaristian	eŭkaristi'a'n
eŭkaristio	eŭkaristi'o
eŭkaristion	eŭkaristi'o'n
eŭklida	eŭklid'a
eŭklidan	eŭklid'a'n
eŭklido	eŭklid'o
eŭlera	eŭler'a
eŭnuko	eŭnuk'o
eŭnukoj	eŭnuk'o'j
eŭra	eŭr'a
eŭro	eŭr'o
eŭroj	eŭr'o'j
eŭrojn	eŭr'o'j'n
eŭron	eŭr'o'n
eŭrocentra	eŭr'o'centr'a
eŭrovidokantokonkurso	eŭr'o'vid'o'kant'o'konkurs'o
eŭrozono	eŭr'o'zon'o
eŭrozonon	eŭr'o'zon'o'n
eŭrazia	eŭrazi'a
eŭraziaj	eŭrazi'a'j
eŭrazio	eŭrazi'o
eŭropa	eŭrop'a
eŭropaj	eŭrop'a'j
eŭropajn	eŭrop'a'j'n
eŭropan	eŭrop'a'n
eŭrope	eŭrop'e
eŭropo	eŭrop'o
eŭropon	eŭrop'o'n
eŭropano	eŭrop'an'o
eŭropanoj	eŭrop'an'o'j
eŭropanojn	eŭrop'an'o'j'n
eŭropanino	eŭrop'an'in'o
eŭropdevenaj	eŭrop'de'ven'a'j
eŭropeca	eŭrop'ec'a
eŭropeco	eŭrop'ec'o
eŭropismo	eŭrop'ism'o
eŭropodemokratioesperanto	eŭrop'o'demokrat'i'o'esperant'o
eŭropstilaj	eŭrop'stil'a'j
eŭropunia	eŭrop'uni'a
eŭropuniaj	eŭrop'uni'a'j
eŭropunio	eŭrop'uni'o
eŭropio	eŭropi'o
eŭska	eŭsk'a
eŭskaj	eŭsk'a'j
eŭskan	eŭsk'a'n
eŭsko	eŭsk'o
eŭskoj	eŭsk'o'j
eŭskio	eŭsk'i'o
evakui	evaku'i
evakuis	evaku'is
evakuo	evaku'o
evakuado	evaku'ad'o
evakuadon	evaku'ad'o'n
evakuita	evaku'it'a
evakuitaj	evaku'it'a'j
evakuitoj	evaku'it'o'j
evangelia	evangeli'a
evangeliaj	evangeli'a'j
evangeliajn	evangeli'a'j'n
evangelian	evangeli'a'n
evangelio	evangeli'o
evangelioj	evangeli'o'j
evangeliojn	evangeli'o'j'n
evangelion	evangeli'o'n
evangeliana	evangeli'an'a
evangelianaj	evangeli'an'a'j
evangeliismo	evangeli'ism'o
evangeliisto	evangeli'ist'o
evangeliistoj	evangeli'ist'o'j
evangelizado	evangeliz'ad'o
evelino	evelin'o
eventa	event'a
eventaj	event'a'j
evento	event'o
eventoj	event'o'j
eventojn	event'o'j'n
eventon	event'o'n
eventoplena	event'o'plen'a
eventuala	eventual'a
eventualaj	eventual'a'j
eventualajn	eventual'a'j'n
eventualan	eventual'a'n
eventuale	eventual'e
eventualaĵo	eventual'aĵ'o
eventualaĵoj	eventual'aĵ'o'j
evidenta	evident'a
evidentaj	evident'a'j
evidentajn	evident'a'j'n
evidentan	evident'a'n
evidentas	evident'as
evidente	evident'e
evidentis	evident'is
evidento	evident'o
evidentaĵo	evident'aĵ'o
evidentaĵoj	evident'aĵ'o'j
evidentaĵon	evident'aĵ'o'n
evidenteco	evident'ec'o
evidentecon	evident'ec'o'n
evidentigas	evident'ig'as
evidentigi	evident'ig'i
evidentigis	evident'ig'is
evidentigita	evident'ig'it'a
evidentigitaj	evident'ig'it'a'j
evidentiĝas	evident'iĝ'as
evidentiĝi	evident'iĝ'i
evidentiĝis	evident'iĝ'is
evidentiĝos	evident'iĝ'os
evitas	evit'as
evite	evit'e
eviti	evit'i
evitis	evit'is
evito	evit'o
evitos	evit'os
evitu	evit'u
evitus	evit'us
evitadis	evit'ad'is
evitado	evit'ad'o
evitadon	evit'ad'o'n
evitanta	evit'ant'a
evitantaj	evit'ant'a'j
evitante	evit'ant'e
evitata	evit'at'a
evitataj	evit'at'a'j
evitebla	evit'ebl'a
eviteblaj	evit'ebl'a'j
eviteblas	evit'ebl'as
evitema	evit'em'a
eviteme	evit'em'e
evitenda	evit'end'a
evitendaj	evit'end'a'j
evitigas	evit'ig'as
evitigi	evit'ig'i
evitigis	evit'ig'is
evitinda	evit'ind'a
evitindaj	evit'ind'a'j
evitinta	evit'int'a
evitisto	evit'ist'o
evitita	evit'it'a
evititaj	evit'it'a'j
evolua	evolu'a
evoluaj	evolu'a'j
evoluajn	evolu'a'j'n
evoluan	evolu'a'n
evoluas	evolu'as
evolue	evolu'e
evolui	evolu'i
evoluis	evolu'is
evoluo	evolu'o
evoluoj	evolu'o'j
evoluojn	evolu'o'j'n
evoluon	evolu'o'n
evoluos	evolu'os
evoluu	evolu'u
evoluus	evolu'us
evoluadis	evolu'ad'is
evoluado	evolu'ad'o
evoluadoj	evolu'ad'o'j
evoluadojn	evolu'ad'o'j'n
evoluadon	evolu'ad'o'n
evoluanta	evolu'ant'a
evoluantaj	evolu'ant'a'j
evoluantajn	evolu'ant'a'j'n
evoluantan	evolu'ant'a'n
evoluante	evolu'ant'e
evoluhelpo	evolu'help'o
evoluiga	evolu'ig'a
evoluigaj	evolu'ig'a'j
evoluigajn	evolu'ig'a'j'n
evoluigan	evolu'ig'a'n
evoluigas	evolu'ig'as
evoluigi	evolu'ig'i
evoluigis	evolu'ig'is
evoluigo	evolu'ig'o
evoluigon	evolu'ig'o'n
evoluigos	evolu'ig'os
evoluigu	evolu'ig'u
evoluigus	evolu'ig'us
evoluigado	evolu'ig'ad'o
evoluiganta	evolu'ig'ant'a
evoluigantaj	evolu'ig'ant'a'j
evoluigante	evolu'ig'ant'e
evoluigata	evolu'ig'at'a
evoluiginta	evolu'ig'int'a
evoluigita	evolu'ig'it'a
evoluigitaj	evolu'ig'it'a'j
evoluigitajn	evolu'ig'it'a'j'n
evoluigitan	evolu'ig'it'a'n
evoluigite	evolu'ig'it'e
evoluigteamo	evolu'ig'team'o
evoluiĝas	evolu'iĝ'as
evoluiĝi	evolu'iĝ'i
evoluiĝis	evolu'iĝ'is
evoluiĝo	evolu'iĝ'o
evoluiĝinta	evolu'iĝ'int'a
evoluinta	evolu'int'a
evoluintaj	evolu'int'a'j
evoluintajn	evolu'int'a'j'n
evoluintan	evolu'int'a'n
evoluisma	evolu'ism'a
evoluismo	evolu'ism'o
evoluistoj	evolu'ist'o'j
evoluita	evolu'it'a
evoluitaj	evolu'it'a'j
evolulando	evolu'land'o
evolulandoj	evolu'land'o'j
evolulandojn	evolu'land'o'j'n
evoluteorio	evolu'teori'o
evolucia	evoluci'a
evolucio	evoluci'o
evolucion	evoluci'o'n
ezofaga	ezofag'a
ezofago	ezofag'o
ezoko	ezok'o
ezokon	ezok'o'n
ezopo	ezop'o