fabo	fab'o
faboj	fab'o'j
fabojn	fab'o'j'n
fabacoj	fab'ac'o'j
fabela	fabel'a
fabelaj	fabel'a'j
fabelan	fabel'a'n
fabele	fabel'e
fabelo	fabel'o
fabeloj	fabel'o'j
fabelojn	fabel'o'j'n
fabelon	fabel'o'n
fabeleca	fabel'ec'a
fabelecaj	fabel'ec'a'j
fabelkonkurso	fabel'konkurs'o
fabia	fabi'a
fabian	fabi'a'n
fabio	fabi'o
fabiano	fabian'o
fablo	fabl'o
fabloj	fabl'o'j
fablojn	fabl'o'j'n
faboideoj	faboide'o'j
fabrika	fabrik'a
fabrikaj	fabrik'a'j
fabrikas	fabrik'as
fabriki	fabrik'i
fabrikis	fabrik'is
fabriko	fabrik'o
fabrikoj	fabrik'o'j
fabrikojn	fabrik'o'j'n
fabrikon	fabrik'o'n
fabrikado	fabrik'ad'o
fabrikadon	fabrik'ad'o'n
fabrikaĵo	fabrik'aĵ'o
fabrikaĵoj	fabrik'aĵ'o'j
fabrikanta	fabrik'ant'a
fabrikanto	fabrik'ant'o
fabrikantoj	fabrik'ant'o'j
fabrikata	fabrik'at'a
fabrikataj	fabrik'at'a'j
fabrikejo	fabrik'ej'o
fabrikejoj	fabrik'ej'o'j
fabrikestro	fabrik'estr'o
fabrikisto	fabrik'ist'o
fabrikistoj	fabrik'ist'o'j
fabrikita	fabrik'it'a
fabrikitaj	fabrik'it'a'j
fabrikitajn	fabrik'it'a'j'n
fabrikmarko	fabrik'mark'o
fabriksistemo	fabrik'sistem'o
fabrikterkultivado	fabrik'ter'kultiv'ad'o
fabrikvendejoj	fabrik'vend'ej'o'j
faca	fac'a
faco	fac'o
facoj	fac'o'j
faceto	fac'et'o
facetoj	fac'et'o'j
facetojn	fac'et'o'j'n
faceton	fac'et'o'n
facetita	fac'et'it'a
facila	facil'a
facilaj	facil'a'j
facilajn	facil'a'j'n
facilan	facil'a'n
facilas	facil'as
facile	facil'e
facilis	facil'is
facilo	facil'o
facilos	facil'os
facilanima	facil'anim'a
facilanimaj	facil'anim'a'j
facilanime	facil'anim'e
facilanimeco	facil'anim'ec'o
facileco	facil'ec'o
facilecon	facil'ec'o'n
facilega	facil'eg'a
facilege	facil'eg'e
faciligas	facil'ig'as
faciligi	facil'ig'i
faciligis	facil'ig'is
faciligo	facil'ig'o
faciligon	facil'ig'o'n
faciligos	facil'ig'os
faciligu	facil'ig'u
faciligus	facil'ig'us
faciligado	facil'ig'ad'o
faciliganta	facil'ig'ant'a
faciligante	facil'ig'ant'e
faciliganto	facil'ig'ant'o
faciligita	facil'ig'it'a
faciligite	facil'ig'it'e
faciliĝo	facil'iĝ'o
faciliĝon	facil'iĝ'o'n
facilmova	facil'mov'a
facilmovaj	facil'mov'a'j
facilmove	facil'mov'e
facilmoveco	facil'mov'ec'o
facilmovecon	facil'mov'ec'o'n
facilpercepto	facil'percept'o
facilpercepton	facil'percept'o'n
fadas	fad'as
fadi	fad'i
fadis	fad'is
fado	fad'o
fadilo	fad'il'o
fadilon	fad'il'o'n
fadena	faden'a
fadeno	faden'o
fadenoj	faden'o'j
fadenojn	faden'o'j'n
fadenon	faden'o'n
fadenkruco	faden'kruc'o
faetono	faeton'o
fago	fag'o
fagoj	fag'o'j
fagopiro	fagopir'o
fagoto	fagot'o
fagotoj	fagot'o'j
fagoton	fagot'o'n
fajon	faj'o'n
fajenca	fajenc'a
fajenco	fajenc'o
fajencaĵoj	fajenc'aĵ'o'j
fajfa	fajf'a
fajfas	fajf'as
fajfi	fajf'i
fajfis	fajf'is
fajfo	fajf'o
fajfoj	fajf'o'j
fajfojn	fajf'o'j'n
fajfon	fajf'o'n
fajfu	fajf'u
fajfadis	fajf'ad'is
fajfado	fajf'ad'o
fajfadon	fajf'ad'o'n
fajfanta	fajf'ant'a
fajfante	fajf'ant'e
fajfilo	fajf'il'o
fajfiloj	fajf'il'o'j
fajfilojn	fajf'il'o'j'n
fajfilon	fajf'il'o'n
fajlas	fajl'as
fajlis	fajl'is
fajlilo	fajl'il'o
fajliloj	fajl'il'o'j
fajlilon	fajl'il'o'n
fajna	fajn'a
fajnaj	fajn'a'j
fajnajn	fajn'a'j'n
fajnan	fajn'a'n
fajne	fajn'e
fajnagordi	fajn'agord'i
fajneco	fajn'ec'o
fajnega	fajn'eg'a
fajnegaj	fajn'eg'a'j
fajngrajna	fajn'grajn'a
fajnigas	fajn'ig'as
fajra	fajr'a
fajraj	fajr'a'j
fajrajn	fajr'a'j'n
fajran	fajr'a'n
fajre	fajr'e
fajris	fajr'is
fajro	fajr'o
fajroj	fajr'o'j
fajrojn	fajr'o'j'n
fajron	fajr'o'n
fajraĵoj	fajr'aĵ'o'j
fajrego	fajr'eg'o
fajregoj	fajr'eg'o'j
fajregon	fajr'eg'o'n
fajrejo	fajr'ej'o
fajrejoj	fajr'ej'o'j
fajrejon	fajr'ej'o'n
fajreris	fajr'er'is
fajrero	fajr'er'o
fajreroj	fajr'er'o'j
fajrerojn	fajr'er'o'j'n
fajreron	fajr'er'o'n
fajrestingistoj	fajr'esting'ist'o'j
fajreto	fajr'et'o
fajretoj	fajr'et'o'j
fajrigis	fajr'ig'is
fajrigilo	fajr'ig'il'o
fajrilon	fajr'il'o'n
fajrobirdo	fajr'o'bird'o
fajrobrigada	fajr'o'brigad'a
fajrobrigado	fajr'o'brigad'o
fajrobrigadoj	fajr'o'brigad'o'j
fajrobrigadon	fajr'o'brigad'o'n
fajrobrigadano	fajr'o'brigad'an'o
fajrobrigadanoj	fajr'o'brigad'an'o'j
fajrobrigadisto	fajr'o'brigad'ist'o
fajrobrigadistoj	fajr'o'brigad'ist'o'j
fajrobrigadistojn	fajr'o'brigad'ist'o'j'n
fajrolando	fajr'o'land'o
fajrolumo	fajr'o'lum'o
fajromuro	fajr'o'mur'o
fajromuroj	fajr'o'mur'o'j
fajroŝirmilo	fajr'o'ŝirm'il'o
fajroŝtalon	fajr'o'ŝtal'o'n
fajroŝtono	fajr'o'ŝton'o
fajrovulpo	fajr'o'vulp'o
fajrujo	fajr'uj'o
fajrujoj	fajr'uj'o'j
fajrujon	fajr'uj'o'n
faka	fak'a
fakaj	fak'a'j
fakajn	fak'a'j'n
fakan	fak'a'n
fake	fak'e
fako	fak'o
fakoj	fak'o'j
fakojn	fak'o'j'n
fakon	fak'o'n
fakdelegito	fak'deleg'it'o
fakestro	fak'estr'o
fakgrupo	fak'grup'o
fakgrupoj	fak'grup'o'j
fakistaj	fak'ist'a'j
fakkunsidoj	fak'kun'sid'o'j
faklernejo	fak'lern'ej'o
faklernejoj	fak'lern'ej'o'j
faklibroj	fak'libr'o'j
faklingvo	fak'lingv'o
fakliteraturo	fak'literatur'o
fakorganizita	fak'organiz'it'a
fakorganizitaj	fak'organiz'it'a'j
fakorganizitajn	fak'organiz'it'a'j'n
fakorganizitan	fak'organiz'it'a'n
fakrevuoj	fak'revu'o'j
fakscio	fak'sci'o
fakscion	fak'sci'o'n
faktermino	fak'termin'o
faktrabaj	fak'trab'a'j
fakula	fak'ul'a
fakulaj	fak'ul'a'j
fakulo	fak'ul'o
fakuloj	fak'ul'o'j
fakulojn	fak'ul'o'j'n
fakulon	fak'ul'o'n
fakularo	fak'ul'ar'o
fakulino	fak'ul'in'o
fakvorto	fak'vort'o
fakvortoj	fak'vort'o'j
fakvortaroj	fak'vort'ar'o'j
fakso	faks'o
fakson	faks'o'n
faksmaŝino	faks'maŝin'o
faksimilo	faksimil'o
fakta	fakt'a
faktaj	fakt'a'j
faktajn	fakt'a'j'n
faktan	fakt'a'n
fakte	fakt'e
fakto	fakt'o
faktoj	fakt'o'j
faktojn	fakt'o'j'n
fakton	fakt'o'n
fakteco	fakt'ec'o
faktkonflikto	fakt'konflikt'o
faktkonfliktoj	fakt'konflikt'o'j
faktkonfliktojn	fakt'konflikt'o'j'n
faktkonflikton	fakt'konflikt'o'n
faktoro	faktor'o
faktoroj	faktor'o'j
faktorojn	faktor'o'j'n
faktoron	faktor'o'n
faktoranalizo	faktor'analiz'o
faktorigas	faktor'ig'as
faktorigo	faktor'ig'o
faktorigado	faktor'ig'ad'o
faktorigita	faktor'ig'it'a
fakturas	faktur'as
fakturo	faktur'o
fakturoj	faktur'o'j
fakturojn	faktur'o'j'n
fakturon	faktur'o'n
fakturigo	faktur'ig'o
fakultata	fakultat'a
fakultato	fakultat'o
fakultatoj	fakultat'o'j
fakultatojn	fakultat'o'j'n
fakultaton	fakultat'o'n
fakultatano	fakultat'an'o
fakultatanoj	fakultat'an'o'j
fakultativa	fakultativ'a
fala	fal'a
falas	fal'as
fali	fal'i
falis	fal'is
falo	fal'o
faloj	fal'o'j
falojn	fal'o'j'n
falon	fal'o'n
falos	fal'os
falu	fal'u
falus	fal'us
faladas	fal'ad'as
faladis	fal'ad'is
falado	fal'ad'o
faladon	fal'ad'o'n
falanta	fal'ant'a
falantaj	fal'ant'a'j
falantajn	fal'ant'a'j'n
falantan	fal'ant'a'n
falante	fal'ant'e
falegis	fal'eg'is
falego	fal'eg'o
faletas	fal'et'as
faletis	fal'et'is
falfoliaj	fal'foli'a'j
faligas	fal'ig'as
faligi	fal'ig'i
faligis	fal'ig'is
faligo	fal'ig'o
faligos	fal'ig'os
faligu	fal'ig'u
faligus	fal'ig'us
faligado	fal'ig'ad'o
faliganta	fal'ig'ant'a
faligante	fal'ig'ant'e
faliginte	fal'ig'int'e
faligita	fal'ig'it'a
faligitaj	fal'ig'it'a'j
falinta	fal'int'a
falintaj	fal'int'a'j
falintajn	fal'int'a'j'n
falintan	fal'int'a'n
falinte	fal'int'e
falintoj	fal'int'o'j
falita	fal'it'a
falitaj	fal'it'a'j
falonta	fal'ont'a
falstelo	fal'stel'o
falstelon	fal'stel'o'n
falange	falang'e
falango	falang'o
falangoj	falang'o'j
falangon	falang'o'n
falbaloj	falbal'o'j
falĉas	falĉ'as
falĉi	falĉ'i
falĉis	falĉ'is
falĉado	falĉ'ad'o
falĉilo	falĉ'il'o
falĉilon	falĉ'il'o'n
falĉileto	falĉ'il'et'o
falĉita	falĉ'it'a
faldas	fald'as
faldi	fald'i
faldis	fald'is
faldo	fald'o
faldoj	fald'o'j
faldojn	fald'o'j'n
faldon	fald'o'n
faldu	fald'u
faldado	fald'ad'o
faldante	fald'ant'e
faldebla	fald'ebl'a
faldeblaj	fald'ebl'a'j
faldeblajn	fald'ebl'a'j'n
faldeblan	fald'ebl'a'n
faldfolio	fald'foli'o
faldfolion	fald'foli'o'n
faldiĝado	fald'iĝ'ad'o
faldita	fald'it'a
falditaj	fald'it'a'j
falditan	fald'it'a'n
falko	falk'o
falkoj	falk'o'j
falkon	falk'o'n
falkoformaj	falk'o'form'a'j
falklandoj	falkland'o'j
falklandinsuloj	falkland'insul'o'j
falsa	fals'a
falsaj	fals'a'j
falsajn	fals'a'j'n
falsan	fals'a'n
falsas	fals'as
false	fals'e
falsi	fals'i
falsis	fals'is
falso	fals'o
falsado	fals'ad'o
falsaĵo	fals'aĵ'o
falsaĵoj	fals'aĵ'o'j
falsaĵojn	fals'aĵ'o'j'n
falsaĵon	fals'aĵ'o'n
falseco	fals'ec'o
falsigado	fals'ig'ad'o
falsigitaj	fals'ig'it'a'j
falsistoj	fals'ist'o'j
falsita	fals'it'a
falsitaj	fals'it'a'j
falsitan	fals'it'a'n
falspruveblo	fals'pruv'ebl'o
falto	falt'o
faltoj	falt'o'j
faltojn	falt'o'j'n
faluso	falus'o
fama	fam'a
famaj	fam'a'j
famajn	fam'a'j'n
faman	fam'a'n
famas	fam'as
fame	fam'e
famis	fam'is
famo	fam'o
famoj	fam'o'j
famojn	fam'o'j'n
famon	fam'o'n
famaĵoj	fam'aĵ'o'j
famaĵojn	fam'aĵ'o'j'n
famekonata	fam'e'kon'at'a
fameco	fam'ec'o
famecon	fam'ec'o'n
famega	fam'eg'a
famegan	fam'eg'a'n
famigis	fam'ig'is
famiĝas	fam'iĝ'as
famiĝi	fam'iĝ'i
famiĝis	fam'iĝ'is
famiĝos	fam'iĝ'os
famiĝinta	fam'iĝ'int'a
famkonata	fam'kon'at'a
famkonataj	fam'kon'at'a'j
famkonatan	fam'kon'at'a'n
famulo	fam'ul'o
famuloj	fam'ul'o'j
famulojn	fam'ul'o'j'n
famulon	fam'ul'o'n
familia	famili'a
familiaj	famili'a'j
familiajn	famili'a'j'n
familian	famili'a'n
familie	famili'e
familio	famili'o
familioj	famili'o'j
familiojn	famili'o'j'n
familion	famili'o'n
familiano	famili'an'o
familianoj	famili'an'o'j
familianojn	famili'an'o'j'n
familianon	famili'an'o'n
familieca	famili'ec'a
familiestro	famili'estr'o
familigrupoj	famili'grup'o'j
familinomo	famili'nom'o
familinomoj	famili'nom'o'j
familinomojn	famili'nom'o'j'n
familinomon	famili'nom'o'n
familiomedicino	famili'o'medicin'o
familiplanado	famili'plan'ad'o
familiara	familiar'a
familiaraj	familiar'a'j
familiarajn	familiar'a'j'n
familiaran	familiar'a'n
familiare	familiar'e
familiaro	familiar'o
familiareco	familiar'ec'o
familiariĝis	familiar'iĝ'is
fanatika	fanatik'a
fanatikaj	fanatik'a'j
fanatikan	fanatik'a'n
fanatike	fanatik'e
fanatikeco	fanatik'ec'o
fanatikecon	fanatik'ec'o'n
fanatikismo	fanatik'ism'o
fanatikulo	fanatik'ul'o
fanatikuloj	fanatik'ul'o'j
fanatikulojn	fanatik'ul'o'j'n
fanda	fand'a
fandas	fand'as
fandi	fand'i
fandis	fand'is
fando	fand'o
fandu	fand'u
fandado	fand'ad'o
fandadoj	fand'ad'o'j
fandadon	fand'ad'o'n
fandaĵo	fand'aĵ'o
fandakvo	fand'akv'o
fandejo	fand'ej'o
fandiĝas	fand'iĝ'as
fandiĝi	fand'iĝ'i
fandiĝis	fand'iĝ'is
fandiĝo	fand'iĝ'o
fandiĝos	fand'iĝ'os
fandita	fand'it'a
fanditaj	fand'it'a'j
fanditan	fand'it'a'n
fandopoto	fand'o'pot'o
fandopunkto	fand'o'punkt'o
fandujo	fand'uj'o
fanfaro	fanfar'o
fanfarona	fanfaron'a
fanfaronaj	fanfaron'a'j
fanfaronas	fanfaron'as
fanfarone	fanfaron'e
fanfaroni	fanfaron'i
fanfaronis	fanfaron'is
fanfaronu	fanfaron'u
fanfaronado	fanfaron'ad'o
fanfaronadon	fanfaron'ad'o'n
fanfaronante	fanfaron'ant'e
fanfaronulo	fanfaron'ul'o
fanto	fant'o
fanton	fant'o'n
fantasta	fantast'a
fantastaj	fantast'a'j
fantastajn	fantast'a'j'n
fantastan	fantast'a'n
fantasto	fantast'o
fantazia	fantazi'a
fantaziaj	fantazi'a'j
fantaziajn	fantazi'a'j'n
fantazian	fantazi'a'n
fantazias	fantazi'as
fantazie	fantazi'e
fantazii	fantazi'i
fantaziis	fantazi'is
fantazio	fantazi'o
fantazioj	fantazi'o'j
fantaziojn	fantazi'o'j'n
fantazion	fantazi'o'n
fantaziaĵo	fantazi'aĵ'o
fantaziaĵoj	fantazi'aĵ'o'j
fantaziaĵojn	fantazi'aĵ'o'j'n
fantaziuloj	fantazi'ul'o'j
fantoma	fantom'a
fantomaj	fantom'a'j
fantoman	fantom'a'n
fantomas	fantom'as
fantome	fantom'e
fantomo	fantom'o
fantomoj	fantom'o'j
fantomojn	fantom'o'j'n
fantomon	fantom'o'n
fantomplena	fantom'plen'a
fantomvizitata	fantom'vizit'at'a
fara	far'a
faras	far'as
fare	far'e
fari	far'i
faris	far'is
faro	far'o
faroj	far'o'j
farojn	far'o'j'n
faron	far'o'n
faros	far'os
faru	far'u
farus	far'us
faraĉas	far'aĉ'as
faradas	far'ad'as
faradi	far'ad'i
faradis	far'ad'is
farado	far'ad'o
faradoj	far'ad'o'j
faradon	far'ad'o'n
farados	far'ad'os
faraĵo	far'aĵ'o
faraĵoj	far'aĵ'o'j
faranta	far'ant'a
farantaj	far'ant'a'j
farantajn	far'ant'a'j'n
farantan	far'ant'a'n
farantas	far'ant'as
farante	far'ant'e
faranto	far'ant'o
farantoj	far'ant'o'j
faranton	far'ant'o'n
farata	far'at'a
farataj	far'at'a'j
faratajn	far'at'a'j'n
faratan	far'at'a'n
faratas	far'at'as
farate	far'at'e
farebla	far'ebl'a
fareblaj	far'ebl'a'j
fareblan	far'ebl'a'n
fareblas	far'ebl'as
farebleco	far'ebl'ec'o
fareblecon	far'ebl'ec'o'n
farenda	far'end'a
farendaj	far'end'a'j
farendajn	far'end'a'j'n
farendan	far'end'a'n
farendas	far'end'as
farendaĵo	far'end'aĵ'o
farendaĵoj	far'end'aĵ'o'j
farendaĵojn	far'end'aĵ'o'j'n
farendaĵon	far'end'aĵ'o'n
farigas	far'ig'as
farigi	far'ig'i
farigis	far'ig'is
farigita	far'ig'it'a
fariĝas	far'iĝ'as
fariĝi	far'iĝ'i
fariĝis	far'iĝ'is
fariĝo	far'iĝ'o
fariĝos	far'iĝ'os
fariĝu	far'iĝ'u
fariĝus	far'iĝ'us
fariĝadis	far'iĝ'ad'is
fariĝanta	far'iĝ'ant'a
fariĝante	far'iĝ'ant'e
fariĝinta	far'iĝ'int'a
fariĝintaj	far'iĝ'int'a'j
fariĝinte	far'iĝ'int'e
fariĝinti	far'iĝ'int'i
fariĝintus	far'iĝ'int'us
farinda	far'ind'a
farindas	far'ind'as
farinta	far'int'a
farintaj	far'int'a'j
farinte	far'int'e
farinto	far'int'o
farintoj	far'int'o'j
farintus	far'int'us
faristo	far'ist'o
farita	far'it'a
faritaj	far'it'a'j
faritajn	far'it'a'j'n
faritan	far'it'a'n
faritas	far'it'as
farite	far'it'e
faritis	far'it'is
faritaĵo	far'it'aĵ'o
faritaĵoj	far'it'aĵ'o'j
farmaniero	far'manier'o
faronta	far'ont'a
farontaj	far'ont'a'j
farota	far'ot'a
farotaj	far'ot'a'j
farotan	far'ot'a'n
farado	farad'o
faradoj	farad'o'j
faradon	farad'o'n
faraona	faraon'a
faraono	faraon'o
faraonoj	faraon'o'j
faraonon	faraon'o'n
farbas	farb'as
farbi	farb'i
farbis	farb'is
farbo	farb'o
farboj	farb'o'j
farbojn	farb'o'j'n
farbon	farb'o'n
farbos	farb'os
farbu	farb'u
farbado	farb'ad'o
farbadon	farb'ad'o'n
farbata	farb'at'a
farbisto	farb'ist'o
farbistoj	farb'ist'o'j
farbistojn	farb'ist'o'j'n
farbiston	farb'ist'o'n
farbita	farb'it'a
farbitaj	farb'it'a'j
farbopulvoro	farb'o'pulvor'o
farĉo	farĉ'o
farĉon	farĉ'o'n
farĉaĵo	farĉ'aĵ'o
farĉita	farĉ'it'a
farĉitaj	farĉ'it'a'j
farĉitajn	farĉ'it'a'j'n
faringo	faring'o
fariseo	farise'o
fariseoj	farise'o'j
farma	farm'a
farmaj	farm'a'j
farmo	farm'o
farmoj	farm'o'j
farmojn	farm'o'j'n
farmon	farm'o'n
farmado	farm'ad'o
farmantoj	farm'ant'o'j
farmbestoj	farm'best'o'j
farmbieno	farm'bien'o
farmbienoj	farm'bien'o'j
farmbienon	farm'bien'o'n
farmdomo	farm'dom'o
farmejo	farm'ej'o
farmista	farm'ist'a
farmisto	farm'ist'o
farmistoj	farm'ist'o'j
farmistojn	farm'ist'o'j'n
farmiston	farm'ist'o'n
farmita	farm'it'a
farmitaj	farm'it'a'j
farmlaboro	farm'labor'o
farmobieno	farm'o'bien'o
farmobienoj	farm'o'bien'o'j
farmodomo	farm'o'dom'o
farmacia	farmaci'a
farmaciaj	farmaci'a'j
farmaciajn	farmaci'a'j'n
farmacian	farmaci'a'n
farmacio	farmaci'o
farmaciaĵo	farmaci'aĵ'o
farmaciaĵoj	farmaci'aĵ'o'j
farmaciaĵojn	farmaci'aĵ'o'j'n
farmaciaĵon	farmaci'aĵ'o'n
farmaciisto	farmaci'ist'o
farmakologia	farmakolog'i'a
farmakologiaj	farmakolog'i'a'j
farmakologiajn	farmakolog'i'a'j'n
farmakologio	farmakolog'i'o
farso	fars'o
farson	fars'o'n
fartas	fart'as
farti	fart'i
fartis	fart'is
farto	fart'o
farton	fart'o'n
fartos	fart'os
fartu	fart'u
fartus	fart'us
faruna	farun'a
farunaj	farun'a'j
farunan	farun'a'n
faruno	farun'o
farunon	farun'o'n
farunaĵo	farun'aĵ'o
farunaĵoj	farun'aĵ'o'j
fasada	fasad'a
fasado	fasad'o
fasadoj	fasad'o'j
fasadojn	fasad'o'j'n
fasadon	fasad'o'n
fascio	fasci'o
fascina	fascin'a
fascinaj	fascin'a'j
fascinajn	fascin'a'j'n
fascinan	fascin'a'n
fascinas	fascin'as
fascine	fascin'e
fascinis	fascin'is
fascino	fascin'o
fascinon	fascin'o'n
fascinita	fascin'it'a
fascinitaj	fascin'it'a'j
fasciolo	fasciol'o
fasciolozo	fasciol'oz'o
fasko	fask'o
faskoj	fask'o'j
faskojn	fask'o'j'n
faskon	fask'o'n
faskigita	fask'ig'it'a
faskigitaj	fask'ig'it'a'j
faskokolonoj	fask'o'kolon'o'j
fasono	fason'o
fasonoj	fason'o'j
fasonon	fason'o'n
fasonado	fason'ad'o
fasonadon	fason'ad'o'n
fasonita	fason'it'a
fasta	fast'a
fastas	fast'as
fasti	fast'i
fastis	fast'is
fasto	fast'o
fastoj	fast'o'j
faston	fast'o'n
fastado	fast'ad'o
fastuma	fast'um'a
faŝisma	faŝism'a
faŝismaj	faŝism'a'j
faŝisman	faŝism'a'n
faŝismo	faŝism'o
faŝismon	faŝism'o'n
faŝista	faŝist'a
faŝisto	faŝist'o
faŝistoj	faŝist'o'j
faŝistojn	faŝist'o'j'n
fato	fat'o
faton	fat'o'n
fatala	fatal'a
fatalaj	fatal'a'j
fatalajn	fatal'a'j'n
fatalan	fatal'a'n
fatale	fatal'e
fatalo	fatal'o
fatalon	fatal'o'n
fatalismo	fatal'ism'o
fatraso	fatras'o
fatrason	fatras'o'n
fatvo	fatv'o
faŭkis	faŭk'is
faŭko	faŭk'o
faŭkon	faŭk'o'n
faŭna	faŭn'a
faŭno	faŭn'o
faŭnon	faŭn'o'n
favelo	favel'o
faveloj	favel'o'j
favora	favor'a
favoraj	favor'a'j
favorajn	favor'a'j'n
favoran	favor'a'n
favoras	favor'as
favore	favor'e
favori	favor'i
favoris	favor'is
favoro	favor'o
favoroj	favor'o'j
favorojn	favor'o'j'n
favoron	favor'o'n
favoros	favor'os
favoru	favor'u
favorus	favor'us
favorado	favor'ad'o
favoranta	favor'ant'a
favorantaj	favor'ant'a'j
favorante	favor'ant'e
favoranto	favor'ant'o
favorantoj	favor'ant'o'j
favorata	favor'at'a
favorataj	favor'at'a'j
favoratan	favor'at'a'n
favorate	favor'at'e
favorato	favor'at'o
favoratoj	favor'at'o'j
favorigas	favor'ig'as
favorigi	favor'ig'i
favorigis	favor'ig'is
favorita	favor'it'a
favoritaj	favor'it'a'j
favorito	favor'it'o
favorkora	favor'kor'a
favorkoreco	favor'kor'ec'o
favorpreze	favor'prez'e
faza	faz'a
fazaj	faz'a'j
fazas	faz'as
fazo	faz'o
fazoj	faz'o'j
fazojn	faz'o'j'n
fazon	faz'o'n
fazado	faz'ad'o
fazodiagramo	faz'o'diagram'o
fazoŝanĝo	faz'o'ŝanĝ'o
faztransiro	faz'trans'ir'o
faztransiroj	faz'trans'ir'o'j
fazano	fazan'o
fazanoj	fazan'o'j
fazanedoj	fazan'ed'o'j
fazeolo	fazeol'o
fazeoloj	fazeol'o'j
fazeolojn	fazeol'o'j'n
fazeolon	fazeol'o'n
fea	fe'a
feo	fe'o
feoj	fe'o'j
feon	fe'o'n
feina	fe'in'a
feino	fe'in'o
feinoj	fe'in'o'j
feinojn	fe'in'o'j'n
feinon	fe'in'o'n
felando	fe'land'o
ferakonto	fe'rakont'o
febla	febl'a
feblaj	febl'a'j
feblan	febl'a'n
feble	febl'e
febleco	febl'ec'o
febra	febr'a
febraj	febr'a'j
febran	febr'a'n
febras	febr'as
febre	febr'e
febris	febr'is
febro	febr'o
febroj	febr'o'j
febron	febr'o'n
februara	februar'a
februaran	februar'a'n
februare	februar'e
februaro	februar'o
februaron	februar'o'n
feĉo	feĉ'o
feĉoj	feĉ'o'j
feĉon	feĉ'o'n
federa	feder'a
federisma	feder'ism'a
federismo	feder'ism'o
federitaj	feder'it'a'j
federacia	federaci'a
federaciaj	federaci'a'j
federaciajn	federaci'a'j'n
federacian	federaci'a'n
federacie	federaci'e
federacio	federaci'o
federacioj	federaci'o'j
federacion	federaci'o'n
federaciero	federaci'er'o
federaciismo	federaci'ism'o
federala	federal'a
federalaj	federal'a'j
federalan	federal'a'n
federalistoj	federal'ist'o'j
facebook	fejsbuk'o
facebookpaĝo	fejsbuk'paĝ'o
feka	fek'a
fekaj	fek'a'j
fekas	fek'as
feke	fek'e
feki	fek'i
fekis	fek'is
feko	fek'o
fekon	fek'o'n
fekado	fek'ad'o
fekaĵo	fek'aĵ'o
fekaĵoj	fek'aĵ'o'j
fekaĵojn	fek'aĵ'o'j'n
fekaĵon	fek'aĵ'o'n
fekete	fek'et'e
fekulo	fek'ul'o
fekulo	fekul'o
fekunda	fekund'a
fekundaj	fekund'a'j
fekundajn	fekund'a'j'n
fekundan	fekund'a'n
fekunde	fekund'e
fekundeco	fekund'ec'o
fekundecon	fekund'ec'o'n
fekundecoprocento	fekund'ec'o'procent'o
fekundigas	fekund'ig'as
fekundigo	fekund'ig'o
fekundigon	fekund'ig'o'n
fekundigita	fekund'ig'it'a
fekundiĝas	fekund'iĝ'as
fekundiĝo	fekund'iĝ'o
fela	fel'a
felo	fel'o
feloj	fel'o'j
felojn	fel'o'j'n
felon	fel'o'n
feldmarŝalo	feldmarŝal'o
feldspato	feldspat'o
felicha	feliĉ'a
feliĉa	feliĉ'a
feliĉaj	feliĉ'a'j
feliĉajn	feliĉ'a'j'n
feliĉan	feliĉ'a'n
feliĉas	feliĉ'as
feliche	feliĉ'e
feliĉe	feliĉ'e
feliĉi	feliĉ'i
feliĉis	feliĉ'is
felicho	feliĉ'o
feliĉo	feliĉ'o
feliĉon	feliĉ'o'n
feliĉos	feliĉ'os
feliĉu	feliĉ'u
feliĉus	feliĉ'us
feliĉaĵo	feliĉ'aĵ'o
feliĉeco	feliĉ'ec'o
feliĉecon	feliĉ'ec'o'n
feliĉega	feliĉ'eg'a
feliĉego	feliĉ'eg'o
feliĉiga	feliĉ'ig'a
feliĉigaj	feliĉ'ig'a'j
feliĉigan	feliĉ'ig'a'n
feliĉigas	feliĉ'ig'as
feliĉige	feliĉ'ig'e
feliĉigi	feliĉ'ig'i
feliĉigis	feliĉ'ig'is
feliĉigos	feliĉ'ig'os
feliĉigu	feliĉ'ig'u
feliĉigus	feliĉ'ig'us
feliĉiĝi	feliĉ'iĝ'i
feliĉiĝis	feliĉ'iĝ'is
feliĉulo	feliĉ'ul'o
feliĉuloj	feliĉ'ul'o'j
felietone	felieton'e
felietono	felieton'o
felietonoj	felieton'o'j
felikso	feliks'o
felisedoj	felis'ed'o'j
felta	felt'a
feltaj	felt'a'j
felto	felt'o
felton	felt'o'n
femala	femal'a
femalaj	femal'a'j
female	femal'e
femalo	femal'o
femaloj	femal'o'j
femalon	femal'o'n
femina	femin'a
feminaj	femin'a'j
feminisma	femin'ism'a
feminismaj	femin'ism'a'j
feminismajn	femin'ism'a'j'n
feminisman	femin'ism'a'n
feminismo	femin'ism'o
feminismon	femin'ism'o'n
feminista	femin'ist'a
feministo	femin'ist'o
feministoj	femin'ist'o'j
feministino	femin'ist'in'o
feministinoj	femin'ist'in'o'j
femuro	femur'o
femuroj	femur'o'j
femurojn	femur'o'j'n
femuron	femur'o'n
fenola	fen'ol'a
fenolaj	fen'ol'a'j
fenolo	fen'ol'o
fenoloj	fen'ol'o'j
fenda	fend'a
fendas	fend'as
fendi	fend'i
fendis	fend'is
fendo	fend'o
fendoj	fend'o'j
fendojn	fend'o'j'n
fendon	fend'o'n
fendante	fend'ant'e
fendebla	fend'ebl'a
fendego	fend'eg'o
fendeto	fend'et'o
fendetoj	fend'et'o'j
fendetojn	fend'et'o'j'n
fendeton	fend'et'o'n
fendetiĝas	fend'et'iĝ'as
fendetiĝi	fend'et'iĝ'i
fendetiĝis	fend'et'iĝ'is
fendetiĝado	fend'et'iĝ'ad'o
fendetiĝantan	fend'et'iĝ'ant'a'n
fendiĝas	fend'iĝ'as
fendiĝis	fend'iĝ'is
fendiĝinta	fend'iĝ'int'a
fendiloj	fend'il'o'j
fendita	fend'it'a
fenditaj	fend'it'a'j
fenditan	fend'it'a'n
fendro	fendr'o
fenestra	fenestr'a
fenestraj	fenestr'a'j
fenestrajn	fenestr'a'j'n
fenestran	fenestr'a'n
fenestro	fenestr'o
fenestroj	fenestr'o'j
fenestrojn	fenestr'o'j'n
fenestron	fenestr'o'n
fenestreto	fenestr'et'o
fenestretoj	fenestr'et'o'j
fenestreton	fenestr'et'o'n
fenestrobreto	fenestr'o'bret'o
fenestrobreton	fenestr'o'bret'o'n
fenestrorozo	fenestr'o'roz'o
fenestrovitroj	fenestr'o'vitr'o'j
fenestrovitraĵo	fenestr'o'vitr'aĵ'o
fenestrovitraĵoj	fenestr'o'vitr'aĵ'o'j
fenestrozono	fenestr'o'zon'o
fenica	fenic'a
fenicaj	fenic'a'j
fenicoj	fenic'o'j
fenicia	fenic'i'a
fenicio	fenic'i'o
fenicianoj	fenic'i'an'o'j
fenicino	fenic'in'o
fenikopteroj	fenikopter'o'j
fenikso	feniks'o
feniksoj	feniks'o'j
fenila	fenil'a
fenilacetata	fenil'acet'at'a
fenilacetato	fenil'acet'at'o
fenilalanino	fenil'alanin'o
fenkolo	fenkol'o
fenomena	fenomen'a
fenomenaj	fenomen'a'j
fenomenan	fenomen'a'n
fenomeno	fenomen'o
fenomenoj	fenomen'o'j
fenomenojn	fenomen'o'j'n
fenomenon	fenomen'o'n
fenomenologia	fenomen'olog'i'a
fenomenologio	fenomen'olog'i'o
fenotipa	fenotip'a
fenotipaj	fenotip'a'j
fenotipo	fenotip'o
fenotipoj	fenotip'o'j
fenotipon	fenotip'o'n
fera	fer'a
feraj	fer'a'j
ferajn	fer'a'j'n
feran	fer'a'n
fere	fer'e
fero	fer'o
feroj	fer'o'j
feron	fer'o'n
feraĵoj	fer'aĵ'o'j
ferepoko	fer'epok'o
fererco	fer'erc'o
ferkerno	fer'kern'o
feroelektra	fer'o'elektr'a
feromagneta	fer'o'magnet'a
feromagnetaj	fer'o'magnet'a'j
feroksido	fer'oksid'o
feroza	fer'oz'a
ferpeco	fer'pec'o
fervoja	fer'voj'a
fervojaj	fer'voj'a'j
fervojajn	fer'voj'a'j'n
fervojan	fer'voj'a'n
fervoje	fer'voj'e
fervojo	fer'voj'o
fervojoj	fer'voj'o'j
fervojojn	fer'voj'o'j'n
fervojon	fer'voj'o'n
fervojinfrastrukturo	fer'voj'infrastruktur'o
fervojista	fer'voj'ist'a
fervojistaj	fer'voj'ist'a'j
fervojisto	fer'voj'ist'o
fervojistoj	fer'voj'ist'o'j
fervojlinio	fer'voj'lini'o
fervojlinioj	fer'voj'lini'o'j
fervojoreto	fer'voj'o'ret'o
fervojosistemo	fer'voj'o'sistem'o
fervojosistemoj	fer'voj'o'sistem'o'j
fervojreto	fer'voj'ret'o
fervojsocietoj	fer'voj'societ'o'j
fervojstacio	fer'voj'staci'o
fervojveturiloj	fer'voj'vetur'il'o'j
ferdeko	ferdek'o
ferdekoj	ferdek'o'j
ferdekon	ferdek'o'n
ferdinando	ferdinand'o
ferdinandon	ferdinand'o'n
feria	feri'a
feriaj	feri'a'j
feriajn	feri'a'j'n
ferian	feri'a'n
ferias	feri'as
ferie	feri'e
ferii	feri'i
feriis	feri'is
ferio	feri'o
ferioj	feri'o'j
feriojn	feri'o'j'n
ferion	feri'o'n
ferios	feri'os
feriado	feri'ad'o
feriadon	feri'ad'o'n
feriantoj	feri'ant'o'j
feriejo	feri'ej'o
feriejoj	feri'ej'o'j
feritago	feri'tag'o
feritagoj	feri'tag'o'j
feritagon	feri'tag'o'n
ferma	ferm'a
fermaj	ferm'a'j
fermajn	ferm'a'j'n
ferman	ferm'a'n
fermas	ferm'as
fermi	ferm'i
fermis	ferm'is
fermo	ferm'o
fermon	ferm'o'n
fermos	ferm'os
fermu	ferm'u
fermus	ferm'us
fermado	ferm'ad'o
fermadon	ferm'ad'o'n
fermanta	ferm'ant'a
fermante	ferm'ant'e
fermanton	ferm'ant'o'n
fermata	ferm'at'a
fermataj	ferm'at'a'j
fermebla	ferm'ebl'a
fermiĝas	ferm'iĝ'as
fermiĝi	ferm'iĝ'i
fermiĝis	ferm'iĝ'is
fermiĝo	ferm'iĝ'o
fermiĝos	ferm'iĝ'os
fermiĝu	ferm'iĝ'u
fermilo	ferm'il'o
fermiloj	ferm'il'o'j
ferminta	ferm'int'a
ferminte	ferm'int'e
fermita	ferm'it'a
fermitaj	ferm'it'a'j
fermitajn	ferm'it'a'j'n
fermitan	ferm'it'a'n
fermite	ferm'it'e
fermitcikla	ferm'it'cikl'a
fermitcirkla	ferm'it'cirkl'a
fermiteco	ferm'it'ec'o
fermitejo	ferm'it'ej'o
fermata	fermat'a
fermataj	fermat'a'j
fermentas	ferment'as
fermenti	ferment'i
fermentis	ferment'is
fermento	ferment'o
fermentoj	ferment'o'j
fermentado	ferment'ad'o
fermentadon	ferment'ad'o'n
fermentigo	ferment'ig'o
fermentilo	ferment'il'o
fermentita	ferment'it'a
fermentitaj	ferment'it'a'j
ferminivelo	fermi'nivel'o
fermiono	fermion'o
fermionoj	fermion'o'j
fernando	fernand'o
feroa	fero'a
feroaj	fero'a'j
ferooj	fero'o'j
feroca	feroc'a
ferocaj	feroc'a'j
ferocajn	feroc'a'j'n
ferocan	feroc'a'n
feroce	feroc'e
feroco	feroc'o
feromonoj	feromon'o'j
feromonojn	feromon'o'j'n
fervora	fervor'a
fervoraj	fervor'a'j
fervorajn	fervor'a'j'n
fervoran	fervor'a'n
fervoras	fervor'as
fervore	fervor'e
fervoris	fervor'is
fervoro	fervor'o
fervoron	fervor'o'n
fervoreco	fervor'ec'o
fervorege	fervor'eg'e
fervorulo	fervor'ul'o
fervoruloj	fervor'ul'o'j
fervorulojn	fervor'ul'o'j'n
festa	fest'a
festaj	fest'a'j
festajn	fest'a'j'n
festan	fest'a'n
festas	fest'as
feste	fest'e
festi	fest'i
festis	fest'is
festo	fest'o
festoj	fest'o'j
festojn	fest'o'j'n
feston	fest'o'n
festos	fest'os
festu	fest'u
festus	fest'us
festado	fest'ad'o
festadoj	fest'ad'o'j
festadojn	fest'ad'o'j'n
festadon	fest'ad'o'n
festanta	fest'ant'a
festantaj	fest'ant'a'j
festante	fest'ant'e
festantoj	fest'ant'o'j
festata	fest'at'a
festataj	fest'at'a'j
festeto	fest'et'o
festetoj	fest'et'o'j
festeton	fest'et'o'n
festita	fest'it'a
festitaj	fest'it'a'j
festlibro	fest'libr'o
festotago	fest'o'tag'o
festotagoj	fest'o'tag'o'j
festotagojn	fest'o'tag'o'j'n
festotagon	fest'o'tag'o'n
festparolado	fest'parol'ad'o
festparoladon	fest'parol'ad'o'n
festenas	festen'as
festeni	festen'i
festenis	festen'is
festeno	festen'o
festenoj	festen'o'j
festenojn	festen'o'j'n
festenon	festen'o'n
festenado	festen'ad'o
festivala	festival'a
festivalo	festival'o
festivaloj	festival'o'j
festivalojn	festival'o'j'n
festivalon	festival'o'n
festivalejo	festival'ej'o
feta	fet'a
fetaj	fet'a'j
fetan	fet'a'n
feto	fet'o
fetoj	fet'o'j
feton	fet'o'n
fetiĉo	fetiĉ'o
fetiĉkulto	fetiĉ'kult'o
fetora	fetor'a
fetoraj	fetor'a'j
fetoran	fetor'a'n
fetoras	fetor'as
fetoris	fetor'is
fetoro	fetor'o
fetoron	fetor'o'n
feuda	feŭd'a
feŭda	feŭd'a
feŭdaj	feŭd'a'j
feŭdajn	feŭd'a'j'n
feŭdan	feŭd'a'n
feŭdo	feŭd'o
feŭdoj	feŭd'o'j
feŭdojn	feŭd'o'j'n
feŭdon	feŭd'o'n
feŭdisma	feŭd'ism'a
feŭdismaj	feŭd'ism'a'j
feŭdismo	feŭd'ism'o
feŭduloj	feŭd'ul'o'j
fi	fi
fia	fi'a
fiaj	fi'a'j
fiajn	fi'a'j'n
fian	fi'a'n
fie	fi'e
fiaĵo	fi'aĵ'o
fiaĵoj	fi'aĵ'o'j
fiaĵojn	fi'aĵ'o'j'n
fibestokontrolo	fi'best'o'kontrol'o
fieco	fi'ec'o
fiecon	fi'ec'o'n
fifama	fi'fam'a
fifamaj	fi'fam'a'j
fifaman	fi'fam'a'n
fifame	fi'fam'e
fifameco	fi'fam'ec'o
fifamecon	fi'fam'ec'o'n
fifaroj	fi'far'o'j
fiherbo	fi'herb'o
fiherboj	fi'herb'o'j
fiherbojn	fi'herb'o'j'n
fiherboforigo	fi'herb'o'for'ig'o
fiinsekto	fi'insekt'o
fiinsektoj	fi'insekt'o'j
fimalbenoj	fi'mal'ben'o'j
fiodoro	fi'odor'o
fisorĉistino	fi'sorĉ'ist'in'o
fitraktis	fi'trakt'is
fitrakto	fi'trakt'o
fitraktado	fi'trakt'ad'o
fitraktadoj	fi'trakt'ad'o'j
fitraktadojn	fi'trakt'ad'o'j'n
fitraktadon	fi'trakt'ad'o'n
fitraktita	fi'trakt'it'a
fitraktitaj	fi'trakt'it'a'j
fiulo	fi'ul'o
fiuloj	fi'ul'o'j
fiulojn	fi'ul'o'j'n
fiulon	fi'ul'o'n
fiulino	fi'ul'in'o
fivortoj	fi'vort'o'j
fivortojn	fi'vort'o'j'n
fiakro	fiakr'o
fiakron	fiakr'o'n
fianĉo	fianĉ'o
fianĉoj	fianĉ'o'j
fianĉon	fianĉ'o'n
fianĉigita	fianĉ'ig'it'a
fianĉiĝis	fianĉ'iĝ'is
fianĉiĝo	fianĉ'iĝ'o
fianĉiĝon	fianĉ'iĝ'o'n
fianĉina	fianĉ'in'a
fianĉino	fianĉ'in'o
fianĉinoj	fianĉ'in'o'j
fianĉinon	fianĉ'in'o'n
fianĉiniĝis	fianĉ'in'iĝ'is
fiaska	fiask'a
fiaskas	fiask'as
fiaske	fiask'e
fiaski	fiask'i
fiaskis	fiask'is
fiasko	fiask'o
fiaskoj	fiask'o'j
fiaskojn	fiask'o'j'n
fiaskon	fiask'o'n
fiaskos	fiask'os
fiaskus	fiask'us
fiaskigi	fiask'ig'i
fiaskinta	fiask'int'a
fiaskoreĝimoj	fiask'o'reĝim'o'j
fibolo	fibol'o
fiboloj	fibol'o'j
fibra	fibr'a
fibraj	fibr'a'j
fibran	fibr'a'n
fibro	fibr'o
fibroj	fibr'o'j
fibrojn	fibr'o'j'n
fibron	fibr'o'n
fibreca	fibr'ec'a
fibrecaj	fibr'ec'a'j
fibrolaseroj	fibr'o'laser'o'j
fibrooptikaj	fibr'o'optik'a'j
fibroidoj	fibr'oid'o'j
fibroptiko	fibr'optik'o
fibrozo	fibr'oz'o
fibulo	fibul'o
fida	fid'a
fidaj	fid'a'j
fidas	fid'as
fide	fid'e
fidi	fid'i
fidis	fid'is
fido	fid'o
fidoj	fid'o'j
fidon	fid'o'n
fidos	fid'os
fidu	fid'u
fidus	fid'us
fidado	fid'ad'o
fidanta	fid'ant'a
fidantaj	fid'ant'a'j
fidante	fid'ant'e
fidata	fid'at'a
fidema	fid'em'a
fidemaj	fid'em'a'j
fideme	fid'em'e
fidemo	fid'em'o
fidinda	fid'ind'a
fidindaj	fid'ind'a'j
fidindajn	fid'ind'a'j'n
fidindan	fid'ind'a'n
fidindas	fid'ind'as
fidinde	fid'ind'e
fidindeco	fid'ind'ec'o
fidindecon	fid'ind'ec'o'n
fidindecinĝenieristiko	fid'ind'ec'inĝenier'ist'ik'o
fidita	fid'it'a
fiditaj	fid'it'a'j
fidoplena	fid'o'plen'a
fidoreto	fid'o'ret'o
fideismo	fideism'o
fidela	fidel'a
fidelaj	fidel'a'j
fidelajn	fidel'a'j'n
fidelan	fidel'a'n
fidelas	fidel'as
fidele	fidel'e
fidelis	fidel'is
fidelo	fidel'o
fidelon	fidel'o'n
fideleco	fidel'ec'o
fidelecoj	fidel'ec'o'j
fidelecon	fidel'ec'o'n
fidelecoĵuron	fidel'ec'o'ĵur'o'n
fidelulo	fidel'ul'o
fideluloj	fidel'ul'o'j
fidelulojn	fidel'ul'o'j'n
fidelulon	fidel'ul'o'n
fiera	fier'a
fieraj	fier'a'j
fieran	fier'a'n
fieras	fier'as
fiere	fier'e
fieri	fier'i
fieris	fier'is
fiero	fier'o
fieron	fier'o'n
fieros	fier'os
fieru	fier'u
fierus	fier'us
fiereco	fier'ec'o
fierecon	fier'ec'o'n
fierega	fier'eg'a
fierigas	fier'ig'as
fierinda	fier'ind'a
figo	fig'o
figoj	fig'o'j
figojn	fig'o'j'n
figon	fig'o'n
figaro	fig'ar'o
figarbo	fig'arb'o
figarboj	fig'arb'o'j
figura	figur'a
figuraj	figur'a'j
figuran	figur'a'n
figuras	figur'as
figure	figur'e
figuris	figur'is
figuro	figur'o
figuroj	figur'o'j
figurojn	figur'o'j'n
figuron	figur'o'n
figurado	figur'ad'o
figuraĵo	figur'aĵ'o
figuraĵon	figur'aĵ'o'n
figureto	figur'et'o
figuretoj	figur'et'o'j
figuretojn	figur'et'o'j'n
figurita	figur'it'a
fiĝia	fiĝi'a
fiĝiaj	fiĝi'a'j
fiĝio	fiĝi'o
fiĝioj	fiĝi'o'j
fikas	fik'as
fiki	fik'i
fikis	fik'is
fiku	fik'u
fikado	fik'ad'o
fikcia	fikci'a
fikciaj	fikci'a'j
fikciajn	fikci'a'j'n
fikcian	fikci'a'n
fikcio	fikci'o
fikcioj	fikci'o'j
fikcion	fikci'o'n
fikciaĵoj	fikci'aĵ'o'j
fikciigita	fikci'ig'it'a
fikciulo	fikci'ul'o
fikciuloj	fikci'ul'o'j
fiksa	fiks'a
fiksaj	fiks'a'j
fiksajn	fiks'a'j'n
fiksan	fiks'a'n
fiksas	fiks'as
fikse	fiks'e
fiksi	fiks'i
fiksis	fiks'is
fikso	fiks'o
fiksoj	fiks'o'j
fikson	fiks'o'n
fiksos	fiks'os
fiksu	fiks'u
fiksado	fiks'ad'o
fiksadon	fiks'ad'o'n
fiksaĵo	fiks'aĵ'o
fiksaĵoj	fiks'aĵ'o'j
fiksaĵojn	fiks'aĵ'o'j'n
fiksanta	fiks'ant'a
fiksante	fiks'ant'e
fiksata	fiks'at'a
fiksataj	fiks'at'a'j
fiksaŭskultis	fiks'aŭskult'is
fiksiĝas	fiks'iĝ'as
fiksiĝi	fiks'iĝ'i
fiksiĝis	fiks'iĝ'is
fiksiĝinta	fiks'iĝ'int'a
fiksiĝintaj	fiks'iĝ'int'a'j
fiksinte	fiks'int'e
fiksita	fiks'it'a
fiksitaj	fiks'it'a'j
fiksitajn	fiks'it'a'j'n
fiksitan	fiks'it'a'n
fiksite	fiks'it'e
fikspunkto	fiks'punkt'o
fiksrigardas	fiks'rigard'as
fiksrigardi	fiks'rigard'i
fiksrigardis	fiks'rigard'is
fiksrigardante	fiks'rigard'ant'e
fiktiva	fiktiv'a
fila	fil'a
file	fil'e
filo	fil'o
filoj	fil'o'j
filojn	fil'o'j'n
filon	fil'o'n
fileto	fil'et'o
fileton	fil'et'o'n
filino	fil'in'o
filinoj	fil'in'o'j
filinojn	fil'in'o'j'n
filinon	fil'in'o'n
filineto	fil'in'et'o
filineton	fil'in'et'o'n
filinlingvoj	fil'in'lingv'o'j
filadelfia	filadelfi'a
filadelfio	filadelfi'o
filamento	filament'o
filamentoj	filament'o'j
filamentojn	filament'o'j'n
filamenton	filament'o'n
filantropo	filantrop'o
filantropoj	filantrop'o'j
filantropia	filantrop'i'a
filantropiaj	filantrop'i'a'j
filantropio	filantrop'i'o
filantropion	filantrop'i'o'n
filatela	filatel'a
filatelo	filatel'o
filatelisto	filatel'ist'o
filatelistoj	filatel'ist'o'j
fileo	file'o
filemono	filemon'o
filharmonia	filharmoni'a
filharmonio	filharmoni'o
filia	fili'a
filiaj	fili'a'j
filio	fili'o
filioj	fili'o'j
filiojn	fili'o'j'n
filion	fili'o'n
filiigita	fili'ig'it'a
filiigitaj	fili'ig'it'a'j
filiberto	filibert'o
filigrano	filigran'o
filiko	filik'o
filikoj	filik'o'j
filipo	filip'o
filipio	filipi'o
filipina	filipin'a
filipinaj	filipin'a'j
filipinajn	filipin'a'j'n
filipinan	filipin'a'n
filipino	filipin'o
filipinoj	filipin'o'j
filipinojn	filipin'o'j'n
filipinano	filipin'an'o
filipinanoj	filipin'an'o'j
filipinaninoj	filipin'an'in'o'j
filipinio	filipin'i'o
filipinion	filipin'i'o'n
filistra	filistr'a
filistro	filistr'o
filistroj	filistr'o'j
filiŝtoj	filiŝt'o'j
filma	film'a
filmaj	film'a'j
filmajn	film'a'j'n
filman	film'a'n
filmas	film'as
filme	film'e
filmi	film'i
filmis	film'is
filmo	film'o
filmoj	film'o'j
filmojn	film'o'j'n
filmon	film'o'n
filmado	film'ad'o
filmadon	film'ad'o'n
filmaĵo	film'aĵ'o
filmaĵon	film'aĵ'o'n
filmaktoro	film'aktor'o
filmante	film'ant'e
filmaro	film'ar'o
filmarto	film'art'o
filmejo	film'ej'o
filmeroj	film'er'o'j
filmeto	film'et'o
filmetoj	film'et'o'j
filmetojn	film'et'o'j'n
filmeton	film'et'o'n
filmfestivalo	film'festival'o
filmfestivaloj	film'festival'o'j
filmhistorio	film'histori'o
filmigo	film'ig'o
filmigon	film'ig'o'n
filmilo	film'il'o
filmilon	film'il'o'n
filmindustrio	film'industri'o
filmisto	film'ist'o
filmistoj	film'ist'o'j
filmita	film'it'a
filmitaj	film'it'a'j
filmkameraoj	film'kamera'o'j
filmkariero	film'karier'o
filmkritikistoj	film'kritik'ist'o'j
filmmuziko	film'muzik'o
filmoproduktado	film'o'produkt'ad'o
filmproduktado	film'produkt'ad'o
filmserio	film'seri'o
filmstelulo	film'stel'ul'o
filmstudioj	film'studi'o'j
filmversio	film'versi'o
filogenetika	filogenetik'a
filogenetikaj	filogenetik'a'j
filogenetikajn	filogenetik'a'j'n
filogenetiko	filogenetik'o
filogenio	filogeni'o
filologo	filolog'o
filologoj	filolog'o'j
filologia	filolog'i'a
filologiaj	filolog'i'a'j
filologian	filolog'i'a'n
filologio	filolog'i'o
filologion	filolog'i'o'n
filoskopo	filoskop'o
filoskopoj	filoskop'o'j
filozofa	filozof'a
filozofaj	filozof'a'j
filozofajn	filozof'a'j'n
filozofi	filozof'i
filozofo	filozof'o
filozofoj	filozof'o'j
filozofojn	filozof'o'j'n
filozofon	filozof'o'n
filozofia	filozof'i'a
filozofiaj	filozof'i'a'j
filozofiajn	filozof'i'a'j'n
filozofian	filozof'i'a'n
filozofie	filozof'i'e
filozofii	filozof'i'i
filozofio	filozof'i'o
filozofioj	filozof'i'o'j
filozofiojn	filozof'i'o'j'n
filozofion	filozof'i'o'n
filozofiado	filozof'i'ad'o
filtras	filtr'as
filtri	filtr'i
filtris	filtr'is
filtrado	filtr'ad'o
filtradon	filtr'ad'o'n
filtranta	filtr'ant'a
filtrante	filtr'ant'e
filtrilo	filtr'il'o
filtriloj	filtr'il'o'j
filtrilojn	filtr'il'o'j'n
filtrilon	filtr'il'o'n
filtrita	filtr'it'a
filtritaj	filtr'it'a'j
filumo	filum'o
filumoj	filum'o'j
fina	fin'a
finaj	fin'a'j
finajn	fin'a'j'n
finan	fin'a'n
finas	fin'as
fine	fin'e
fini	fin'i
finis	fin'is
fino	fin'o
finoj	fin'o'j
finojn	fin'o'j'n
finon	fin'o'n
finos	fin'os
finu	fin'u
finus	fin'us
finado	fin'ad'o
finajho	fin'aĵ'o
finaĵo	fin'aĵ'o
finaĵoj	fin'aĵ'o'j
finaĵojn	fin'aĵ'o'j'n
finaĵon	fin'aĵ'o'n
finakto	fin'akt'o
finanta	fin'ant'a
finantaj	fin'ant'a'j
finantan	fin'ant'a'n
finante	fin'ant'e
finbatalo	fin'batal'o
finbrulis	fin'brul'is
fincelo	fin'cel'o
findecidi	fin'decid'i
finfari	fin'far'i
finfaris	fin'far'is
finfaros	fin'far'os
finfarita	fin'far'it'a
finfina	fin'fin'a
finfinaj	fin'fin'a'j
finfinan	fin'fin'a'n
finfine	fin'fin'e
fingrado	fin'grad'o
fingradoj	fin'grad'o'j
finhaltejo	fin'halt'ej'o
finhava	fin'hav'a
finhavaj	fin'hav'a'j
finhavajn	fin'hav'a'j'n
finhavan	fin'hav'a'n
finhave	fin'hav'e
finigas	fin'ig'as
finigi	fin'ig'i
finigis	fin'ig'is
finigo	fin'ig'o
finiĝas	fin'iĝ'as
finiĝi	fin'iĝ'i
finiĝis	fin'iĝ'is
finigho	fin'iĝ'o
finiĝo	fin'iĝ'o
finiĝoj	fin'iĝ'o'j
finiĝon	fin'iĝ'o'n
finiĝos	fin'iĝ'os
finiĝu	fin'iĝ'u
finiĝus	fin'iĝ'us
finiĝado	fin'iĝ'ad'o
finiĝanta	fin'iĝ'ant'a
finiĝantaj	fin'iĝ'ant'a'j
finiĝantajn	fin'iĝ'ant'a'j'n
finiĝantan	fin'iĝ'ant'a'n
finiĝante	fin'iĝ'ant'e
finiĝinta	fin'iĝ'int'a
finiĝonta	fin'iĝ'ont'a
fininta	fin'int'a
finintaj	fin'int'a'j
fininte	fin'int'e
finita	fin'it'a
finitaj	fin'it'a'j
finitajn	fin'it'a'j'n
finitan	fin'it'a'n
finite	fin'it'e
finiteco	fin'it'ec'o
finkalkulo	fin'kalkul'o
finkonstrui	fin'konstru'i
finkonstruis	fin'konstru'is
finkonstruo	fin'konstru'o
finkonstruiĝis	fin'konstru'iĝ'is
finkonstruita	fin'konstru'it'a
finkonstruitaj	fin'konstru'it'a'j
finlegi	fin'leg'i
finlegis	fin'leg'is
finleginta	fin'leg'int'a
finleginte	fin'leg'int'e
finlernis	fin'lern'is
finmanĝi	fin'manĝ'i
finmanĝis	fin'manĝ'is
finmezepoko	fin'mez'epok'o
finofara	fin'o'far'a
finonta	fin'ont'a
finparolis	fin'parol'is
finpoluro	fin'polur'o
finpoluroj	fin'polur'o'j
finpolurojn	fin'polur'o'j'n
finpoluron	fin'polur'o'n
finpretigi	fin'pret'ig'i
finpretigis	fin'pret'ig'is
finpretigo	fin'pret'ig'o
finpretigita	fin'pret'ig'it'a
finprodukto	fin'produkt'o
finproduktoj	fin'produkt'o'j
finpunkto	fin'punkt'o
finpunktoj	fin'punkt'o'j
finpunkton	fin'punkt'o'n
finredakti	fin'redakt'i
finrezulto	fin'rezult'o
finrezultoj	fin'rezult'o'j
finrezulton	fin'rezult'o'n
finskribis	fin'skrib'is
finsomero	fin'somer'o
finstacio	fin'staci'o
finstacioj	fin'staci'o'j
finstacion	fin'staci'o'n
finstudis	fin'stud'is
finstudinta	fin'stud'int'a
fintrinkis	fin'trink'is
finuzanto	fin'uz'ant'o
finuzantoj	fin'uz'ant'o'j
finvenkisma	fin'venk'ism'a
finvenkismaj	fin'venk'ism'a'j
finvenkismo	fin'venk'ism'o
finvenkismon	fin'venk'ism'o'n
finvenkismoraŭmismo	fin'venk'ism'o'raŭm'ism'o
finvenkisto	fin'venk'ist'o
finvenkistoj	fin'venk'ist'o'j
finverkis	fin'verk'is
finala	final'a
finalo	final'o
finaloj	final'o'j
finalon	final'o'n
finalistoj	final'ist'o'j
finalistinon	final'ist'in'o'n
financa	financ'a
financaj	financ'a'j
financajn	financ'a'j'n
financan	financ'a'n
financas	financ'as
finance	financ'e
financi	financ'i
financis	financ'is
financo	financ'o
financoj	financ'o'j
financojn	financ'o'j'n
financon	financ'o'n
financos	financ'os
financado	financ'ad'o
financadon	financ'ad'o'n
financanta	financ'ant'a
financante	financ'ant'e
financantoj	financ'ant'o'j
financata	financ'at'a
financataj	financ'at'a'j
financejo	financ'ej'o
financejoj	financ'ej'o'j
financisto	financ'ist'o
financistoj	financ'ist'o'j
financita	financ'it'a
financitaj	financ'it'a'j
financkrizo	financ'kriz'o
financministerio	financ'ministeri'o
financministro	financ'ministr'o
financpolitiko	financ'politik'o
fingre	fingr'e
fingro	fingr'o
fingroj	fingr'o'j
fingrojn	fingr'o'j'n
fingron	fingr'o'n
fingreto	fingr'et'o
fingretoj	fingr'et'o'j
fingrolingvo	fingr'o'lingv'o
fingromontris	fingr'o'montr'is
fingropintoj	fingr'o'pint'o'j
fingropintojn	fingr'o'pint'o'j'n
fingroringon	fingr'o'ring'o'n
fingrospuro	fingr'o'spur'o
fingrospuroj	fingr'o'spur'o'j
fingrospurojn	fingr'o'spur'o'j'n
fingrotabulo	fingr'o'tabul'o
fingrotruoj	fingr'o'tru'o'j
fingrumas	fingr'um'as
fingrumi	fingr'um'i
fingrumis	fingr'um'is
fingrumado	fingr'um'ad'o
finia	fini'a
finiaj	fini'a'j
finian	fini'a'n
finlando	finland'o
finna	finn'a
finnaj	finn'a'j
finnan	finn'a'n
finne	finn'e
finno	finn'o
finnoj	finn'o'j
finnojn	finn'o'j'n
finnlanda	finn'land'a
finnlandaj	finn'land'a'j
finnlando	finn'land'o
finnlandon	finn'land'o'n
finnlingva	finn'lingv'a
finnujo	finn'uj'o
fiolo	fiol'o
firma	firm'a
firmaj	firm'a'j
firmajn	firm'a'j'n
firman	firm'a'n
firme	firm'e
firmo	firm'o
firmoj	firm'o'j
firmaĵo	firm'aĵ'o
firmanima	firm'anim'a
firmaniman	firm'anim'a'n
firmeco	firm'ec'o
firmecon	firm'ec'o'n
firmega	firm'eg'a
firmege	firm'eg'e
firmigas	firm'ig'as
firmigi	firm'ig'i
firmigis	firm'ig'is
firmigo	firm'ig'o
firmigita	firm'ig'it'a
firmigitaj	firm'ig'it'a'j
firmiĝas	firm'iĝ'as
firmiĝi	firm'iĝ'i
firmiĝis	firm'iĝ'is
firmiĝo	firm'iĝ'o
firmiĝon	firm'iĝ'o'n
firmligita	firm'lig'it'a
firmvaro	firm'var'o
firmvaron	firm'var'o'n
firmvola	firm'vol'a
firmaa	firma'a
firmaaj	firma'a'j
firmao	firma'o
firmaoj	firma'o'j
firmaojn	firma'o'j'n
firmaon	firma'o'n
firmamento	firmament'o
firmamenton	firmament'o'n
firsto	first'o
fisio	fisi'o
fision	fisi'o'n
fisiobombo	fisi'o'bomb'o
fisiproduktoj	fisi'produkt'o'j
fiska	fisk'a
fiskaj	fisk'a'j
fiskajn	fisk'a'j'n
fiskan	fisk'a'n
fisko	fisk'o
fiskon	fisk'o'n
fistulo	fistul'o
fiŝa	fiŝ'a
fiŝaj	fiŝ'a'j
fiŝan	fiŝ'a'n
fiŝas	fiŝ'as
fiŝi	fiŝ'i
fiŝo	fiŝ'o
fiŝoj	fiŝ'o'j
fiŝojn	fiŝ'o'j'n
fiŝon	fiŝ'o'n
fiŝado	fiŝ'ad'o
fiŝaglo	fiŝ'agl'o
fiŝaĵo	fiŝ'aĵ'o
fiŝaĵoj	fiŝ'aĵ'o'j
fiŝaĵon	fiŝ'aĵ'o'n
fiŝaro	fiŝ'ar'o
fiŝaroj	fiŝ'ar'o'j
fiŝbredado	fiŝ'bred'ad'o
fiŝetoj	fiŝ'et'o'j
fiŝetojn	fiŝ'et'o'j'n
fiŝfarmo	fiŝ'farm'o
fiŝfarmoj	fiŝ'farm'o'j
fiŝfarmojn	fiŝ'farm'o'j'n
fiŝhokis	fiŝ'hok'is
fiŝhokoj	fiŝ'hok'o'j
fiŝhokado	fiŝ'hok'ad'o
fiŝidaro	fiŝ'id'ar'o
fiŝista	fiŝ'ist'a
fiŝistaj	fiŝ'ist'a'j
fiŝistan	fiŝ'ist'a'n
fiŝisto	fiŝ'ist'o
fiŝistoj	fiŝ'ist'o'j
fiŝkapta	fiŝ'kapt'a
fiŝkaptaj	fiŝ'kapt'a'j
fiŝkaptajn	fiŝ'kapt'a'j'n
fiŝkaptan	fiŝ'kapt'a'n
fiŝkaptas	fiŝ'kapt'as
fiŝkapti	fiŝ'kapt'i
fiŝkaptis	fiŝ'kapt'is
fiŝkaptadaj	fiŝ'kapt'ad'a'j
fiŝkaptadi	fiŝ'kapt'ad'i
fiŝkaptado	fiŝ'kapt'ad'o
fiŝkaptadon	fiŝ'kapt'ad'o'n
fiŝkaptante	fiŝ'kapt'ant'e
fiŝkaptejo	fiŝ'kapt'ej'o
fiŝkaptejoj	fiŝ'kapt'ej'o'j
fiŝkaptista	fiŝ'kapt'ist'a
fiŝkaptistaj	fiŝ'kapt'ist'a'j
fiŝkaptisto	fiŝ'kapt'ist'o
fiŝkaptistoj	fiŝ'kapt'ist'o'j
fiŝkaptistojn	fiŝ'kapt'ist'o'j'n
fiŝlago	fiŝ'lag'o
fiŝlagoj	fiŝ'lag'o'j
fiŝoleo	fiŝ'ole'o
fiŝreto	fiŝ'ret'o
fiŝretoj	fiŝ'ret'o'j
fiŝretojn	fiŝ'ret'o'j'n
fiŝsaŭco	fiŝ'saŭc'o
fiŝspecoj	fiŝ'spec'o'j
fiŝvendisto	fiŝ'vend'ist'o
fizika	fizik'a
fizikaj	fizik'a'j
fizikajn	fizik'a'j'n
fizikan	fizik'a'n
fizike	fizik'e
fiziko	fizik'o
fizikoj	fizik'o'j
fizikojn	fizik'o'j'n
fizikon	fizik'o'n
fizikismo	fizik'ism'o
fizikisto	fizik'ist'o
fizikistoj	fizik'ist'o'j
fizikistojn	fizik'ist'o'j'n
fizikiston	fizik'ist'o'n
fiziologoj	fiziolog'o'j
fiziologia	fiziolog'i'a
fiziologiaj	fiziolog'i'a'j
fiziologiajn	fiziolog'i'a'j'n
fiziologian	fiziolog'i'a'n
fiziologie	fiziolog'i'e
fiziologio	fiziolog'i'o
fiziologion	fiziolog'i'o'n
fizionomio	fizionomi'o
fizionomion	fizionomi'o'n
fizioterapio	fizioterapi'o
fjordo	fjord'o
fjordoj	fjord'o'j
fjordon	fjord'o'n
fjordane	fjord'an'e
flaga	flag'a
flago	flag'o
flagoj	flag'o'j
flagojn	flag'o'j'n
flagon	flag'o'n
flageto	flag'et'o
flagetoj	flag'et'o'j
flagetojn	flag'et'o'j'n
flageton	flag'et'o'n
flagstango	flag'stang'o
flagŝipo	flag'ŝip'o
flagelo	flagel'o
flagras	flagr'as
flagris	flagr'is
flagrado	flagr'ad'o
flagranta	flagr'ant'a
flagrantaj	flagr'ant'a'j
flagretis	flagr'et'is
flako	flak'o
flakoj	flak'o'j
flakojn	flak'o'j'n
flakon	flak'o'n
flakono	flakon'o
flakonoj	flakon'o'j
flakonon	flakon'o'n
flama	flam'a
flamaj	flam'a'j
flaman	flam'a'n
flamas	flam'as
flame	flam'e
flamis	flam'is
flamo	flam'o
flamoj	flam'o'j
flamojn	flam'o'j'n
flamon	flam'o'n
flamanta	flam'ant'a
flamantaj	flam'ant'a'j
flameto	flam'et'o
flamigas	flam'ig'as
flamigi	flam'ig'i
flamigis	flam'ig'is
flamiĝis	flam'iĝ'is
flamiĝema	flam'iĝ'em'a
flamiĝemaj	flam'iĝ'em'a'j
flamiĝemo	flam'iĝ'em'o
flamlumo	flam'lum'o
flamlumoj	flam'lum'o'j
flamengo	flameng'o
flamengoj	flameng'o'j
flamenka	flamenk'a
flamenko	flamenk'o
flano	flan'o
flanoj	flan'o'j
flanon	flan'o'n
flandra	flandr'a
flandraj	flandr'a'j
flandran	flandr'a'n
flandro	flandr'o
flandroj	flandr'o'j
flandrio	flandr'i'o
flandrion	flandr'i'o'n
flandrujo	flandr'uj'o
flanelo	flanel'o
flanĝo	flanĝ'o
flanka	flank'a
flankaj	flank'a'j
flankajn	flank'a'j'n
flankan	flank'a'n
flanke	flank'e
flanken	flank'e'n
flanko	flank'o
flankoj	flank'o'j
flankojn	flank'o'j'n
flankon	flank'o'n
flankaĵoj	flank'aĵ'o'j
flankalflanka	flank'al'flank'a
flankalflanke	flank'al'flank'e
flankaparato	flank'aparat'o
flankaparatoj	flank'aparat'o'j
flankenbalaas	flank'e'n'bala'as
flankenbalais	flank'e'n'bala'is
flankenbalaita	flank'e'n'bala'it'a
flankeniris	flank'e'n'ir'is
flankenlasas	flank'e'n'las'as
flankenlasi	flank'e'n'las'i
flankenlasis	flank'e'n'las'is
flankenmetas	flank'e'n'met'as
flankenmeti	flank'e'n'met'i
flankenmetis	flank'e'n'met'is
flankenmetitaj	flank'e'n'met'it'a'j
flankenmetite	flank'e'n'met'it'e
flankenpuŝita	flank'e'n'puŝ'it'a
flankenŝovi	flank'e'n'ŝov'i
flankefikoj	flank'efik'o'j
flankiĝis	flank'iĝ'is
flankita	flank'it'a
flanklinioj	flank'lini'o'j
flankmuro	flank'mur'o
flankmuroj	flank'mur'o'j
flanknavo	flank'nav'o
flanknavoj	flank'nav'o'j
flankoĉeflanke	flank'o'ĉe'flank'e
flankovojoj	flank'o'voj'o'j
flankovojon	flank'o'voj'o'n
flankpasi	flank'pas'i
flankrivero	flank'river'o
flankriveroj	flank'river'o'j
flara	flar'a
flaraj	flar'a'j
flaras	flar'as
flari	flar'i
flaris	flar'is
flaro	flar'o
flaron	flar'o'n
flaru	flar'u
flarado	flar'ad'o
flaradon	flar'ad'o'n
flarante	flar'ant'e
flarkapablon	flar'kapabl'o'n
flarsenso	flar'sens'o
flarsento	flar'sent'o
flata	flat'a
flataj	flat'a'j
flatas	flat'as
flate	flat'e
flati	flat'i
flatis	flat'is
flato	flat'o
flatoj	flat'o'j
flatu	flat'u
flatado	flat'ad'o
flatema	flat'em'a
flatita	flat'it'a
flaŭra	flaŭr'a
flaŭro	flaŭr'o
flaŭron	flaŭr'o'n
flava	flav'a
flavaj	flav'a'j
flavajn	flav'a'j'n
flavan	flav'a'n
flavas	flav'as
flave	flav'e
flavo	flav'o
flavon	flav'o'n
flavbeka	flav'bek'a
flavbruna	flav'brun'a
flaveca	flav'ec'a
flavecaj	flav'ec'a'j
flavecajn	flav'ec'a'j'n
flavecan	flav'ec'a'n
flavece	flav'ec'e
flaveco	flav'ec'o
flavecbruna	flav'ec'brun'a
flaveta	flav'et'a
flavetaj	flav'et'a'j
flavgriza	flav'griz'a
flaviĝas	flav'iĝ'as
flaviĝis	flav'iĝ'is
flavkolora	flav'kolor'a
flavoranĝa	flav'oranĝ'a
flavulo	flav'ul'o
flavverda	flav'verd'a
flavia	flavi'a
flavio	flavi'o
flavonoidoj	flavon'oid'o'j
flegas	fleg'as
flegi	fleg'i
flegis	fleg'is
flego	fleg'o
flegon	fleg'o'n
flegu	fleg'u
flegado	fleg'ad'o
flegadon	fleg'ad'o'n
flegata	fleg'at'a
flegataj	fleg'at'a'j
flegejo	fleg'ej'o
flegejoj	fleg'ej'o'j
flegejon	fleg'ej'o'n
flegisto	fleg'ist'o
flegistoj	fleg'ist'o'j
flegistojn	fleg'ist'o'j'n
flegistino	fleg'ist'in'o
flegistinoj	fleg'ist'in'o'j
flegistinojn	fleg'ist'in'o'j'n
flegistinon	fleg'ist'in'o'n
flegita	fleg'it'a
flegitaj	fleg'it'a'j
flegma	flegm'a
flegme	flegm'e
fleksa	fleks'a
fleksas	fleks'as
fleksi	fleks'i
fleksis	fleks'is
flekso	fleks'o
fleksu	fleks'u
fleksado	fleks'ad'o
fleksadon	fleks'ad'o'n
fleksante	fleks'ant'e
fleksebla	fleks'ebl'a
flekseblaj	fleks'ebl'a'j
flekseblajn	fleks'ebl'a'j'n
flekseblan	fleks'ebl'a'n
flekseble	fleks'ebl'e
flekseblo	fleks'ebl'o
fleksebleco	fleks'ebl'ec'o
flekseblecon	fleks'ebl'ec'o'n
fleksejo	fleks'ej'o
fleksejoj	fleks'ej'o'j
fleksiĝas	fleks'iĝ'as
fleksiĝi	fleks'iĝ'i
fleksiĝis	fleks'iĝ'is
fleksiĝema	fleks'iĝ'em'a
fleksiĝinte	fleks'iĝ'int'e
fleksinte	fleks'int'e
fleksita	fleks'it'a
fleksitaj	fleks'it'a'j
fleksitan	fleks'it'a'n
fleksia	fleksi'a
fleksiaj	fleksi'a'j
fleksias	fleksi'as
fleksio	fleksi'o
fleksioj	fleksi'o'j
flikas	flik'as
fliki	flik'i
flikis	flik'is
flikaĵo	flik'aĵ'o
flikitaj	flik'it'a'j
flirtas	flirt'as
flirte	flirt'e
flirti	flirt'i
flirtis	flirt'is
flirto	flirt'o
flirtado	flirt'ad'o
flirtanima	flirt'anim'a
flirtanimaj	flirt'anim'a'j
flirtanta	flirt'ant'a
flirtantaj	flirt'ant'a'j
flirtema	flirt'em'a
floko	flok'o
flokoj	flok'o'j
flokojn	flok'o'j'n
flokiĝo	flok'iĝ'o
flora	flor'a
floraj	flor'a'j
florajn	flor'a'j'n
floran	flor'a'n
floras	flor'as
flori	flor'i
floris	flor'is
floro	flor'o
floroj	flor'o'j
florojn	flor'o'j'n
floron	flor'o'n
floros	flor'os
floru	flor'u
florus	flor'us
floradis	flor'ad'is
florado	flor'ad'o
floradon	flor'ad'o'n
floraĵoj	flor'aĵ'o'j
floranta	flor'ant'a
florantaj	flor'ant'a'j
florantajn	flor'ant'a'j'n
florantan	flor'ant'a'n
floraro	flor'ar'o
floraroj	flor'ar'o'j
florarojn	flor'ar'o'j'n
floraron	flor'ar'o'n
floraranĝo	flor'aranĝ'o
florbedo	flor'bed'o
florbedoj	flor'bed'o'j
florbrasiko	flor'brasik'o
florbukedo	flor'buked'o
florbukedon	flor'buked'o'n
florburĝonoj	flor'burĝon'o'j
floreto	flor'et'o
floretoj	flor'et'o'j
floreton	flor'et'o'n
florinda	flor'ind'a
florkrono	flor'kron'o
florkronoj	flor'kron'o'j
florkronon	flor'kron'o'n
florplanto	flor'plant'o
florplantoj	flor'plant'o'j
florpoto	flor'pot'o
florpotoj	flor'pot'o'j
flortempo	flor'temp'o
flortigoj	flor'tig'o'j
florvazo	flor'vaz'o
florvazoj	flor'vaz'o'j
florvazon	flor'vaz'o'n
florvendejo	flor'vend'ej'o
florenca	florenc'a
florence	florenc'e
florenco	florenc'o
florencon	florenc'o'n
floriano	florian'o
florida	florid'a
florido	florid'o
floridon	florid'o'n
flosas	flos'as
flosi	flos'i
flosis	flos'is
floso	flos'o
flosoj	flos'o'j
floson	flos'o'n
flosado	flos'ad'o
flosanta	flos'ant'a
flosantaj	flos'ant'a'j
flosantan	flos'ant'a'n
flosante	flos'ant'e
flosema	flos'em'a
flosemo	flos'em'o
flosemon	flos'em'o'n
flosglacio	flos'glaci'o
flosigi	flos'ig'i
flosigado	flos'ig'ad'o
flosigante	flos'ig'ant'e
flosilo	flos'il'o
flosiloj	flos'il'o'j
flosponto	flos'pont'o
flota	flot'a
floto	flot'o
flotoj	flot'o'j
flotojn	flot'o'j'n
floton	flot'o'n
flotestro	flot'estr'o
flua	flu'a
fluaj	flu'a'j
fluan	flu'a'n
fluas	flu'as
flue	flu'e
flui	flu'i
fluis	flu'is
fluo	flu'o
fluoj	flu'o'j
fluojn	flu'o'j'n
fluon	flu'o'n
fluos	flu'os
fluu	flu'u
fluus	flu'us
fluadas	flu'ad'as
fluadis	flu'ad'is
fluado	flu'ad'o
fluadon	flu'ad'o'n
fluaĵa	flu'aĵ'a
fluaĵo	flu'aĵ'o
fluaĵoj	flu'aĵ'o'j
fluaĵon	flu'aĵ'o'n
fluanta	flu'ant'a
fluantaj	flu'ant'a'j
fluantajn	flu'ant'a'j'n
fluantan	flu'ant'a'n
fluante	flu'ant'e
flueco	flu'ec'o
fluecon	flu'ec'o'n
fluejo	flu'ej'o
fluejoj	flu'ej'o'j
fluejon	flu'ej'o'n
fluetis	flu'et'is
fluigas	flu'ig'as
fluigi	flu'ig'i
fluigis	flu'ig'is
flukvanto	flu'kvant'o
flukvantoj	flu'kvant'o'j
flulavi	flu'lav'i
flulinia	flu'lini'a
fluliniaj	flu'lini'a'j
fluliniigi	flu'lini'ig'i
fluorapideco	flu'o'rapid'ec'o
flurapideco	flu'rapid'ec'o
fluga	flug'a
flugaj	flug'a'j
flugajn	flug'a'j'n
flugan	flug'a'n
flugas	flug'as
fluge	flug'e
flugi	flug'i
flugis	flug'is
flugo	flug'o
flugoj	flug'o'j
flugojn	flug'o'j'n
flugon	flug'o'n
flugos	flug'os
flugu	flug'u
flugus	flug'us
flugadas	flug'ad'as
flugadis	flug'ad'is
flugado	flug'ad'o
flugadon	flug'ad'o'n
fluganta	flug'ant'a
flugantaj	flug'ant'a'j
flugantajn	flug'ant'a'j'n
flugantan	flug'ant'a'n
flugante	flug'ant'e
flugantoj	flug'ant'o'j
flugbiletojn	flug'bilet'o'j'n
flugbileton	flug'bilet'o'n
flugcindro	flug'cindr'o
flugetas	flug'et'as
flugferdeko	flug'ferdek'o
flugfolio	flug'foli'o
flugfolioj	flug'foli'o'j
flugfoliojn	flug'foli'o'j'n
flugfolion	flug'foli'o'n
flughavena	flug'haven'a
flughavenaj	flug'haven'a'j
flughaveno	flug'haven'o
flughavenoj	flug'haven'o'j
flughavenojn	flug'haven'o'j'n
flughavenon	flug'haven'o'n
flugigas	flug'ig'as
flugigi	flug'ig'i
flugigis	flug'ig'is
flugila	flug'il'a
flugilaj	flug'il'a'j
flugilo	flug'il'o
flugiloj	flug'il'o'j
flugilojn	flug'il'o'j'n
flugilon	flug'il'o'n
flugiletoj	flug'il'et'o'j
flugilfrapado	flug'il'frap'ad'o
flugilhava	flug'il'hav'a
flugilhavaj	flug'il'hav'a'j
flugilhavan	flug'il'hav'a'n
flugilkovriloj	flug'il'kovr'il'o'j
flugilmakuloj	flug'il'makul'o'j
flugilpinto	flug'il'pint'o
flugilpintoj	flug'il'pint'o'j
flugilplumoj	flug'il'plum'o'j
flugilstrio	flug'il'stri'o
flugilstrioj	flug'il'stri'o'j
flugilstriojn	flug'il'stri'o'j'n
flugilstrion	flug'il'stri'o'n
flugita	flug'it'a
flugitaj	flug'it'a'j
flugkompanio	flug'kompani'o
flugkompanioj	flug'kompani'o'j
flugkontrolsistemo	flug'kontrol'sistem'o
flugmalsano	flug'mal'san'o
flugmaniero	flug'manier'o
flugmanieron	flug'manier'o'n
flugmaŝino	flug'maŝin'o
flugmaŝinoj	flug'maŝin'o'j
flugmotoroj	flug'motor'o'j
flugoplumoj	flug'o'plum'o'j
flugpado	flug'pad'o
flugpilko	flug'pilk'o
flugpilkon	flug'pilk'o'n
flugpilkado	flug'pilk'ad'o
flugplumoj	flug'plum'o'j
flugrapide	flug'rapid'e
flugteamo	flug'team'o
flugteamoj	flug'team'o'j
flugtransporto	flug'trans'port'o
fluida	fluid'a
fluidaj	fluid'a'j
fluidajn	fluid'a'j'n
fluidan	fluid'a'n
fluido	fluid'o
fluidoj	fluid'o'j
fluidojn	fluid'o'j'n
fluidaĵo	fluid'aĵ'o
fluidaĵoj	fluid'aĵ'o'j
fluidaĵon	fluid'aĵ'o'n
fluidodinamiko	fluid'o'dinamik'o
fluktuas	fluktu'as
fluktuo	fluktu'o
fluktuoj	fluktu'o'j
fluktuojn	fluktu'o'j'n
fluktuado	fluktu'ad'o
fluora	fluor'a
fluoro	fluor'o
fluoron	fluor'o'n
fluorida	fluor'id'a
fluorido	fluor'id'o
fluoridoj	fluor'id'o'j
fluoridon	fluor'id'o'n
fluoreska	fluoresk'a
fluoreskaj	fluoresk'a'j
fluoreskajn	fluoresk'a'j'n
fluoreskan	fluoresk'a'n
fluoresko	fluoresk'o
fluoreskeco	fluoresk'ec'o
fluoreskecon	fluoresk'ec'o'n
fluso	flus'o
flusebenaĵoj	flus'eben'aĵ'o'j
flustra	flustr'a
flustras	flustr'as
flustre	flustr'e
flustri	flustr'i
flustris	flustr'is
flustro	flustr'o
flustroj	flustr'o'j
flustron	flustr'o'n
flustrado	flustr'ad'o
flustranta	flustr'ant'a
flustrante	flustr'ant'e
fluto	flut'o
flutoj	flut'o'j
flutojn	flut'o'j'n
fluton	flut'o'n
fluteto	flut'et'o
flutisto	flut'ist'o
fobo	fob'o
fobio	fobi'o
fobioj	fobi'o'j
foino	foin'o
foira	foir'a
foiro	foir'o
foiroj	foir'o'j
foirojn	foir'o'j'n
foiron	foir'o'n
foirejo	foir'ej'o
foirejoj	foir'ej'o'j
foirejon	foir'ej'o'n
foirplaco	foir'plac'o
foja	foj'a
fojaj	foj'a'j
fojajn	foj'a'j'n
fojan	foj'a'n
foje	foj'e
fojo	foj'o
fojoj	foj'o'j
fojojn	foj'o'j'n
fojon	foj'o'n
fojefoje	foj'e'foj'e
fojfoja	foj'foj'a
fojfoje	foj'foj'e
fojno	fojn'o
fojnon	fojn'o'n
fojnamaso	fojn'amas'o
fojnejo	fojn'ej'o
foka	fok'a
fokaj	fok'a'j
foko	fok'o
fokoj	fok'o'j
fokojn	fok'o'j'n
fokon	fok'o'n
fokusa	fokus'a
fokusaj	fokus'a'j
fokusajn	fokus'a'j'n
fokusan	fokus'a'n
fokusas	fokus'as
fokuse	fokus'e
fokusi	fokus'i
fokusis	fokus'is
fokuso	fokus'o
fokusoj	fokus'o'j
fokusojn	fokus'o'j'n
fokuson	fokus'o'n
fokusado	fokus'ad'o
fokusigas	fokus'ig'as
fokusigi	fokus'ig'i
fokusigis	fokus'ig'is
fokusiĝas	fokus'iĝ'as
fokusiĝi	fokus'iĝ'i
fokusiĝis	fokus'iĝ'is
fokusita	fokus'it'a
fokusitaj	fokus'it'a'j
fokusitan	fokus'it'a'n
fola	fol'a
folaj	fol'a'j
foldo	fold'o
folia	foli'a
foliaj	foli'a'j
folio	foli'o
folioj	foli'o'j
foliojn	foli'o'j'n
folion	foli'o'n
foliakseloj	foli'aksel'o'j
foliantoj	foli'ant'o'j
foliaro	foli'ar'o
foliaroj	foli'ar'o'j
foliaron	foli'ar'o'n
foliarbo	foli'arb'o
foliarboj	foli'arb'o'j
foliarbaro	foli'arb'ar'o
foliarbaroj	foli'arb'ar'o'j
foliecaj	foli'ec'a'j
folieto	foli'et'o
folietoj	foli'et'o'j
folietojn	foli'et'o'j'n
folieton	foli'et'o'n
foliplato	foli'plat'o
foliplatoj	foli'plat'o'j
folirando	foli'rand'o
folisurfaco	foli'surfac'o
folitigoj	foli'tig'o'j
folitigojn	foli'tig'o'j'n
foliumas	foli'um'as
foliumi	foli'um'i
foliumis	foli'um'is
foliumado	foli'um'ad'o
foliumante	foli'um'ant'e
foliumilo	foli'um'il'o
foliumiloj	foli'um'il'o'j
foliklo	folikl'o
folikloj	folikl'o'j
folklora	folklor'a
folkloraj	folklor'a'j
folklorajn	folklor'a'j'n
folkloran	folklor'a'n
folkloro	folklor'o
folkloroj	folklor'o'j
folklorojn	folklor'o'j'n
folkloron	folklor'o'n
folkloristo	folklor'ist'o
fona	fon'a
fonaj	fon'a'j
fonajn	fon'a'j'n
fonan	fon'a'n
fone	fon'e
fono	fon'o
fonoj	fon'o'j
fonojn	fon'o'j'n
fonon	fon'o'n
fonigo	fon'ig'o
foninformon	fon'inform'o'n
fonrakonto	fon'rakont'o
fonda	fond'a
fondaj	fond'a'j
fondas	fond'as
fondi	fond'i
fondis	fond'is
fondo	fond'o
fondoj	fond'o'j
fondon	fond'o'n
fondos	fond'os
fondu	fond'u
fondado	fond'ad'o
fondadon	fond'ad'o'n
fondajho	fond'aĵ'o
fondaĵo	fond'aĵ'o
fondaĵoj	fond'aĵ'o'j
fondaĵon	fond'aĵ'o'n
fondante	fond'ant'e
fondata	fond'at'a
fondiĝas	fond'iĝ'as
fondiĝis	fond'iĝ'is
fondigho	fond'iĝ'o
fondiĝo	fond'iĝ'o
fondiĝon	fond'iĝ'o'n
fondinta	fond'int'a
fondintaj	fond'int'a'j
fondinto	fond'int'o
fondintoj	fond'int'o'j
fondintojn	fond'int'o'j'n
fondinton	fond'int'o'n
fondintino	fond'int'in'o
fondisto	fond'ist'o
fondita	fond'it'a
fonditaj	fond'it'a'j
fonditan	fond'it'a'n
fondite	fond'it'e
fondmembro	fond'membr'o
fondota	fond'ot'a
fonduma	fond'um'a
fondumo	fond'um'o
fonduso	fondus'o
fondusoj	fondus'o'j
fondusojn	fondus'o'j'n
fonduson	fondus'o'n
fonema	fonem'a
fonemaj	fonem'a'j
fonemajn	fonem'a'j'n
foneman	fonem'a'n
foneme	fonem'e
fonemo	fonem'o
fonemoj	fonem'o'j
fonemojn	fonem'o'j'n
fonemon	fonem'o'n
fonetika	fonetik'a
fonetikaj	fonetik'a'j
fonetikajn	fonetik'a'j'n
fonetikan	fonetik'a'n
fonetike	fonetik'e
fonetiko	fonetik'o
fonetikon	fonetik'o'n
fonetikistoj	fonetik'ist'o'j
fonografo	fonograf'o
fonologia	fonologi'a
fonologiaj	fonologi'a'j
fonologiajn	fonologi'a'j'n
fonologian	fonologi'a'n
fonologie	fonologi'e
fonologio	fonologi'o
fonologion	fonologi'o'n
fonta	font'a
fontaj	font'a'j
fontan	font'a'n
fontas	font'as
fonte	font'e
fonti	font'i
fontis	font'is
fonto	font'o
fontoj	font'o'j
fontojn	font'o'j'n
fonton	font'o'n
fontakvo	font'akv'o
fontakvon	font'akv'o'n
fontanta	font'ant'a
fonteto	font'et'o
fontindikoj	font'indik'o'j
fontkodo	font'kod'o
fontkodon	font'kod'o'n
fontlingvo	font'lingv'o
fontlingvoj	font'lingv'o'j
fontokritiko	font'o'kritik'o
fontolingvo	font'o'lingv'o
fontolingvoj	font'o'lingv'o'j
fontomaterialo	font'o'material'o
fontoplumo	font'o'plum'o
fontoplumon	font'o'plum'o'n
fontoteksto	font'o'tekst'o
fontotekstoj	font'o'tekst'o'j
fontteksto	font'tekst'o
fontana	fontan'a
fontano	fontan'o
fontanoj	fontan'o'j
fontanojn	fontan'o'j'n
fontanon	fontan'o'n
for	for
fora	for'a
foraj	for'a'j
forajn	for'a'j'n
foran	for'a'n
foras	for'as
fore	for'e
foren	for'e'n
foris	for'is
foroj	for'o'j
foron	for'o'n
forbalaas	for'bala'as
forbalai	for'bala'i
forbalais	for'bala'is
forbari	for'bar'i
forbaro	for'bar'o
forbatita	for'bat'it'a
forblovas	for'blov'as
forblovis	for'blov'is
forblovita	for'blov'it'a
forbrulas	for'brul'as
forbruli	for'brul'i
forbrulis	for'brul'is
forbrulos	for'brul'os
forbruligas	for'brul'ig'as
forbruligi	for'brul'ig'i
forbruligis	for'brul'ig'is
forbruligo	for'brul'ig'o
forbruligon	for'brul'ig'o'n
forbruligita	for'brul'ig'it'a
forbruligitaj	for'brul'ig'it'a'j
forbruliĝis	for'brul'iĝ'is
forbrulinta	for'brul'int'a
fordonas	for'don'as
fordoni	for'don'i
fordonis	for'don'is
fordono	for'don'o
fordonos	for'don'os
fordonu	for'don'u
fordonus	for'don'us
fordonado	for'don'ad'o
fordonante	for'don'ant'e
fordonita	for'don'it'a
foreco	for'ec'o
forejo	for'ej'o
foresta	for'est'a
forestas	for'est'as
foresti	for'est'i
forestis	for'est'is
foresto	for'est'o
forestoj	for'est'o'j
foreston	for'est'o'n
forestos	for'est'os
forestu	for'est'u
forestado	for'est'ad'o
forestanta	for'est'ant'a
forestantaj	for'est'ant'a'j
forestanto	for'est'ant'o
forfalas	for'fal'as
forfali	for'fal'i
forfalis	for'fal'is
forfalo	for'fal'o
forfalos	for'fal'os
forfikiĝu	for'fik'iĝ'u
forfluas	for'flu'as
forfluis	for'flu'is
forfluo	for'flu'o
forflugas	for'flug'as
forflugi	for'flug'i
forflugis	for'flug'is
forflugo	for'flug'o
forflugos	for'flug'os
forfuĝas	for'fuĝ'as
forfuĝi	for'fuĝ'i
forfuĝis	for'fuĝ'is
forfuĝo	for'fuĝ'o
forgalopis	for'galop'is
forglitas	for'glit'as
forglitis	for'glit'is
forglutis	for'glut'is
forhaki	for'hak'i
forhakis	for'hak'is
forhakita	for'hak'it'a
forhakitaj	for'hak'it'a'j
foriga	for'ig'a
forigas	for'ig'as
forigi	for'ig'i
forigis	for'ig'is
forigo	for'ig'o
forigoj	for'ig'o'j
forigojn	for'ig'o'j'n
forigon	for'ig'o'n
forigos	for'ig'os
forigu	for'ig'u
forigus	for'ig'us
forigado	for'ig'ad'o
foriganta	for'ig'ant'a
forigante	for'ig'ant'e
forigata	for'ig'at'a
forigataj	for'ig'at'a'j
forigebla	for'ig'ebl'a
forigeblaj	for'ig'ebl'a'j
forigenda	for'ig'end'a
foriginta	for'ig'int'a
foriginte	for'ig'int'e
forigita	for'ig'it'a
forigitaj	for'ig'it'a'j
forigitajn	for'ig'it'a'j'n
forigitan	for'ig'it'a'n
forigite	for'ig'it'e
foriĝas	for'iĝ'as
foriĝi	for'iĝ'i
foriĝis	for'iĝ'is
foriĝo	for'iĝ'o
foriĝos	for'iĝ'os
foriĝu	for'iĝ'u
foriras	for'ir'as
foriri	for'ir'i
foriris	for'ir'is
foriro	for'ir'o
foriroj	for'ir'o'j
foriron	for'ir'o'n
foriros	for'ir'os
foriru	for'ir'u
forirus	for'ir'us
foriradis	for'ir'ad'is
forirado	for'ir'ad'o
foriranta	for'ir'ant'a
forirantaj	for'ir'ant'a'j
forirantajn	for'ir'ant'a'j'n
forirantan	for'ir'ant'a'n
forirante	for'ir'ant'e
foririgi	for'ir'ig'i
foririnta	for'ir'int'a
foririntaj	for'ir'int'a'j
foririnte	for'ir'int'e
forironta	for'ir'ont'a
forirontaj	for'ir'ont'a'j
forironte	for'ir'ont'e
forĵetas	for'ĵet'as
forĵeti	for'ĵet'i
forĵetis	for'ĵet'is
forĵeto	for'ĵet'o
forĵetos	for'ĵet'os
forĵetu	for'ĵet'u
forĵetus	for'ĵet'us
forĵetado	for'ĵet'ad'o
forĵetaĵoj	for'ĵet'aĵ'o'j
forĵetaĵojn	for'ĵet'aĵ'o'j'n
forĵetante	for'ĵet'ant'e
forĵetinte	for'ĵet'int'e
forĵetita	for'ĵet'it'a
forĵetitaj	for'ĵet'it'a'j
forĵetitan	for'ĵet'it'a'n
forĵuris	for'ĵur'is
forkaptas	for'kapt'as
forkapti	for'kapt'i
forkaptis	for'kapt'is
forkapto	for'kapt'o
forkaptoj	for'kapt'o'j
forkapton	for'kapt'o'n
forkaptita	for'kapt'it'a
forkaptitaj	for'kapt'it'a'j
forkondukas	for'konduk'as
forkonduki	for'konduk'i
forkondukis	for'konduk'is
forkonduko	for'konduk'o
forkonduku	for'konduk'u
forkondukita	for'konduk'it'a
forkonsumas	for'konsum'as
forkonsumis	for'konsum'is
forkonsumita	for'konsum'it'a
forkuras	for'kur'as
forkuri	for'kur'i
forkuris	for'kur'is
forkuro	for'kur'o
forkuron	for'kur'o'n
forkuros	for'kur'os
forkuru	for'kur'u
forkurus	for'kur'us
forkurado	for'kur'ad'o
forkurinta	for'kur'int'a
forkurintaj	for'kur'int'a'j
forlasas	for'las'as
forlasi	for'las'i
forlasis	for'las'is
forlaso	for'las'o
forlason	for'las'o'n
forlasos	for'las'os
forlasu	for'las'u
forlasus	for'las'us
forlasadis	for'las'ad'is
forlasado	for'las'ad'o
forlasanta	for'las'ant'a
forlasantaj	for'las'ant'a'j
forlasante	for'las'ant'e
forlasata	for'las'at'a
forlasinta	for'las'int'a
forlasintaj	for'las'int'a'j
forlasinte	for'las'int'e
forlasita	for'las'it'a
forlasitaj	for'las'it'a'j
forlasitajn	for'las'it'a'j'n
forlasitan	for'las'it'a'n
forlasite	for'las'it'e
forlasitoj	for'las'it'o'j
forlasiteco	for'las'it'ec'o
forlasonta	for'las'ont'a
forlavas	for'lav'as
forlavi	for'lav'i
forlavis	for'lav'is
forlavitaj	for'lav'it'a'j
forliberigu	for'liber'ig'u
forlogas	for'log'as
forlogi	for'log'i
forlogis	for'log'is
forlokita	for'lok'it'a
forlokitaj	for'lok'it'a'j
formanĝas	for'manĝ'as
formanĝi	for'manĝ'i
formanĝis	for'manĝ'is
formanĝos	for'manĝ'os
formanĝu	for'manĝ'u
formanĝita	for'manĝ'it'a
formarŝis	for'marŝ'is
formetas	for'met'as
formeti	for'met'i
formetis	for'met'is
formetu	for'met'u
formetitaj	for'met'it'a'j
formigris	for'migr'is
formortas	for'mort'as
formorti	for'mort'i
formortis	for'mort'is
formorto	for'mort'o
formortoj	for'mort'o'j
formortojn	for'mort'o'j'n
formorton	for'mort'o'n
formortos	for'mort'os
formortado	for'mort'ad'o
formortantaj	for'mort'ant'a'j
formortinta	for'mort'int'a
formortintaj	for'mort'int'a'j
formortintajn	for'mort'int'a'j'n
formovi	for'mov'i
formovis	for'mov'is
fornaĝis	for'naĝ'is
fornavigi	for'navig'i
fornego	for'neg'o
fornegoj	for'neg'o'j
fornegon	for'neg'o'n
foroferi	for'ofer'i
foroferis	for'ofer'is
forpafiĝis	for'paf'iĝ'is
forpafiĝu	for'paf'iĝ'u
forpasas	for'pas'as
forpasi	for'pas'i
forpasis	for'pas'is
forpaso	for'pas'o
forpason	for'pas'o'n
forpasos	for'pas'os
forpasinta	for'pas'int'a
forpasintaj	for'pas'int'a'j
forpasintan	for'pas'int'a'n
forpasinto	for'pas'int'o
forpasintoj	for'pas'int'o'j
forpelas	for'pel'as
forpeli	for'pel'i
forpelis	for'pel'is
forpelo	for'pel'o
forpelon	for'pel'o'n
forpelos	for'pel'os
forpelu	for'pel'u
forpelus	for'pel'us
forpelado	for'pel'ad'o
forpelante	for'pel'ant'e
forpelataj	for'pel'at'a'j
forpelita	for'pel'it'a
forpelitaj	for'pel'it'a'j
forpelito	for'pel'it'o
forpelitoj	for'pel'it'o'j
forperdo	for'perd'o
forperdon	for'perd'o'n
forpermesis	for'permes'is
forpermeso	for'permes'o
forpermeson	for'permes'o'n
forportas	for'port'as
forporti	for'port'i
forportis	for'port'is
forportos	for'port'os
forportu	for'port'u
forportante	for'port'ant'e
forportata	for'port'at'a
forportita	for'port'it'a
forportitaj	for'port'it'a'j
forprenas	for'pren'as
forpreni	for'pren'i
forprenis	for'pren'is
forpreno	for'pren'o
forprenon	for'pren'o'n
forprenos	for'pren'os
forprenu	for'pren'u
forprenus	for'pren'us
forprenante	for'pren'ant'e
forprenebla	for'pren'ebl'a
forpreneblaj	for'pren'ebl'a'j
forpreninte	for'pren'int'e
forprenita	for'pren'it'a
forprenitaj	for'pren'it'a'j
forpuŝa	for'puŝ'a
forpuŝas	for'puŝ'as
forpuŝi	for'puŝ'i
forpuŝis	for'puŝ'is
forpuŝo	for'puŝ'o
forpuŝos	for'puŝ'os
forpuŝu	for'puŝ'u
forpuŝante	for'puŝ'ant'e
forpuŝita	for'puŝ'it'a
forpuŝitaj	for'puŝ'it'a'j
forrabas	for'rab'as
forrabi	for'rab'i
forrabis	for'rab'is
forrabo	for'rab'o
forrabita	for'rab'it'a
forrabitaj	for'rab'it'a'j
forrajdis	for'rajd'is
forrapidis	for'rapid'is
forrestis	for'rest'is
forsaltis	for'salt'is
forsendas	for'send'as
forsendi	for'send'i
forsendis	for'send'is
forsendo	for'send'o
forsendos	for'send'os
forsendu	for'send'u
forsendita	for'send'it'a
forsenditaj	for'send'it'a'j
forskui	for'sku'i
forskuis	for'sku'is
forstreki	for'strek'i
forstrekis	for'strek'is
forstreku	for'strek'u
forstrekita	for'strek'it'a
forŝanceliĝis	for'ŝancel'iĝ'is
forŝiras	for'ŝir'as
forŝiri	for'ŝir'i
forŝiris	for'ŝir'is
forŝiro	for'ŝir'o
forŝirita	for'ŝir'it'a
forŝovas	for'ŝov'as
forŝovi	for'ŝov'i
forŝovis	for'ŝov'is
forŝovita	for'ŝov'it'a
forŝtelis	for'ŝtel'is
fortenas	for'ten'as
forteni	for'ten'i
fortenu	for'ten'u
fortimiga	for'tim'ig'a
fortimigas	for'tim'ig'as
fortimigi	for'tim'ig'i
fortimigis	for'tim'ig'is
fortiras	for'tir'as
fortiri	for'tir'i
fortiris	for'tir'is
fortirita	for'tir'it'a
fortranĉas	for'tranĉ'as
fortranĉi	for'tranĉ'i
fortranĉis	for'tranĉ'is
fortranĉo	for'tranĉ'o
fortranĉu	for'tranĉ'u
fortranĉante	for'tranĉ'ant'e
fortranĉita	for'tranĉ'it'a
fortranĉitaj	for'tranĉ'it'a'j
fortrenis	for'tren'is
fortrinkis	for'trink'is
forturnas	for'turn'as
forturni	for'turn'i
forturnis	for'turn'is
forturnu	for'turn'u
forturnante	for'turn'ant'e
forturniĝis	for'turn'iĝ'is
foruzas	for'uz'as
foruzi	for'uz'i
foruzis	for'uz'is
foruzo	for'uz'o
foruzos	for'uz'os
foruzu	for'uz'u
foruzado	for'uz'ad'o
foruzante	for'uz'ant'e
foruzita	for'uz'it'a
foruzitaj	for'uz'it'a'j
forvagis	for'vag'is
forvaporiĝas	for'vapor'iĝ'as
forvaporiĝi	for'vapor'iĝ'i
forvaporiĝis	for'vapor'iĝ'is
forvaporiĝo	for'vapor'iĝ'o
forvelkas	for'velk'as
forvelki	for'velk'i
forvelkis	for'velk'is
forvelkanta	for'velk'ant'a
forvelkantaj	for'velk'ant'a'j
forvelkantan	for'velk'ant'a'n
forvendi	for'vend'i
forvendis	for'vend'is
forveturas	for'vetur'as
forveturi	for'vetur'i
forveturis	for'vetur'is
forveturo	for'vetur'o
forveturon	for'vetur'o'n
forveturos	for'vetur'os
forveturu	for'vetur'u
forveturanta	for'vetur'ant'a
forveturigi	for'vetur'ig'i
forveturigis	for'vetur'ig'is
forveturinta	for'vetur'int'a
forviŝas	for'viŝ'as
forviŝi	for'viŝ'i
forviŝis	for'viŝ'is
forviŝos	for'viŝ'os
forviŝu	for'viŝ'u
forviŝado	for'viŝ'ad'o
forviŝante	for'viŝ'ant'e
forviŝiĝis	for'viŝ'iĝ'is
forviŝita	for'viŝ'it'a
forviŝitaj	for'viŝ'it'a'j
forvojaĝas	for'vojaĝ'as
forvojaĝi	for'vojaĝ'i
forvojaĝis	for'vojaĝ'is
forvojaĝo	for'vojaĝ'o
forvojaĝos	for'vojaĝ'os
foraminiferoj	foraminifer'o'j
force	forc'e
forceja	forc'ej'a
forcejaj	forc'ej'a'j
forcejo	forc'ej'o
forcejoj	forc'ej'o'j
forcejon	forc'ej'o'n
forcejefika	forc'ej'efik'a
forcejefikaj	forc'ej'efik'a'j
forcejefikgasaj	forc'ej'efik'gas'a'j
forcejgasaj	forc'ej'gas'a'j
forcejgasajn	forc'ej'gas'a'j'n
forcepso	forceps'o
forgesas	forges'as
forgesi	forges'i
forgesis	forges'is
forgeso	forges'o
forgeson	forges'o'n
forgesos	forges'os
forgesu	forges'u
forgesus	forges'us
forgesado	forges'ad'o
forgesante	forges'ant'e
forgesata	forges'at'a
forgesebla	forges'ebl'a
forgesema	forges'em'a
forgesemaj	forges'em'a'j
forgesemo	forges'em'o
forgesigas	forges'ig'as
forgesigi	forges'ig'i
forgesigis	forges'ig'is
forgesiĝas	forges'iĝ'as
forgesiĝis	forges'iĝ'is
forgesiĝos	forges'iĝ'os
forgesinta	forges'int'a
forgesinte	forges'int'e
forgesita	forges'it'a
forgesitaj	forges'it'a'j
forgesitajn	forges'it'a'j'n
forgesitan	forges'it'a'n
forĝas	forĝ'as
forĝi	forĝ'i
forĝis	forĝ'is
forĝu	forĝ'u
forĝado	forĝ'ad'o
forĝejo	forĝ'ej'o
forĝejon	forĝ'ej'o'n
forĝista	forĝ'ist'a
forĝisto	forĝ'ist'o
forĝistoj	forĝ'ist'o'j
forĝita	forĝ'it'a
forĝitaj	forĝ'it'a'j
forko	fork'o
forkoj	fork'o'j
forkojn	fork'o'j'n
forkon	fork'o'n
forkego	fork'eg'o
forkegon	fork'eg'o'n
forketo	fork'et'o
forkiĝo	fork'iĝ'o
forkoforma	fork'o'form'a
forma	form'a
formaj	form'a'j
formajn	form'a'j'n
forman	form'a'n
formas	form'as
forme	form'e
formi	form'i
formis	form'is
formo	form'o
formoj	form'o'j
formojn	form'o'j'n
formon	form'o'n
formos	form'os
formu	form'u
formus	form'us
formado	form'ad'o
formadoj	form'ad'o'j
formadon	form'ad'o'n
formaĵo	form'aĵ'o
formaĵoj	form'aĵ'o'j
formanta	form'ant'a
formantaj	form'ant'a'j
formante	form'ant'e
formanto	form'ant'o
formata	form'at'a
formataj	form'at'a'j
formatas	form'at'as
formati	form'at'i
formato	form'at'o
formatoj	form'at'o'j
formatojn	form'at'o'j'n
formaton	form'at'o'n
formigas	form'ig'as
formigi	form'ig'i
formigis	form'ig'is
formigo	form'ig'o
formigado	form'ig'ad'o
formigita	form'ig'it'a
formiĝas	form'iĝ'as
formiĝi	form'iĝ'i
formiĝis	form'iĝ'is
formigho	form'iĝ'o
formiĝo	form'iĝ'o
formiĝoj	form'iĝ'o'j
formiĝon	form'iĝ'o'n
formiĝos	form'iĝ'os
formiĝu	form'iĝ'u
formiĝus	form'iĝ'us
formiĝado	form'iĝ'ad'o
formiĝanta	form'iĝ'ant'a
formiĝantaj	form'iĝ'ant'a'j
formiĝantan	form'iĝ'ant'a'n
formiĝante	form'iĝ'ant'e
formiĝinta	form'iĝ'int'a
formiĝintaj	form'iĝ'int'a'j
formita	form'it'a
formitaj	form'it'a'j
formitajn	form'it'a'j'n
formitan	form'it'a'n
formite	form'it'e
formtranĉita	form'tranĉ'it'a
formacio	formaci'o
formacioj	formaci'o'j
formaciojn	formaci'o'j'n
formacion	formaci'o'n
formacioprocezo	formaci'o'procez'o
formala	formal'a
formalaj	formal'a'j
formalajn	formal'a'j'n
formalan	formal'a'n
formale	formal'e
formalaĵo	formal'aĵ'o
formalaĵoj	formal'aĵ'o'j
formalaĵojn	formal'aĵ'o'j'n
formaleco	formal'ec'o
formaligas	formal'ig'as
formaligi	formal'ig'i
formaligis	formal'ig'is
formaligo	formal'ig'o
formaligita	formal'ig'it'a
formaligitaj	formal'ig'it'a'j
formalisma	formal'ism'a
formalismo	formal'ism'o
formalismoj	formal'ism'o'j
formalparolmaniera	formal'parol'manier'a
formaldehido	formaldehid'o
formata	format'a
formataj	format'a'j
formatas	format'as
formati	format'i
formato	format'o
formatoj	format'o'j
formatojn	format'o'j'n
formaton	format'o'n
formatado	format'ad'o
formatadon	format'ad'o'n
formatita	format'it'a
formatitaj	format'it'a'j
formiata	formi'at'a
formiato	formi'at'o
formika	formik'a
formiko	formik'o
formikoj	formik'o'j
formikojn	formik'o'j'n
formikon	formik'o'n
formikacido	formik'acid'o
formikejo	formik'ej'o
formula	formul'a
formulas	formul'as
formuli	formul'i
formulis	formul'is
formulo	formul'o
formuloj	formul'o'j
formulojn	formul'o'j'n
formulon	formul'o'n
formulu	formul'u
formulado	formul'ad'o
formuladoj	formul'ad'o'j
formuladon	formul'ad'o'n
formulaĵoj	formul'aĵ'o'j
formularo	formul'ar'o
formularoj	formul'ar'o'j
formularojn	formul'ar'o'j'n
formularon	formul'ar'o'n
formuliĝo	formul'iĝ'o
formuliĝoj	formul'iĝ'o'j
formuliĝon	formul'iĝ'o'n
formulita	formul'it'a
formulitaj	formul'it'a'j
forna	forn'a
forno	forn'o
fornoj	forn'o'j
fornojn	forn'o'j'n
fornon	forn'o'n
forneto	forn'et'o
fornelo	fornel'o
forsta	forst'a
forstaj	forst'a'j
forsto	forst'o
forstoj	forst'o'j
forstado	forst'ad'o
forstisto	forst'ist'o
forstistoj	forst'ist'o'j
forstokulturo	forst'o'kultur'o
forstuma	forst'um'a
forstumado	forst'um'ad'o
forta	fort'a
fortaj	fort'a'j
fortajn	fort'a'j'n
fortan	fort'a'n
fortas	fort'as
forte	fort'e
forti	fort'i
fortis	fort'is
forto	fort'o
fortoj	fort'o'j
fortojn	fort'o'j'n
forton	fort'o'n
forteco	fort'ec'o
fortecon	fort'ec'o'n
fortega	fort'eg'a
fortegaj	fort'eg'a'j
fortegajn	fort'eg'a'j'n
fortegan	fort'eg'a'n
fortege	fort'eg'e
fortego	fort'eg'o
fortegulo	fort'eg'ul'o
fortiga	fort'ig'a
fortigas	fort'ig'as
fortigi	fort'ig'i
fortigis	fort'ig'is
fortigo	fort'ig'o
fortigon	fort'ig'o'n
fortigos	fort'ig'os
fortigu	fort'ig'u
fortigus	fort'ig'us
fortigado	fort'ig'ad'o
fortiganta	fort'ig'ant'a
fortigante	fort'ig'ant'e
fortigita	fort'ig'it'a
fortigitaj	fort'ig'it'a'j
fortiĝas	fort'iĝ'as
fortiĝi	fort'iĝ'i
fortiĝis	fort'iĝ'is
fortiĝo	fort'iĝ'o
fortiĝanta	fort'iĝ'ant'a
fortokampo	fort'o'kamp'o
fortokampoj	fort'o'kamp'o'j
fortokampon	fort'o'kamp'o'n
fortoniveloj	fort'o'nivel'o'j
fortostreĉo	fort'o'streĉ'o
fortostreĉoj	fort'o'streĉ'o'j
fortostreĉojn	fort'o'streĉ'o'j'n
fortostreĉon	fort'o'streĉ'o'n
fortouzo	fort'o'uz'o
fortulo	fort'ul'o
fortuloj	fort'ul'o'j
fortulon	fort'ul'o'n
fortvektoro	fort'vektor'o
fortvento	fort'vent'o
fortvola	fort'vol'a
fortepiano	fortepian'o
fortepianon	fortepian'o'n
fortika	fortik'a
fortikaj	fortik'a'j
fortikajn	fortik'a'j'n
fortikan	fortik'a'n
fortikas	fortik'as
fortike	fortik'e
fortikaĵa	fortik'aĵ'a
fortikaĵo	fortik'aĵ'o
fortikaĵoj	fortik'aĵ'o'j
fortikaĵojn	fortik'aĵ'o'j'n
fortikaĵon	fortik'aĵ'o'n
fortikaĵeto	fortik'aĵ'et'o
fortikeco	fortik'ec'o
fortikecon	fortik'ec'o'n
fortikejo	fortik'ej'o
fortikejoj	fortik'ej'o'j
fortikejojn	fortik'ej'o'j'n
fortikigas	fortik'ig'as
fortikigi	fortik'ig'i
fortikigis	fortik'ig'is
fortikigo	fortik'ig'o
fortikigita	fortik'ig'it'a
fortikigitaj	fortik'ig'it'a'j
fortreso	fortres'o
fortreson	fortres'o'n
fortuna	fortun'a
fortune	fortun'e
fortuno	fortun'o
fortunon	fortun'o'n
foruma	forum'a
forumaj	forum'a'j
forumo	forum'o
forumoj	forum'o'j
forumojn	forum'o'j'n
forumon	forum'o'n
forumano	forum'an'o
forumanoj	forum'an'o'j
forumanojn	forum'an'o'j'n
forumparto	forum'part'o
fosas	fos'as
fosi	fos'i
fosis	fos'is
foso	fos'o
foson	fos'o'n
fosos	fos'os
fosu	fos'u
fosadis	fos'ad'is
fosado	fos'ad'o
fosadoj	fos'ad'o'j
fosadon	fos'ad'o'n
fosajho	fos'aĵ'o
fosaĵo	fos'aĵ'o
fosaĵoj	fos'aĵ'o'j
fosaĵojn	fos'aĵ'o'j'n
fosaĵon	fos'aĵ'o'n
fosante	fos'ant'e
fosilo	fos'il'o
fosiloj	fos'il'o'j
fosilon	fos'il'o'n
fosita	fos'it'a
fositaj	fos'it'a'j
fosfatoj	fosf'at'o'j
fosfito	fosf'it'o
fosfolipidoj	fosf'o'lipid'o'j
fosfata	fosfat'a
fosfato	fosfat'o
fosfino	fosfin'o
fosfora	fosfor'a
fosforaj	fosfor'a'j
fosforo	fosfor'o
fosforon	fosfor'o'n
fosforacido	fosfor'acid'o
fosforiligo	fosfor'il'ig'o
fosforeska	fosforesk'a
fosgeno	fosgen'o
fosilia	fosili'a
fosiliaj	fosili'a'j
fosiliajn	fosili'a'j'n
fosilian	fosili'a'n
fosilio	fosili'o
fosilioj	fosili'o'j
fosiliojn	fosili'o'j'n
fosilion	fosili'o'n
fosilifuela	fosili'fuel'a
fosilifuelaj	fosili'fuel'a'j
fosiliigita	fosili'ig'it'a
fosiliigitaj	fosili'ig'it'a'j
fosiliindico	fosili'indic'o
fosiliindikoj	fosili'indik'o'j
fosto	fost'o
fostoj	fost'o'j
fostojn	fost'o'j'n
foston	fost'o'n
fota	fot'a
fotaj	fot'a'j
fotajn	fot'a'j'n
fotan	fot'a'n
fotas	fot'as
fote	fot'e
foti	fot'i
fotis	fot'is
foto	fot'o
fotoj	fot'o'j
fotojn	fot'o'j'n
foton	fot'o'n
fotos	fot'os
fotu	fot'u
fotado	fot'ad'o
fotadon	fot'ad'o'n
fotaĵo	fot'aĵ'o
fotaĵoj	fot'aĵ'o'j
fotaĵojn	fot'aĵ'o'j'n
fotaĵon	fot'aĵ'o'n
fotarto	fot'art'o
fotarton	fot'art'o'n
fotiĝis	fot'iĝ'is
fotila	fot'il'a
fotilo	fot'il'o
fotiloj	fot'il'o'j
fotilojn	fot'il'o'j'n
fotilon	fot'il'o'n
fotisto	fot'ist'o
fotistoj	fot'ist'o'j
fotiston	fot'ist'o'n
fotita	fot'it'a
fotitaj	fot'it'a'j
fotoalbumon	fot'o'album'o'n
fotoaparato	fot'o'aparat'o
fotoaparaton	fot'o'aparat'o'n
fotoekspozicion	fot'o'ekspozici'o'n
fotokonkurso	fot'o'konkurs'o
fotokopio	fot'o'kopi'o
fotokopion	fot'o'kopi'o'n
fotokopiilo	fot'o'kopi'il'o
fotokopiiloj	fot'o'kopi'il'o'j
fotolitografio	fot'o'litografi'o
fotomodelo	fot'o'model'o
fotomodeloj	fot'o'model'o'j
fotelo	fotel'o
foteloj	fotel'o'j
fotelojn	fotel'o'j'n
fotelon	fotel'o'n
fotoelektra	fotoelektr'a
fotografa	fotograf'a
fotografi	fotograf'i
fotografis	fotograf'is
fotografo	fotograf'o
fotografado	fotograf'ad'o
fotografaĵo	fotograf'aĵ'o
fotografaĵoj	fotograf'aĵ'o'j
fotografaĵojn	fotograf'aĵ'o'j'n
fotografaĵon	fotograf'aĵ'o'n
fotografia	fotograf'i'a
fotografiaj	fotograf'i'a'j
fotografiajn	fotograf'i'a'j'n
fotografian	fotograf'i'a'n
fotografio	fotograf'i'o
fotografioj	fotograf'i'o'j
fotografion	fotograf'i'o'n
fotografilo	fotograf'il'o
fotografilon	fotograf'il'o'n
fotografisto	fotograf'ist'o
fotokatodo	fotokatod'o
fotokemia	fotokemi'a
fotometrio	fotometr'i'o
fotona	foton'a
fotonaj	foton'a'j
fotono	foton'o
fotonoj	foton'o'j
fotonojn	foton'o'j'n
fotonon	foton'o'n
fotosinteza	fotosintez'a
fotosintezaj	fotosintez'a'j
fotosintezo	fotosintez'o
fotosintezon	fotosintez'o'n
fototropismo	fototropism'o
fotovoltaeca	fotovolta'ec'a
fotovoltaecaj	fotovolta'ec'a'j
fotovoltaecan	fotovolta'ec'a'n
fraĉjo	fraĉj'o
fraga	frag'a
fragan	frag'a'n
frago	frag'o
fragoj	frag'o'j
fragojn	frag'o'j'n
fragon	frag'o'n
fragujoj	frag'uj'o'j
fragila	fragil'a
fragilaj	fragil'a'j
fragilan	fragil'a'n
fragmenta	fragment'a
fragmentaj	fragment'a'j
fragmentajn	fragment'a'j'n
fragmentan	fragment'a'n
fragmente	fragment'e
fragmento	fragment'o
fragmentoj	fragment'o'j
fragmentojn	fragment'o'j'n
fragmenton	fragment'o'n
fragmentado	fragment'ad'o
fragmentigita	fragment'ig'it'a
fragmentiĝis	fragment'iĝ'is
fragmentiĝo	fragment'iĝ'o
fragmentiĝon	fragment'iĝ'o'n
fragmito	fragmit'o
fragmitoj	fragmit'o'j
frajo	fraj'o
frajon	fraj'o'n
frajto	frajt'o
frajton	frajt'o'n
frako	frak'o
frakoj	frak'o'j
frakasas	frakas'as
frakasi	frakas'i
frakasis	frakas'is
frakaso	frakas'o
frakasos	frakas'os
frakasu	frakas'u
frakasado	frakas'ad'o
frakasante	frakas'ant'e
frakasiĝis	frakas'iĝ'is
frakasiĝo	frakas'iĝ'o
frakasiĝos	frakas'iĝ'os
frakasita	frakas'it'a
frakasitaj	frakas'it'a'j
frakcia	frakci'a
frakcio	frakci'o
frakcioj	frakci'o'j
frakciojn	frakci'o'j'n
frakcion	frakci'o'n
frakcieca	frakci'ec'a
frakciecaj	frakci'ec'a'j
frakseno	fraksen'o
fraksenoj	fraksen'o'j
frakturo	fraktur'o
frakturoj	fraktur'o'j
frakturojn	fraktur'o'j'n
frakturon	fraktur'o'n
frama	fram'a
frame	fram'e
framo	fram'o
framoj	fram'o'j
framon	fram'o'n
framfrekvenco	fram'frekvenc'o
framasona	framason'a
framasonaj	framason'a'j
framasono	framason'o
framasonoj	framason'o'j
framasonismo	framason'ism'o
framban	framb'a'n
frambo	framb'o
framboj	framb'o'j
frambojn	framb'o'j'n
frambujoj	framb'uj'o'j
franca	franc'a
francaj	franc'a'j
francajn	franc'a'j'n
francan	franc'a'n
france	franc'e
francen	franc'e'n
franco	franc'o
francoj	franc'o'j
francojn	franc'o'j'n
francon	franc'o'n
francanoj	franc'an'o'j
francangla	franc'angl'a
francdevena	franc'de'ven'a
francgermana	franc'german'a
francia	franc'i'a
franciaj	franc'i'a'j
francio	franc'i'o
francion	franc'i'o'n
francigo	franc'ig'o
francine	franc'in'e
francino	franc'in'o
franclando	franc'land'o
franclingva	franc'lingv'a
franclingvaj	franc'lingv'a'j
franclingvajn	franc'lingv'a'j'n
franclingvan	franc'lingv'a'n
franclingve	franc'lingv'e
franclingvano	franc'lingv'an'o
franclingvanoj	franc'lingv'an'o'j
franclingvio	franc'lingv'i'o
francparolanta	franc'parol'ant'a
francparolanto	franc'parol'ant'o
francparolantoj	franc'parol'ant'o'j
francuja	franc'uj'a
francujo	franc'uj'o
francujon	franc'uj'o'n
franculoj	franc'ul'o'j
franciska	francisk'a
francisko	francisk'o
franciskon	francisk'o'n
franciskana	francisk'an'a
franciskanaj	francisk'an'a'j
franciskano	francisk'an'o
franciskanoj	francisk'an'o'j
franda	frand'a
frandas	frand'as
frandi	frand'i
frandu	frand'u
frandaĵo	frand'aĵ'o
frandaĵoj	frand'aĵ'o'j
frandaĵojn	frand'aĵ'o'j'n
frandaĵon	frand'aĵ'o'n
frandema	frand'em'a
frandemuloj	frand'em'ul'o'j
franĝo	franĝ'o
franĝoj	franĝ'o'j
franĝojn	franĝ'o'j'n
franka	frank'a
frankaj	frank'a'j
frankan	frank'a'n
franko	frank'o
frankoj	frank'o'j
frankojn	frank'o'j'n
frankon	frank'o'n
frankisma	frank'ism'a
frankismo	frank'ism'o
frankfurta	frankfurt'a
frankfurto	frankfurt'o
frankolino	frankolin'o
frankonia	frankoni'a
frankonio	frankoni'o
frapa	frap'a
frapaj	frap'a'j
frapajn	frap'a'j'n
frapan	frap'a'n
frapas	frap'as
frape	frap'e
frapi	frap'i
frapis	frap'is
frapo	frap'o
frapoj	frap'o'j
frapojn	frap'o'j'n
frapon	frap'o'n
frapos	frap'os
frapu	frap'u
frapus	frap'us
frapadis	frap'ad'is
frapado	frap'ad'o
frapadon	frap'ad'o'n
frapanta	frap'ant'a
frapantaj	frap'ant'a'j
frapante	frap'ant'e
frapata	frap'at'a
frapegis	frap'eg'is
frapetas	frap'et'as
frapeti	frap'et'i
frapetis	frap'et'is
frapeto	frap'et'o
frapetoj	frap'et'o'j
frapeton	frap'et'o'n
frapetado	frap'et'ad'o
frapetante	frap'et'ant'e
frapetita	frap'et'it'a
frapfermis	frap'ferm'is
frapfrazo	frap'fraz'o
frapiĝis	frap'iĝ'is
frapilo	frap'il'o
frapiloj	frap'il'o'j
frapinstrumento	frap'instrument'o
frapinstrumentoj	frap'instrument'o'j
frapinstrumentaro	frap'instrument'ar'o
frapinstrumentaroj	frap'instrument'ar'o'j
frapinstrumentisto	frap'instrument'ist'o
frapinstrumentistoj	frap'instrument'ist'o'j
frapinta	frap'int'a
frapinte	frap'int'e
frapita	frap'it'a
frapitaj	frap'it'a'j
frapite	frap'it'e
fraptitoloj	frap'titol'o'j
fraptitolojn	frap'titol'o'j'n
frata	frat'a
frataj	frat'a'j
fratajn	frat'a'j'n
fratan	frat'a'n
frate	frat'e
frato	frat'o
fratoj	frat'o'j
fratojn	frat'o'j'n
fraton	frat'o'n
frataro	frat'ar'o
frataroj	frat'ar'o'j
frataron	frat'ar'o'n
frateca	frat'ec'a
fratecaj	frat'ec'a'j
fratecan	frat'ec'a'n
fratece	frat'ec'e
frateco	frat'ec'o
fratecoj	frat'ec'o'j
fratecon	frat'ec'o'n
frateto	frat'et'o
frateton	frat'et'o'n
fratiĝo	frat'iĝ'o
fratina	frat'in'a
fratino	frat'in'o
fratinoj	frat'in'o'j
fratinojn	frat'in'o'j'n
fratinon	frat'in'o'n
fratinaro	frat'in'ar'o
fratinaroj	frat'in'ar'o'j
fratineto	frat'in'et'o
fratinetoj	frat'in'et'o'j
fratineton	frat'in'et'o'n
fratulo	frat'ul'o
fratuloj	frat'ul'o'j
fratulino	frat'ul'in'o
fratulinoj	frat'ul'in'o'j
fraŭda	fraŭd'a
fraŭdaj	fraŭd'a'j
fraŭdan	fraŭd'a'n
fraŭdo	fraŭd'o
fraŭdoj	fraŭd'o'j
fraŭdojn	fraŭd'o'j'n
fraŭdon	fraŭd'o'n
fraŭdulo	fraŭd'ul'o
fraŭla	fraŭl'a
fraŭlaj	fraŭl'a'j
fraŭlo	fraŭl'o
fraŭloj	fraŭl'o'j
fraŭlon	fraŭl'o'n
fraŭleco	fraŭl'ec'o
fraŭlecon	fraŭl'ec'o'n
fraŭlina	fraŭl'in'a
fraŭlino	fraŭl'in'o
fraŭlinoj	fraŭl'in'o'j
fraŭlinojn	fraŭl'in'o'j'n
fraŭlinon	fraŭl'in'o'n
fraza	fraz'a
frazaj	fraz'a'j
frazan	fraz'a'n
frazo	fraz'o
frazoj	fraz'o'j
frazojn	fraz'o'j'n
frazon	fraz'o'n
frazaro	fraz'ar'o
frazaron	fraz'ar'o'n
frazaranĝo	fraz'aranĝ'o
frazelemento	fraz'element'o
frazelementoj	fraz'element'o'j
frazenkondukilo	fraz'en'konduk'il'o
frazero	fraz'er'o
frazeroj	fraz'er'o'j
frazeto	fraz'et'o
frazetoj	fraz'et'o'j
frazetvorto	fraz'et'vort'o
frazetvortoj	fraz'et'vort'o'j
frazkomence	fraz'komenc'e
frazkonstruo	fraz'konstru'o
frazkonstruon	fraz'konstru'o'n
frazostrukturo	fraz'o'struktur'o
frazostrukturgramatikoj	fraz'o'struktur'gramatik'o'j
frazparto	fraz'part'o
frazpartoj	fraz'part'o'j
frazpartojn	fraz'part'o'j'n
frazparton	fraz'part'o'n
frazrolo	fraz'rol'o
frazroloj	fraz'rol'o'j
frazrolojn	fraz'rol'o'j'n
frazrolon	fraz'rol'o'n
frazeologio	frazeologi'o
frederiko	frederik'o
fregato	fregat'o
fregatoj	fregat'o'j
frekvenca	frekvenc'a
frekvencaj	frekvenc'a'j
frekvenco	frekvenc'o
frekvencoj	frekvenc'o'j
frekvencojn	frekvenc'o'j'n
frekvencon	frekvenc'o'n
frekvencbendo	frekvenc'bend'o
frekvencbendoj	frekvenc'bend'o'j
frekvencintervalo	frekvenc'interval'o
frekvencmodulado	frekvenc'modul'ad'o
frekvencrespondado	frekvenc'respond'ad'o
frekventas	frekvent'as
frekventi	frekvent'i
frekventis	frekvent'is
frekventado	frekvent'ad'o
frekventata	frekvent'at'a
fremda	fremd'a
fremdaj	fremd'a'j
fremdajn	fremd'a'j'n
fremdan	fremd'a'n
fremdas	fremd'as
fremde	fremd'e
fremdaĵoj	fremd'aĵ'o'j
fremdeco	fremd'ec'o
fremdigas	fremd'ig'as
fremdigi	fremd'ig'i
fremdigis	fremd'ig'is
fremdigita	fremd'ig'it'a
fremdigitaj	fremd'ig'it'a'j
fremdiĝis	fremd'iĝ'is
fremdiĝo	fremd'iĝ'o
fremdiĝon	fremd'iĝ'o'n
fremdlanda	fremd'land'a
fremdlandaj	fremd'land'a'j
fremdlandajn	fremd'land'a'j'n
fremdlandan	fremd'land'a'n
fremdlando	fremd'land'o
fremdlandano	fremd'land'an'o
fremdlandanoj	fremd'land'an'o'j
fremdlandanojn	fremd'land'an'o'j'n
fremdlingva	fremd'lingv'a
fremdlingvaj	fremd'lingv'a'j
fremdlingvajn	fremd'lingv'a'j'n
fremdlingvan	fremd'lingv'a'n
fremdlingve	fremd'lingv'e
fremdlingvo	fremd'lingv'o
fremdlingvoj	fremd'lingv'o'j
fremdlingvojn	fremd'lingv'o'j'n
fremdlingvon	fremd'lingv'o'n
fremdula	fremd'ul'a
fremdulo	fremd'ul'o
fremduloj	fremd'ul'o'j
fremdulojn	fremd'ul'o'j'n
fremdulon	fremd'ul'o'n
fremdulino	fremd'ul'in'o
fremdultrafiko	fremd'ul'trafik'o
fremdvorto	fremd'vort'o
fremdvortoj	fremd'vort'o'j
freneza	frenez'a
frenezaj	frenez'a'j
frenezajn	frenez'a'j'n
frenezan	frenez'a'n
frenezas	frenez'as
freneze	frenez'e
frenezis	frenez'is
frenezo	frenez'o
frenezon	frenez'o'n
frenezaĵo	frenez'aĵ'o
frenezaĵon	frenez'aĵ'o'n
frenezeco	frenez'ec'o
frenezecon	frenez'ec'o'n
frenezega	frenez'eg'a
frenezeta	frenez'et'a
freneziga	frenez'ig'a
frenezigas	frenez'ig'as
frenezigi	frenez'ig'i
frenezigis	frenez'ig'is
frenezigos	frenez'ig'os
freneziĝas	frenez'iĝ'as
freneziĝi	frenez'iĝ'i
freneziĝis	frenez'iĝ'is
freneziĝo	frenez'iĝ'o
freneziĝos	frenez'iĝ'os
freneziĝinta	frenez'iĝ'int'a
frenezulo	frenez'ul'o
frenezuloj	frenez'ul'o'j
frenezulojn	frenez'ul'o'j'n
frenezulon	frenez'ul'o'n
frenezulejo	frenez'ul'ej'o
frenezulejon	frenez'ul'ej'o'n
frenezulino	frenez'ul'in'o
frenologio	frenolog'i'o
fresko	fresk'o
freskoj	fresk'o'j
freskojn	fresk'o'j'n
freskon	fresk'o'n
freŝa	freŝ'a
freŝaj	freŝ'a'j
freŝajn	freŝ'a'j'n
freŝan	freŝ'a'n
freŝas	freŝ'as
freŝe	freŝ'e
freŝo	freŝ'o
freŝbakita	freŝ'bak'it'a
freŝdata	freŝ'dat'a
freŝdataj	freŝ'dat'a'j
freŝdate	freŝ'dat'e
freŝeco	freŝ'ec'o
freŝecon	freŝ'ec'o'n
freŝiga	freŝ'ig'a
freŝigis	freŝ'ig'is
frezi	frez'i
frezilo	frez'il'o
frezmaŝinoj	frez'maŝin'o'j
frida	frid'a
fridaj	frid'a'j
fridan	frid'a'n
fride	frid'e
frido	frid'o
fridigo	frid'ig'o
fridigon	frid'ig'o'n
fridigaĵo	frid'ig'aĵ'o
fridigaĵoj	frid'ig'aĵ'o'j
fridigaĵon	frid'ig'aĵ'o'n
fridigita	frid'ig'it'a
fridigitaj	frid'ig'it'a'j
fridujo	frid'uj'o
fridujoj	frid'uj'o'j
fridujojn	frid'uj'o'j'n
fridujon	frid'uj'o'n
frikativo	frikativ'o
frikativoj	frikativ'o'j
frikativojn	frikativ'o'j'n
frikativon	frikativ'o'n
fringo	fring'o
fringoj	fring'o'j
fringedoj	fring'ed'o'j
fripona	fripon'a
fripone	fripon'e
friponi	fripon'i
friponis	fripon'is
fripono	fripon'o
friponoj	fripon'o'j
friponon	fripon'o'n
friponaĵo	fripon'aĵ'o
frisa	fris'a
frisaj	fris'a'j
friso	fris'o
frisoj	fris'o'j
frislando	fris'land'o
friska	frisk'a
fritas	frit'as
friti	frit'i
fritis	frit'is
fritoj	frit'o'j
fritojn	frit'o'j'n
fritu	frit'u
fritado	frit'ad'o
fritaĵoj	frit'aĵ'o'j
fritita	frit'it'a
frititaj	frit'it'a'j
frititajn	frit'it'a'j'n
frititan	frit'it'a'n
frivola	frivol'a
frivolaj	frivol'a'j
frizejo	friz'ej'o
frizisto	friz'ist'o
friziston	friz'ist'o'n
frizistino	friz'ist'in'o
frizita	friz'it'a
froko	frok'o
fromaĝo	fromaĝ'o
fromaĝoj	fromaĝ'o'j
fromaĝojn	fromaĝ'o'j'n
fromaĝon	fromaĝ'o'n
frondo	frond'o
fronta	front'a
frontaj	front'a'j
frontan	front'a'n
frontas	front'as
fronte	front'e
fronti	front'i
frontis	front'is
fronto	front'o
frontoj	front'o'j
frontojn	front'o'j'n
fronton	front'o'n
frontos	front'os
frontu	front'u
frontanta	front'ant'a
frontantaj	front'ant'a'j
frontante	front'ant'e
frontfiguro	front'figur'o
frontliniaj	front'lini'a'j
frontlinio	front'lini'o
frontlinioj	front'lini'o'j
frontmontra	front'montr'a
frontpaĝo	front'paĝ'o
frontpordo	front'pord'o
frontulo	front'ul'o
frontuloj	front'ul'o'j
frontvico	front'vic'o
frontono	fronton'o
frontonoj	fronton'o'j
frontonon	fronton'o'n
frosta	frost'a
frostaj	frost'a'j
frostajn	frost'a'j'n
frostan	frost'a'n
frostas	frost'as
froste	frost'e
frosti	frost'i
frostis	frost'is
frosto	frost'o
frostoj	frost'o'j
froston	frost'o'n
frostos	frost'os
frostegas	frost'eg'as
frostigas	frost'ig'as
frostigi	frost'ig'i
frostigis	frost'ig'is
frostigo	frost'ig'o
frostigado	frost'ig'ad'o
frostigante	frost'ig'ant'e
frostigita	frost'ig'it'a
frostigitaj	frost'ig'it'a'j
frostigitajn	frost'ig'it'a'j'n
frostiĝas	frost'iĝ'as
frostiĝi	frost'iĝ'i
frostiĝis	frost'iĝ'is
frostiĝo	frost'iĝ'o
frostiĝado	frost'iĝ'ad'o
frostiĝanta	frost'iĝ'ant'a
frostiĝinta	frost'iĝ'int'a
frostiĝintaj	frost'iĝ'int'a'j
frostita	frost'it'a
frostopunkto	frost'o'punkt'o
frostopunktoj	frost'o'punkt'o'j
frostopunkton	frost'o'punkt'o'n
frostotremis	frost'o'trem'is
frostotremojn	frost'o'trem'o'j'n
frostpunkto	frost'punkt'o
frostujo	frost'uj'o
frota	frot'a
frotas	frot'as
froti	frot'i
frotis	frot'is
froto	frot'o
frotu	frot'u
frotado	frot'ad'o
frotadon	frot'ad'o'n
frotante	frot'ant'e
frotita	frot'it'a
frotitaj	frot'it'a'j
frotpurigilo	frot'pur'ig'il'o
frua	fru'a
fruaj	fru'a'j
fruajn	fru'a'j'n
fruan	fru'a'n
fruas	fru'as
frue	fru'e
frumatena	fru'maten'a
frumatene	fru'maten'e
frumateno	fru'maten'o
frumatura	fru'matur'a
frumaturaj	fru'matur'a'j
frutempe	fru'temp'e
frugilegoj	frugileg'o'j
frukta	frukt'a
fruktaj	frukt'a'j
fruktas	frukt'as
fruktis	frukt'is
frukto	frukt'o
fruktoj	frukt'o'j
fruktojn	frukt'o'j'n
frukton	frukt'o'n
fruktu	frukt'u
fruktarbo	frukt'arb'o
fruktarboj	frukt'arb'o'j
fruktarbojn	frukt'arb'o'j'n
fruktkarno	frukt'karn'o
fruktodona	frukt'o'don'a
fruktodonaj	frukt'o'don'a'j
fruktodonajn	frukt'o'don'a'j'n
fruktodonan	frukt'o'don'a'n
fruktodone	frukt'o'don'e
fruktodoneco	frukt'o'don'ec'o
fruktoĝardeno	frukt'o'ĝarden'o
fruktoĝardenoj	frukt'o'ĝarden'o'j
fruktoĝardenon	frukt'o'ĝarden'o'n
fruktokarno	frukt'o'karn'o
fruktoplantejoj	frukt'o'plant'ej'o'j
fruktosukoj	frukt'o'suk'o'j
fruktosukon	frukt'o'suk'o'n
fruktodoro	frukt'odor'o
fruktozo	frukt'oz'o
frunta	frunt'a
fruntaj	frunt'a'j
fruntan	frunt'a'n
frunte	frunt'e
frunto	frunt'o
fruntoj	frunt'o'j
fruntojn	frunt'o'j'n
frunton	frunt'o'n
fruntlobo	frunt'lob'o
fruntloboj	frunt'lob'o'j
frustras	frustr'as
frustranta	frustr'ant'a
frustriĝo	frustr'iĝ'o
frustriĝon	frustr'iĝ'o'n
frustrita	frustr'it'a
frustritaj	frustr'it'a'j
frustrite	frustr'it'e
frustracio	frustraci'o
frustracion	frustraci'o'n
ftizo	ftiz'o
fuela	fuel'a
fuelaj	fuel'a'j
fuelo	fuel'o
fueloj	fuel'o'j
fuelojn	fuel'o'j'n
fuelon	fuel'o'n
fuelciklo	fuel'cikl'o
fuelefika	fuel'efik'a
fuelefikaj	fuel'efik'a'j
fuelefikeco	fuel'efik'ec'o
fuelefikecon	fuel'efik'ec'o'n
fuelekonomio	fuel'ekonomi'o
fuelekonomion	fuel'ekonomi'o'n
fuelkonsumo	fuel'konsum'o
fuelkonsumon	fuel'konsum'o'n
fuelkostoj	fuel'kost'o'j
fuelpilo	fuel'pil'o
fuelpiloj	fuel'pil'o'j
fuelprezoj	fuel'prez'o'j
fugo	fug'o
fugoj	fug'o'j
fugon	fug'o'n
fuĝas	fuĝ'as
fuĝi	fuĝ'i
fuĝis	fuĝ'is
fuĝo	fuĝ'o
fuĝoj	fuĝ'o'j
fuĝon	fuĝ'o'n
fuĝu	fuĝ'u
fuĝado	fuĝ'ad'o
fuĝanta	fuĝ'ant'a
fuĝantaj	fuĝ'ant'a'j
fuĝantajn	fuĝ'ant'a'j'n
fuĝantan	fuĝ'ant'a'n
fuĝante	fuĝ'ant'e
fuĝanto	fuĝ'ant'o
fuĝantoj	fuĝ'ant'o'j
fuĝantojn	fuĝ'ant'o'j'n
fuĝigis	fuĝ'ig'is
fuĝinta	fuĝ'int'a
fuĝintaj	fuĝ'int'a'j
fuĝinto	fuĝ'int'o
fuĝintoj	fuĝ'int'o'j
fuĝintojn	fuĝ'int'o'j'n
fuko	fuk'o
fukoj	fuk'o'j
fukuŝima	fukuŝim'a
fukuŝimo	fukuŝim'o
fulerenoj	fuleren'o'j
fulga	fulg'a
fulgo	fulg'o
fulgon	fulg'o'n
fuliko	fulik'o
fulma	fulm'a
fulmas	fulm'as
fulme	fulm'e
fulmi	fulm'i
fulmis	fulm'is
fulmo	fulm'o
fulmoj	fulm'o'j
fulmojn	fulm'o'j'n
fulmon	fulm'o'n
fulmmemoro	fulm'memor'o
fulmmilito	fulm'milit'o
fulmorapida	fulm'o'rapid'a
fulmorapide	fulm'o'rapid'e
fulmotondre	fulm'o'tondr'e
fulmotondro	fulm'o'tondr'o
fulmotondroj	fulm'o'tondr'o'j
fulmotondrojn	fulm'o'tondr'o'j'n
fulmotondron	fulm'o'tondr'o'n
fulmrapida	fulm'rapid'a
fulmrapide	fulm'rapid'e
fulmtrajnoj	fulm'trajn'o'j
fuma	fum'a
fumaj	fum'a'j
fumas	fum'as
fume	fum'e
fumi	fum'i
fumis	fum'is
fumo	fum'o
fumoj	fum'o'j
fumojn	fum'o'j'n
fumon	fum'o'n
fumos	fum'os
fumu	fum'u
fumadi	fum'ad'i
fumadis	fum'ad'is
fumado	fum'ad'o
fumadon	fum'ad'o'n
fumaĵita	fum'aĵ'it'a
fumaĵitaj	fum'aĵ'it'a'j
fumanta	fum'ant'a
fumantaj	fum'ant'a'j
fumantan	fum'ant'a'n
fumante	fum'ant'e
fumanto	fum'ant'o
fumantoj	fum'ant'o'j
fumantojn	fum'ant'o'j'n
fumitaj	fum'it'a'j
fumnebulo	fum'nebul'o
fumplena	fum'plen'a
fumtubo	fum'tub'o
fumtuboj	fum'tub'o'j
fumarata	fumar'at'a
fumarato	fumar'at'o
funda	fund'a
fundaj	fund'a'j
fundajn	fund'a'j'n
fundan	fund'a'n
funde	fund'e
fundo	fund'o
fundoj	fund'o'j
fundojn	fund'o'j'n
fundon	fund'o'n
fundamenta	fundament'a
fundamentaj	fundament'a'j
fundamentajn	fundament'a'j'n
fundamentan	fundament'a'n
fundamentas	fundament'as
fundamente	fundament'e
fundamento	fundament'o
fundamentoj	fundament'o'j
fundamentojn	fundament'o'j'n
fundamenton	fundament'o'n
fundamentata	fundament'at'a
fundamentisma	fundament'ism'a
fundamentismaj	fundament'ism'a'j
fundamentismo	fundament'ism'o
fundamentistoj	fundament'ist'o'j
fundamentita	fundament'it'a
funebra	funebr'a
funebraj	funebr'a'j
funebrajn	funebr'a'j'n
funebran	funebr'a'n
funebras	funebr'as
funebre	funebr'e
funebri	funebr'i
funebris	funebr'is
funebro	funebr'o
funebroj	funebr'o'j
funebron	funebr'o'n
funebrado	funebr'ad'o
funebraĵo	funebr'aĵ'o
funebraĵoj	funebr'aĵ'o'j
funebranta	funebr'ant'a
funebrante	funebr'ant'e
funebrantoj	funebr'ant'o'j
funelo	funel'o
funeloj	funel'o'j
funelon	funel'o'n
funga	fung'a
fungaj	fung'a'j
fungo	fung'o
fungoj	fung'o'j
fungojn	fung'o'j'n
fungon	fung'o'n
funikularo	funikular'o
funikularoj	funikular'o'j
funkcia	funkci'a
funkciaj	funkci'a'j
funkciajn	funkci'a'j'n
funkcian	funkci'a'n
funkcias	funkci'as
funkcie	funkci'e
funkcii	funkci'i
funkciis	funkci'is
funkcio	funkci'o
funkcioj	funkci'o'j
funkciojn	funkci'o'j'n
funkcion	funkci'o'n
funkcios	funkci'os
funkciu	funkci'u
funkcius	funkci'us
funkciado	funkci'ad'o
funkciadoj	funkci'ad'o'j
funkciadon	funkci'ad'o'n
funkcianta	funkci'ant'a
funkciantaj	funkci'ant'a'j
funkciantajn	funkci'ant'a'j'n
funkciantan	funkci'ant'a'n
funkciante	funkci'ant'e
funkcieco	funkci'ec'o
funkciecoj	funkci'ec'o'j
funkciecon	funkci'ec'o'n
funkciiga	funkci'ig'a
funkciigaj	funkci'ig'a'j
funkciigajn	funkci'ig'a'j'n
funkciigan	funkci'ig'a'n
funkciigas	funkci'ig'as
funkciigi	funkci'ig'i
funkciigis	funkci'ig'is
funkciigo	funkci'ig'o
funkciigon	funkci'ig'o'n
funkciigos	funkci'ig'os
funkciigu	funkci'ig'u
funkciigus	funkci'ig'us
funkciigado	funkci'ig'ad'o
funkciigadkostoj	funkci'ig'ad'kost'o'j
funkciigadkostojn	funkci'ig'ad'kost'o'j'n
funkciiganta	funkci'ig'ant'a
funkciigantaj	funkci'ig'ant'a'j
funkciigantajn	funkci'ig'ant'a'j'n
funkciigante	funkci'ig'ant'e
funkciigata	funkci'ig'at'a
funkciigataj	funkci'ig'at'a'j
funkciigisto	funkci'ig'ist'o
funkciigistoj	funkci'ig'ist'o'j
funkciigistojn	funkci'ig'ist'o'j'n
funkciigiston	funkci'ig'ist'o'n
funkciigita	funkci'ig'it'a
funkciigitaj	funkci'ig'it'a'j
funkciigitajn	funkci'ig'it'a'j'n
funkciigitan	funkci'ig'it'a'n
funkciigite	funkci'ig'it'e
funkciinta	funkci'int'a
funkciismo	funkci'ism'o
funkciita	funkci'it'a
funkciitaj	funkci'it'a'j
funkciserva	funkci'serv'a
funkciservaj	funkci'serv'a'j
funkciservajn	funkci'serv'a'j'n
funkciservan	funkci'serv'a'n
funkciulo	funkci'ul'o
funkciuloj	funkci'ul'o'j
funkciulojn	funkci'ul'o'j'n
funkciulon	funkci'ul'o'n
funkcionala	funkcional'a
funto	funt'o
funtoj	funt'o'j
funtojn	funt'o'j'n
funton	funt'o'n
fuorto	fuort'o
fuortoj	fuort'o'j
furaĝa	furaĝ'a
furaĝaj	furaĝ'a'j
furaĝas	furaĝ'as
furaĝi	furaĝ'i
furaĝo	furaĝ'o
furaĝoj	furaĝ'o'j
furaĝojn	furaĝ'o'j'n
furaĝon	furaĝ'o'n
furaĝado	furaĝ'ad'o
furaĝante	furaĝ'ant'e
furaĝistoj	furaĝ'ist'o'j
furfuralo	furfural'o
furioza	furioz'a
furiozaj	furioz'a'j
furiozajn	furioz'a'j'n
furiozan	furioz'a'n
furiozas	furioz'as
furioze	furioz'e
furiozi	furioz'i
furiozis	furioz'is
furiozo	furioz'o
furiozon	furioz'o'n
furiozus	furioz'us
furiozado	furioz'ad'o
furiozanta	furioz'ant'a
furiozeco	furioz'ec'o
furiozigas	furioz'ig'as
furiozigis	furioz'ig'is
furiozigita	furioz'ig'it'a
furioziĝis	furioz'iĝ'is
furora	furor'a
furoraj	furor'a'j
furoran	furor'a'n
furoras	furor'as
furoris	furor'is
furoro	furor'o
furoron	furor'o'n
furoraĵo	furor'aĵ'o
furoramas	furor'am'as
furoranta	furor'ant'a
furorkanto	furor'kant'o
furorlibro	furor'libr'o
furorlibroj	furor'libr'o'j
furorlisto	furor'list'o
furorlistoj	furor'list'o'j
furorliston	furor'list'o'n
furzas	furz'as
furzis	furz'is
furzo	furz'o
furzoj	furz'o'j
fusilo	fusil'o
fusiloj	fusil'o'j
fusilojn	fusil'o'j'n
fusilon	fusil'o'n
fusto	fust'o
fuŝa	fuŝ'a
fuŝaj	fuŝ'a'j
fuŝan	fuŝ'a'n
fuŝas	fuŝ'as
fuŝe	fuŝ'e
fuŝi	fuŝ'i
fuŝis	fuŝ'is
fuŝo	fuŝ'o
fuŝoj	fuŝ'o'j
fuŝojn	fuŝ'o'j'n
fuŝon	fuŝ'o'n
fuŝos	fuŝ'os
fuŝu	fuŝ'u
fuŝado	fuŝ'ad'o
fuŝaĵo	fuŝ'aĵ'o
fuŝaĵoj	fuŝ'aĵ'o'j
fuŝaĵojn	fuŝ'aĵ'o'j'n
fuŝaĵon	fuŝ'aĵ'o'n
fuŝiĝas	fuŝ'iĝ'as
fuŝiĝis	fuŝ'iĝ'is
fuŝita	fuŝ'it'a
fuŝitaj	fuŝ'it'a'j
fuŝkontakto	fuŝ'kontakt'o
fuŝkontakton	fuŝ'kontakt'o'n
fuŝkontaktigi	fuŝ'kontakt'ig'i
fuŝkontaktigu	fuŝ'kontakt'ig'u
fuŝulo	fuŝ'ul'o
fuŝuloj	fuŝ'ul'o'j
futo	fut'o
futoj	fut'o'j
futojn	fut'o'j'n
futbala	futbal'a
futbalaj	futbal'a'j
futbalajn	futbal'a'j'n
futbalan	futbal'a'n
futbalas	futbal'as
futbalis	futbal'is
futbalo	futbal'o
futbaloj	futbal'o'j
futbalon	futbal'o'n
futbalado	futbal'ad'o
futbalisto	futbal'ist'o
futbalistoj	futbal'ist'o'j
futbalklubo	futbal'klub'o
futbalmatĉo	futbal'matĉ'o
futbalteamo	futbal'team'o
futbalteamoj	futbal'team'o'j
futura	futur'a
futuraj	futur'a'j
future	futur'e
futuro	futur'o
futuron	futur'o'n
futuraĵoj	futur'aĵ'o'j
futuraĵojn	futur'aĵ'o'j'n
futureca	futur'ec'a
futurecaj	futur'ec'a'j
futurisma	futur'ism'a
futuristoj	futur'ist'o'j
futurologio	futur'olog'i'o
fuzaĵo	fuz'aĵ'o
fuzaĵoj	fuz'aĵ'o'j
fuzaĵojn	fuz'aĵ'o'j'n
fuzaĵon	fuz'aĵ'o'n
fuzeo	fuze'o
fuzeoj	fuze'o'j
fuzeon	fuze'o'n
fuzelaĝo	fuzelaĝ'o
fuzelaĝon	fuzelaĝ'o'n
fuzia	fuzi'a
fuziaj	fuzi'a'j
fuzio	fuzi'o
fuzioj	fuzi'o'j
fuzion	fuzi'o'n
fuziado	fuzi'ad'o
fuziofuelo	fuzi'o'fuel'o
fuzioprocesoj	fuzi'o'proces'o'j