gabona	gabon'a
gabono	gabon'o
gabriela	gabriel'a
gabrielo	gabriel'o
gado	gad'o
gaja	gaj'a
gajaj	gaj'a'j
gajajn	gaj'a'j'n
gajan	gaj'a'n
gajas	gaj'as
gaje	gaj'e
gaji	gaj'i
gajis	gaj'is
gajo	gaj'o
gajon	gaj'o'n
gaju	gaj'u
gajeco	gaj'ec'o
gajecon	gaj'ec'o'n
gajega	gaj'eg'a
gajhumora	gaj'humor'a
gajiga	gaj'ig'a
gajigas	gaj'ig'as
gajigi	gaj'ig'i
gajigis	gaj'ig'is
gajiĝis	gaj'iĝ'is
gajna	gajn'a
gajnan	gajn'a'n
gajnas	gajn'as
gajni	gajn'i
gajnis	gajn'is
gajno	gajn'o
gajnoj	gajn'o'j
gajnojn	gajn'o'j'n
gajnon	gajn'o'n
gajnos	gajn'os
gajnu	gajn'u
gajnus	gajn'us
gajnado	gajn'ad'o
gajnanta	gajn'ant'a
gajnantaj	gajn'ant'a'j
gajnante	gajn'ant'e
gajnanto	gajn'ant'o
gajnantoj	gajn'ant'o'j
gajnigis	gajn'ig'is
gajninta	gajn'int'a
gajnintaj	gajn'int'a'j
gajninte	gajn'int'e
gajninto	gajn'int'o
gajnintoj	gajn'int'o'j
gajnintojn	gajn'int'o'j'n
gajninton	gajn'int'o'n
gajnita	gajn'it'a
gajnitaj	gajn'it'a'j
gajnitan	gajn'it'a'n
gaku	gak'u
gala	gal'a
gale	gal'e
galo	gal'o
galon	gal'o'n
galacidoj	gal'acid'o'j
galveziko	gal'vezik'o
galaksia	galaksi'a
galaksiaj	galaksi'a'j
galaksian	galaksi'a'n
galaksio	galaksi'o
galaksioj	galaksi'o'j
galaksiojn	galaksi'o'j'n
galaksion	galaksi'o'n
galanta	galant'a
galante	galant'e
galapaga	galapag'a
galapagoj	galapag'o'j
galapagos	galapag'os
galata	galat'a
galateo	galate'o
galega	galeg'a
galegan	galeg'a'n
galego	galeg'o
galegoj	galeg'o'j
galegio	galeg'i'o
galeno	galen'o
galeran	galer'a'n
galero	galer'o
galeroj	galer'o'j
galeranon	galer'an'o'n
galeria	galeri'a
galerio	galeri'o
galerioj	galeri'o'j
galeriojn	galeri'o'j'n
galerion	galeri'o'n
galia	gali'a
galio	gali'o
galicio	galici'o
galilea	galile'a
galileo	galile'o
galileon	galile'o'n
galilejo	galilej'o
galimatio	galimati'o
galinago	galinag'o
galionoj	galion'o'j
galono	galon'o
galonoj	galon'o'j
galopas	galop'as
galope	galop'e
galopi	galop'i
galopis	galop'is
galopo	galop'o
galopado	galop'ad'o
galopanta	galop'ant'a
galoŝoj	galoŝ'o'j
galoŝojn	galoŝ'o'j'n
galvani	galvan'i
galvanizis	galvan'iz'is
galvanizado	galvan'iz'ad'o
galvanizita	galvan'iz'it'a
gama	gam'a
gamaj	gam'a'j
game	gam'e
gamo	gam'o
gamoj	gam'o'j
gamojn	gam'o'j'n
gamon	gam'o'n
gamafunkcio	gam'a'funkci'o
gamaradioj	gam'a'radi'o'j
gamaradiojn	gam'a'radi'o'j'n
gamaradiado	gam'a'radi'ad'o
gamoradia	gam'o'radi'a
gamoradiaj	gam'o'radi'a'j
gamaŝoj	gamaŝ'o'j
gamba	gamb'a
gambo	gamb'o
gamboj	gamb'o'j
gambojn	gamb'o'j'n
gambon	gamb'o'n
gambio	gambi'o
gamelano	gamelan'o
gameto	gamet'o
gametoj	gamet'o'j
gametojn	gamet'o'j'n
gametofito	gametofit'o
ganaa	gana'a
ganao	gana'o
ganga	gang'a
gango	gang'o
ganglio	gangli'o
ganglioj	gangli'o'j
ganglioĉeloj	gangli'o'ĉel'o'j
gangreno	gangren'o
ganto	gant'o
gantoj	gant'o'j
gantojn	gant'o'j'n
ganton	gant'o'n
gapas	gap'as
gape	gap'e
gapi	gap'i
gapis	gap'is
gapado	gap'ad'o
gapantaj	gap'ant'a'j
gapante	gap'ant'e
garaĝa	garaĝ'a
garaĝo	garaĝ'o
garaĝon	garaĝ'o'n
garaĝita	garaĝ'it'a
garantia	garanti'a
garantiaj	garanti'a'j
garantian	garanti'a'n
garantias	garanti'as
garantii	garanti'i
garantiis	garanti'is
garantio	garanti'o
garantioj	garanti'o'j
garantiojn	garanti'o'j'n
garantion	garanti'o'n
garantios	garanti'os
garantiu	garanti'u
garantius	garanti'us
garantiado	garanti'ad'o
garantiaĵo	garanti'aĵ'o
garantiaĵon	garanti'aĵ'o'n
garantianta	garanti'ant'a
garantiante	garanti'ant'e
garantianto	garanti'ant'o
garantiata	garanti'at'a
garantiataj	garanti'at'a'j
garantiita	garanti'it'a
garantiitaj	garanti'it'a'j
garantiitan	garanti'it'a'n
garantiuloj	garanti'ul'o'j
garba	garb'a
garbo	garb'o
garboj	garb'o'j
garbojn	garb'o'j'n
garbon	garb'o'n
garbejo	garb'ej'o
garbejoj	garb'ej'o'j
garbejon	garb'ej'o'n
garda	gard'a
gardas	gard'as
garde	gard'e
gardi	gard'i
gardis	gard'is
gardo	gard'o
gardon	gard'o'n
gardos	gard'os
gardu	gard'u
gardus	gard'us
gardadis	gard'ad'is
gardado	gard'ad'o
gardadoj	gard'ad'o'j
gardadon	gard'ad'o'n
gardanĝelo	gard'anĝel'o
gardanta	gard'ant'a
gardantaj	gard'ant'a'j
gardante	gard'ant'e
gardanto	gard'ant'o
gardantoj	gard'ant'o'j
gardantojn	gard'ant'o'j'n
gardata	gard'at'a
gardataj	gard'at'a'j
gardejo	gard'ej'o
gardema	gard'em'a
gardeme	gard'em'e
gardemo	gard'em'o
gardista	gard'ist'a
gardisto	gard'ist'o
gardistoj	gard'ist'o'j
gardistojn	gard'ist'o'j'n
gardiston	gard'ist'o'n
gardistaro	gard'ist'ar'o
gardistaron	gard'ist'ar'o'n
gardistejo	gard'ist'ej'o
gardistharoj	gard'ist'har'o'j
gardita	gard'it'a
garditaj	gard'it'a'j
gardohundoj	gard'o'hund'o'j
gardostaras	gard'o'star'as
gardostaris	gard'o'star'is
gardostaranto	gard'o'star'ant'o
gardostarantoj	gard'o'star'ant'o'j
gardoturo	gard'o'tur'o
gardoturoj	gard'o'tur'o'j
gargari	gargar'i
gargojloj	gargojl'o'j
garnas	garn'as
garnis	garn'is
garnaĵo	garn'aĵ'o
garnita	garn'it'a
garnitaj	garn'it'a'j
garnituro	garnitur'o
garnizona	garnizon'a
garnizono	garnizon'o
garnizonoj	garnizon'o'j
garnizonojn	garnizon'o'j'n
garnizonon	garnizon'o'n
garnizonanta	garnizon'ant'a
garnizonantoj	garnizon'ant'o'j
garolo	garol'o
garoloj	garol'o'j
gasa	gas'a
gasaj	gas'a'j
gasajn	gas'a'j'n
gasan	gas'a'n
gasas	gas'as
gaso	gas'o
gasoj	gas'o'j
gasojn	gas'o'j'n
gason	gas'o'n
gasĉambroj	gas'ĉambr'o'j
gasdukto	gas'dukt'o
gasgeneratoro	gas'generator'o
gasgigantoj	gas'gigant'o'j
gasigado	gas'ig'ad'o
gasinterŝanĝo	gas'inter'ŝanĝ'o
gaskuŝejoj	gas'kuŝ'ej'o'j
gasmaskoj	gas'mask'o'j
gasminejoj	gas'min'ej'o'j
gasmolekuloj	gas'molekul'o'j
gasodukto	gas'o'dukt'o
gasohava	gas'o'hav'a
gasokondensata	gas'o'kondens'at'a
gasokondensataj	gas'o'kondens'at'a'j
gasonafta	gas'o'naft'a
gaspremo	gas'prem'o
gasturbino	gas'turbin'o
gasturbinoj	gas'turbin'o'j
gasvezikoj	gas'vezik'o'j
gaskono	gaskon'o
gaskonio	gaskon'i'o
gasparo	gaspar'o
gasparon	gaspar'o'n
gasta	gast'a
gastas	gast'as
gaste	gast'e
gasti	gast'i
gastis	gast'is
gasto	gast'o
gastoj	gast'o'j
gastojn	gast'o'j'n
gaston	gast'o'n
gastos	gast'os
gastado	gast'ad'o
gastama	gast'am'a
gastamaj	gast'am'a'j
gastaman	gast'am'a'n
gastame	gast'am'e
gastamo	gast'am'o
gastamon	gast'am'o'n
gastameco	gast'am'ec'o
gastejo	gast'ej'o
gastejoj	gast'ej'o'j
gastejojn	gast'ej'o'j'n
gastejon	gast'ej'o'n
gastejestro	gast'ej'estr'o
gastejestrino	gast'ej'estr'in'o
gastema	gast'em'a
gastiga	gast'ig'a
gastigaj	gast'ig'a'j
gastigan	gast'ig'a'n
gastigas	gast'ig'as
gastigi	gast'ig'i
gastigis	gast'ig'is
gastigo	gast'ig'o
gastigos	gast'ig'os
gastigado	gast'ig'ad'o
gastigadon	gast'ig'ad'o'n
gastiganta	gast'ig'ant'a
gastigantaj	gast'ig'ant'a'j
gastigantan	gast'ig'ant'a'n
gastigante	gast'ig'ant'e
gastiganto	gast'ig'ant'o
gastigantoj	gast'ig'ant'o'j
gastigantojn	gast'ig'ant'o'j'n
gastiganton	gast'ig'ant'o'n
gastigantino	gast'ig'ant'in'o
gastigantplanto	gast'ig'ant'plant'o
gastigata	gast'ig'at'a
gastigataj	gast'ig'at'a'j
gastigemo	gast'ig'em'o
gastigita	gast'ig'it'a
gastigitaj	gast'ig'it'a'j
gastignacio	gast'ig'naci'o
gastino	gast'in'o
gastinon	gast'in'o'n
gastlaboristoj	gast'labor'ist'o'j
gastlaboristojn	gast'labor'ist'o'j'n
gastlibro	gast'libr'o
gastoĉambro	gast'o'ĉambr'o
gastoĉambron	gast'o'ĉambr'o'n
gastono	gaston'o
gastra	gastr'a
gastrointesta	gastr'o'intest'a
gastrointestaj	gastr'o'intest'a'j
gastrointestajn	gastr'o'intest'a'j'n
gastronomia	gastronom'i'a
gastronomiaj	gastronom'i'a'j
gastronomio	gastronom'i'o
gastropodoj	gastropod'o'j
gaŭĉo	gaŭĉ'o
gaŭĉoj	gaŭĉ'o'j
gaŭsa	gaŭs'a
gaza	gaz'a
gazan	gaz'a'n
gazo	gaz'o
gazaa	gaza'a
gazao	gaza'o
gazaon	gaza'o'n
gazalo	gazal'o
gazelo	gazel'o
gazeloj	gazel'o'j
gazeta	gazet'a
gazetaj	gazet'a'j
gazetajn	gazet'a'j'n
gazetan	gazet'a'n
gazete	gazet'e
gazeto	gazet'o
gazetoj	gazet'o'j
gazetojn	gazet'o'j'n
gazeton	gazet'o'n
gazetara	gazet'ar'a
gazetaraj	gazet'ar'a'j
gazetarajn	gazet'ar'a'j'n
gazetaran	gazet'ar'a'n
gazetaro	gazet'ar'o
gazetaroj	gazet'ar'o'j
gazetarojn	gazet'ar'o'j'n
gazetaron	gazet'ar'o'n
gazetartikolo	gazet'artikol'o
gazetartikoloj	gazet'artikol'o'j
gazetartikolojn	gazet'artikol'o'j'n
gazetisto	gazet'ist'o
gazetistoj	gazet'ist'o'j
gazono	gazon'o
gazonoj	gazon'o'j
gazonon	gazon'o'n
gazontondilo	gazon'tond'il'o
gazontondiloj	gazon'tond'il'o'j
gdansko	gdansk'o
gea	ge'a
geo	ge'o
geaktoroj	ge'aktor'o'j
geaktorojn	ge'aktor'o'j'n
geamantoj	ge'am'ant'o'j
geamantojn	ge'am'ant'o'j'n
geamikoj	ge'amik'o'j
geamikojn	ge'amik'o'j'n
geamikiĝo	ge'amik'iĝ'o
geastronomoj	ge'astronom'o'j
geaŭskultantoj	ge'aŭskult'ant'o'j
geavoj	ge'av'o'j
geavojn	ge'av'o'j'n
gecivitanoj	ge'civit'an'o'j
gedioj	ge'di'o'j
geedza	ge'edz'a
geedzaj	ge'edz'a'j
geedzajn	ge'edz'a'j'n
geedzan	ge'edz'a'n
geedzo	ge'edz'o
geedzoj	ge'edz'o'j
geedzojn	ge'edz'o'j'n
geedzon	ge'edz'o'n
geedzeca	ge'edz'ec'a
geedzeco	ge'edz'ec'o
geedzecoj	ge'edz'ec'o'j
geedzecon	ge'edz'ec'o'n
geedzeckontrakto	ge'edz'ec'kontrakt'o
geedzigo	ge'edz'ig'o
geedzigha	ge'edz'iĝ'a
geedziĝa	ge'edz'iĝ'a
geedziĝaj	ge'edz'iĝ'a'j
geedziĝan	ge'edz'iĝ'a'n
geedziĝas	ge'edz'iĝ'as
geedziĝi	ge'edz'iĝ'i
geedziĝis	ge'edz'iĝ'is
geedzigho	ge'edz'iĝ'o
geedziĝo	ge'edz'iĝ'o
geedziĝoj	ge'edz'iĝ'o'j
geedziĝojn	ge'edz'iĝ'o'j'n
geedziĝon	ge'edz'iĝ'o'n
geedziĝos	ge'edz'iĝ'os
geedziĝu	ge'edz'iĝ'u
geedziĝus	ge'edz'iĝ'us
geedziĝado	ge'edz'iĝ'ad'o
geedziĝante	ge'edz'iĝ'ant'e
geedziĝfesto	ge'edz'iĝ'fest'o
geedziĝinta	ge'edz'iĝ'int'a
geedziĝintaj	ge'edz'iĝ'int'a'j
geedzita	ge'edz'it'a
geedzitaj	ge'edz'it'a'j
geesperantistoj	ge'esperant'ist'o'j
geesperantistojn	ge'esperant'ist'o'j'n
gefamilianoj	ge'famili'an'o'j
gefianĉoj	ge'fianĉ'o'j
gefianĉiĝo	ge'fianĉ'iĝ'o
gefianĉiĝon	ge'fianĉ'iĝ'o'n
gefilo	ge'fil'o
gefiloj	ge'fil'o'j
gefilojn	ge'fil'o'j'n
gefilon	ge'fil'o'n
gefrata	ge'frat'a
gefrato	ge'frat'o
gefratoj	ge'frat'o'j
gefratojn	ge'frat'o'j'n
gefraŭloj	ge'fraŭl'o'j
gegejoj	ge'gej'o'j
gehomoj	ge'hom'o'j
geinfanoj	ge'infan'o'j
geinfanojn	ge'infan'o'j'n
geinstruistoj	ge'instru'ist'o'j
gejunuloj	ge'jun'ul'o'j
gejunulojn	ge'jun'ul'o'j'n
gekamaradoj	ge'kamarad'o'j
gekantistoj	ge'kant'ist'o'j
geknaba	ge'knab'a
geknaboj	ge'knab'o'j
geknabojn	ge'knab'o'j'n
gekokoj	ge'kok'o'j
gekolegoj	ge'koleg'o'j
gekongresanoj	ge'kongres'an'o'j
gekursanoj	ge'kurs'an'o'j
gekuzoj	ge'kuz'o'j
gelegantoj	ge'leg'ant'o'j
gelernantoj	ge'lern'ant'o'j
gelernantojn	ge'lern'ant'o'j'n
gemaljunuloj	ge'mal'jun'ul'o'j
gemastroj	ge'mastr'o'j
genepoj	ge'nep'o'j
genepojn	ge'nep'o'j'n
genevoj	ge'nev'o'j
geonkloj	ge'onkl'o'j
georfoj	ge'orf'o'j
geparencoj	ge'parenc'o'j
gepatra	ge'patr'a
gepatraj	ge'patr'a'j
gepatrajn	ge'patr'a'j'n
gepatran	ge'patr'a'n
gepatro	ge'patr'o
gepatroj	ge'patr'o'j
gepatrojn	ge'patr'o'j'n
gepatron	ge'patr'o'n
gepatralingva	ge'patr'a'lingv'a
gepatralingve	ge'patr'a'lingv'e
gepatreco	ge'patr'ec'o
gepatrorajto	ge'patr'o'rajt'o
gepatrorajton	ge'patr'o'rajt'o'n
gereĝoj	ge'reĝ'o'j
gereligiuloj	ge'religi'ul'o'j
gesamideanoj	ge'sam'ide'an'o'j
geservistoj	ge'serv'ist'o'j
gesinjoroj	ge'sinjor'o'j
gesinjorojn	ge'sinjor'o'j'n
geskoltoj	ge'skolt'o'j
geskoltojn	ge'skolt'o'j'n
gestudentoj	ge'student'o'j
gestudentojn	ge'student'o'j'n
geviroj	ge'vir'o'j
geja	gej'a
gejaj	gej'a'j
gejajn	gej'a'j'n
gejan	gej'a'n
gejas	gej'as
gejo	gej'o
gejoj	gej'o'j
gejojn	gej'o'j'n
gejon	gej'o'n
gejeco	gej'ec'o
gejerotiko	gej'erotik'o
gejseroj	gejser'o'j
gekoj	gek'o'j
gelateno	gelaten'o
gemo	gem'o
gemoj	gem'o'j
gemojn	gem'o'j'n
gemon	gem'o'n
gena	gen'a
genaj	gen'a'j
genan	gen'a'n
gene	gen'e
geni	gen'i
geno	gen'o
genoj	gen'o'j
genojn	gen'o'j'n
genon	gen'o'n
genaro	gen'ar'o
genaroj	gen'ar'o'j
genarojn	gen'ar'o'j'n
genaron	gen'ar'o'n
genfluo	gen'flu'o
genlinio	gen'lini'o
genlinioj	gen'lini'o'j
genliniojn	gen'lini'o'j'n
genlinion	gen'lini'o'n
genprovizo	gen'proviz'o
gentekniko	gen'teknik'o
genterapio	gen'terapi'o
gentestado	gen'test'ad'o
gentipo	gen'tip'o
gentipoj	gen'tip'o'j
gentransdono	gen'trans'don'o
gentransigo	gen'trans'ig'o
genealogoj	genealog'o'j
genealogia	genealog'i'a
genealogiaj	genealog'i'a'j
genealogian	genealog'i'a'n
genealogio	genealog'i'o
genealogioj	genealog'i'o'j
genealogiojn	genealog'i'o'j'n
genealogion	genealog'i'o'n
genera	gener'a
generaj	gener'a'j
generajn	gener'a'j'n
generan	gener'a'n
generas	gener'as
genere	gener'e
generi	gener'i
generis	gener'is
genero	gener'o
generos	gener'os
generus	gener'us
generado	gener'ad'o
generadon	gener'ad'o'n
generanta	gener'ant'a
generantaj	gener'ant'a'j
generante	gener'ant'e
generanto	gener'ant'o
generata	gener'at'a
generilo	gener'il'o
generiloj	gener'il'o'j
generinto	gener'int'o
generita	gener'it'a
generitaj	gener'it'a'j
generitajn	gener'it'a'j'n
generitan	gener'it'a'n
generite	gener'it'e
generacia	generaci'a
generaciaj	generaci'a'j
generacian	generaci'a'n
generacio	generaci'o
generacioj	generaci'o'j
generaciojn	generaci'o'j'n
generacion	generaci'o'n
generala	general'a
generalan	general'a'n
generale	general'e
generalo	general'o
generaloj	general'o'j
generalojn	general'o'j'n
generalon	general'o'n
generaldirektoro	general'direktor'o
generalinspektoro	general'inspektor'o
generalleŭtenanto	general'leŭtenant'o
generalmajoro	general'major'o
generalsekretario	general'sekretari'o
generaluzo	general'uz'o
generatoro	generator'o
generatoroj	generator'o'j
generatorojn	generator'o'j'n
generatoron	generator'o'n
genetika	genetik'a
genetikaj	genetik'a'j
genetikajn	genetik'a'j'n
genetikan	genetik'a'n
genetike	genetik'e
genetiko	genetik'o
genetikon	genetik'o'n
genetikistoj	genetik'ist'o'j
genetikuloj	genetik'ul'o'j
genezo	genez'o
genezon	genez'o'n
genia	geni'a
geniaj	geni'a'j
geniajn	geni'a'j'n
genian	geni'a'n
genie	geni'e
genio	geni'o
genioj	geni'o'j
genion	geni'o'n
genieco	geni'ec'o
geniecon	geni'ec'o'n
geniulo	geni'ul'o
geniuloj	geni'ul'o'j
geniulon	geni'ul'o'n
genitala	genital'a
genitalan	genital'a'n
genitaloj	genital'o'j
genitalojn	genital'o'j'n
genitiva	genitiv'a
genitivo	genitiv'o
genitivon	genitiv'o'n
genitivkazo	genitiv'kaz'o
genocida	genocid'a
genocide	genocid'e
genocido	genocid'o
genocidoj	genocid'o'j
genocidon	genocid'o'n
genoma	genom'a
genomo	genom'o
genra	genr'a
genraj	genr'a'j
genran	genr'a'n
genro	genr'o
genroj	genr'o'j
genrojn	genr'o'j'n
genron	genr'o'n
genronomo	genr'o'nom'o
genta	gent'a
gentaj	gent'a'j
gentan	gent'a'n
gento	gent'o
gentoj	gent'o'j
gentojn	gent'o'j'n
genton	gent'o'n
gentnomo	gent'nom'o
genua	genu'a
genuas	genu'as
genue	genu'e
genuis	genu'is
genuo	genu'o
genuoj	genu'o'j
genuojn	genu'o'j'n
genuon	genu'o'n
genuanta	genu'ant'a
genuante	genu'ant'e
genufleksis	genu'fleks'is
genuiĝi	genu'iĝ'i
genuiĝis	genu'iĝ'is
geodezia	geodezi'a
geodeziaj	geodezi'a'j
geodezio	geodezi'o
geodeziisto	geodezi'ist'o
geodeziistoj	geodezi'ist'o'j
geofiksa	geofiks'a
geofizika	geofizik'a
geofizikaj	geofizik'a'j
geofiziko	geofizik'o
geografo	geograf'o
geografoj	geograf'o'j
geografia	geograf'i'a
geografiaj	geograf'i'a'j
geografiajn	geograf'i'a'j'n
geografian	geograf'i'a'n
geografie	geograf'i'e
geografio	geograf'i'o
geografion	geograf'i'o'n
geografiaĵoj	geograf'i'aĵ'o'j
geografiisto	geograf'i'ist'o
geografiistoj	geograf'i'ist'o'j
geografioloko	geograf'i'o'lok'o
geologo	geolog'o
geologoj	geolog'o'j
geologon	geolog'o'n
geologia	geolog'i'a
geologiaj	geolog'i'a'j
geologiajn	geolog'i'a'j'n
geologian	geolog'i'a'n
geologie	geolog'i'e
geologio	geolog'i'o
geologion	geolog'i'o'n
geomagneta	geomagnet'a
geomagnetaj	geomagnet'a'j
geomagnetiko	geomagnet'ik'o
geometria	geometr'i'a
geometriaj	geometr'i'a'j
geometriajn	geometr'i'a'j'n
geometrian	geometr'i'a'n
geometrie	geometr'i'e
geometrio	geometr'i'o
geometrioj	geometr'i'o'j
geometriojn	geometr'i'o'j'n
geometrion	geometr'i'o'n
geomorfologia	geomorfologi'a
geopolitika	geopolitik'a
geopolitikaj	geopolitik'a'j
geopolitikajn	geopolitik'a'j'n
geopolitikan	geopolitik'a'n
geopolitike	geopolitik'e
geopolitiko	geopolitik'o
georga	georg'a
georgo	georg'o
georgon	georg'o'n
georgia	georgi'a
georgio	georgi'o
geosinkrona	geosinkron'a
geoterma	geoterm'a
geotermaj	geoterm'a'j
geoterman	geoterm'a'n
gepardo	gepard'o
gepardoj	gepard'o'j
gerardo	gerard'o
gerilaj	geril'a'j
gerilo	geril'o
geriloj	geril'o'j
gerilano	geril'an'o
gerilanoj	geril'an'o'j
germana	german'a
germanaj	german'a'j
germanajn	german'a'j'n
germanan	german'a'n
germane	german'e
germano	german'o
germanoj	german'o'j
germanojn	german'o'j'n
germanon	german'o'n
germandevena	german'de'ven'a
germania	german'i'a
germaniaj	german'i'a'j
germanio	german'i'o
germanion	german'i'o'n
germanigo	german'ig'o
germanino	german'in'o
germanistiko	german'ist'ik'o
germanlando	german'land'o
germanlingva	german'lingv'a
germanlingvaj	german'lingv'a'j
germanlingvajn	german'lingv'a'j'n
germanlingvan	german'lingv'a'n
germanlingve	german'lingv'e
germanlingvanoj	german'lingv'an'o'j
germanparolantoj	german'parol'ant'o'j
germanujo	german'uj'o
germanujon	german'uj'o'n
germaniumo	germanium'o
gerundio	gerundi'o
gerundioj	gerundi'o'j
gesta	gest'a
gestaj	gest'a'j
gestas	gest'as
geste	gest'e
gestis	gest'is
gesto	gest'o
gestoj	gest'o'j
gestojn	gest'o'j'n
geston	gest'o'n
gestadis	gest'ad'is
gestado	gest'ad'o
gestante	gest'ant'e
gestlingvo	gest'lingv'o
gestolingvo	gest'o'lingv'o
gestolingvon	gest'o'lingv'o'n
gestapo	gestap'o
getae	geta'e
getaoj	geta'o'j
gibono	gibon'o
gibonoj	gibon'o'j
giĉeto	giĉet'o
giĉetoj	giĉet'o'j
giganta	gigant'a
gigantaj	gigant'a'j
gigantajn	gigant'a'j'n
gigantan	gigant'a'n
gigante	gigant'e
giganto	gigant'o
gigantoj	gigant'o'j
gigantojn	gigant'o'j'n
giganton	gigant'o'n
gigantino	gigant'in'o
gilda	gild'a
gildo	gild'o
gildoj	gild'o'j
gildojn	gild'o'j'n
gilotino	gilotin'o
gimnastoj	gimnast'o'j
gimnastejo	gimnast'ej'o
gimnastika	gimnast'ik'a
gimnastikaj	gimnast'ik'a'j
gimnastikan	gimnast'ik'a'n
gimnastikas	gimnast'ik'as
gimnastiki	gimnast'ik'i
gimnastiko	gimnast'ik'o
gimnastikon	gimnast'ik'o'n
gimnastikado	gimnast'ik'ad'o
gimnastikejo	gimnast'ik'ej'o
gimnastikejoj	gimnast'ik'ej'o'j
gimnastikejon	gimnast'ik'ej'o'n
gimnazia	gimnazi'a
gimnaziaj	gimnazi'a'j
gimnazio	gimnazi'o
gimnazioj	gimnazi'o'j
gimnazion	gimnazi'o'n
gimnaziano	gimnazi'an'o
gimnazianoj	gimnazi'an'o'j
gimnospermoj	gimnosperm'o'j
gineceo	ginece'o
ginekologo	ginekolog'o
ginekologio	ginekolog'i'o
ginevra	ginevr'a
gingivoj	gingiv'o'j
ginsenga	ginseng'a
ginsengo	ginseng'o
ginsengon	ginseng'o'n
gipsa	gips'a
gipsaj	gips'a'j
gipso	gips'o
gipson	gips'o'n
gipsita	gips'it'a
girlando	girland'o
girlandoj	girland'o'j
girlandojn	girland'o'j'n
girlandon	girland'o'n
giroskopo	giroskop'o
giroskopoj	giroskop'o'j
gisa	gis'a
gisas	gis'as
gisi	gis'i
gisis	gis'is
gisado	gis'ad'o
gisanta	gis'ant'a
gisante	gis'ant'e
gisfera	gis'fer'a
gisfero	gis'fer'o
gisita	gis'it'a
gisitaj	gis'it'a'j
gisto	gist'o
gistoj	gist'o'j
giston	gist'o'n
gitara	gitar'a
gitaras	gitar'as
gitari	gitar'i
gitaris	gitar'is
gitaro	gitar'o
gitaroj	gitar'o'j
gitarojn	gitar'o'j'n
gitaron	gitar'o'n
gitaristo	gitar'ist'o
gitaristoj	gitar'ist'o'j
gitarludon	gitar'lud'o'n
gitarludado	gitar'lud'ad'o
glaco	glac'o
glacoj	glac'o'j
glacojn	glac'o'j'n
glacon	glac'o'n
glacea	glace'a
glacia	glaci'a
glaciaj	glaci'a'j
glaciajn	glaci'a'j'n
glacian	glaci'a'n
glacie	glaci'e
glacio	glaci'o
glacioj	glaci'o'j
glacion	glaci'o'n
glaciaĵo	glaci'aĵ'o
glaciaĵoj	glaci'aĵ'o'j
glaciaĵojn	glaci'aĵ'o'j'n
glaciaĵon	glaci'aĵ'o'n
glaciaĵbovlo	glaci'aĵ'bovl'o
glacieja	glaci'ej'a
glaciejaj	glaci'ej'a'j
glaciejo	glaci'ej'o
glaciejoj	glaci'ej'o'j
glaciejiĝo	glaci'ej'iĝ'o
glaciepoka	glaci'epok'a
glaciepoko	glaci'epok'o
glaciepokoj	glaci'epok'o'j
glacihokeo	glaci'hoke'o
glaciigis	glaci'ig'is
glaciigita	glaci'ig'it'a
glaciiĝas	glaci'iĝ'as
glaciiĝis	glaci'iĝ'is
glaciiĝo	glaci'iĝ'o
glaciiĝinta	glaci'iĝ'int'a
glacikovrita	glaci'kovr'it'a
glacikovritaj	glaci'kovr'it'a'j
glacikristaloj	glaci'kristal'o'j
glacimonto	glaci'mont'o
glacimontoj	glaci'mont'o'j
glaciriveroj	glaci'river'o'j
glacitavolo	glaci'tavol'o
glacitavoloj	glaci'tavol'o'j
glaĉera	glaĉer'a
glaĉeraj	glaĉer'a'j
glaĉero	glaĉer'o
glaĉeroj	glaĉer'o'j
glaĉerojn	glaĉer'o'j'n
gladas	glad'as
gladi	glad'i
gladis	glad'is
glados	glad'os
gladado	glad'ad'o
gladilo	glad'il'o
gladilon	glad'il'o'n
gladiatoro	gladiator'o
gladiatoroj	gladiator'o'j
glano	glan'o
glanoj	glan'o'j
glanojn	glan'o'j'n
glanon	glan'o'n
glandaj	gland'a'j
glando	gland'o
glandoj	gland'o'j
glandojn	gland'o'j'n
glandon	gland'o'n
glaso	glas'o
glasoj	glas'o'j
glasojn	glas'o'j'n
glason	glas'o'n
glaseto	glas'et'o
glasetoj	glas'et'o'j
glasetojn	glas'et'o'j'n
glaseton	glas'et'o'n
glata	glat'a
glataj	glat'a'j
glatajn	glat'a'j'n
glatan	glat'a'n
glatas	glat'as
glate	glat'e
glatis	glat'is
glateco	glat'ec'o
glatecon	glat'ec'o'n
glatigas	glat'ig'as
glatigi	glat'ig'i
glatigis	glat'ig'is
glatigante	glat'ig'ant'e
glatigita	glat'ig'it'a
glatigitaj	glat'ig'it'a'j
glatmuskolaj	glat'muskol'a'j
glatrandaj	glat'rand'a'j
glaŭka	glaŭk'a
glaŭko	glaŭk'o
glava	glav'a
glavo	glav'o
glavoj	glav'o'j
glavojn	glav'o'j'n
glavon	glav'o'n
glavingo	glav'ing'o
glavtenilo	glav'ten'il'o
glazuro	glazur'o
glazuroj	glazur'o'j
glazurita	glazur'it'a
glazuritaj	glazur'it'a'j
glicerino	glicerin'o
glicino	glicin'o
glicirizaj	gliciriz'a'j
glicirizan	gliciriz'a'n
glicirizo	gliciriz'o
glimis	glim'is
glimo	glim'o
glimanta	glim'ant'a
gliro	glir'o
glisas	glis'as
glisis	glis'is
glisado	glis'ad'o
glisaviadilo	glis'aviad'il'o
glisaviadiloj	glis'aviad'il'o'j
glisilo	glis'il'o
glisiloj	glis'il'o'j
glita	glit'a
glitaj	glit'a'j
glitan	glit'a'n
glitas	glit'as
glite	glit'e
gliti	glit'i
glitis	glit'is
glitos	glit'os
glitu	glit'u
glitus	glit'us
glitadis	glit'ad'is
glitado	glit'ad'o
glitadon	glit'ad'o'n
glitanta	glit'ant'a
glitantaj	glit'ant'a'j
glitante	glit'ant'e
glitejo	glit'ej'o
glitfalis	glit'fal'is
glitiga	glit'ig'a
glitigaj	glit'ig'a'j
glitigis	glit'ig'is
glitilo	glit'il'o
glitiloj	glit'il'o'j
glitinte	glit'int'e
glitkomaj	glit'kom'a'j
glitkuri	glit'kur'i
glittubo	glit'tub'o
glitvetero	glit'veter'o
glitveteroj	glit'veter'o'j
glitveturilo	glit'vetur'il'o
glitveturilon	glit'vetur'il'o'n
globa	glob'a
globaj	glob'a'j
globe	glob'e
globo	glob'o
globoj	glob'o'j
globojn	glob'o'j'n
globon	glob'o'n
globeto	glob'et'o
globetoj	glob'et'o'j
globeton	glob'et'o'n
globforma	glob'form'a
globformaj	glob'form'a'j
globkrajono	glob'krajon'o
globkrajonoj	glob'krajon'o'j
globkrajonon	glob'krajon'o'n
globuloj	globul'o'j
globuletoj	globul'et'o'j
globuso	globus'o
glora	glor'a
gloraj	glor'a'j
glorajn	glor'a'j'n
gloran	glor'a'n
gloras	glor'as
glore	glor'e
glori	glor'i
gloris	glor'is
gloro	glor'o
gloroj	glor'o'j
gloron	glor'o'n
gloros	glor'os
gloru	glor'u
glorado	glor'ad'o
gloramo	glor'am'o
glorante	glor'ant'e
glorata	glor'at'a
glorigas	glor'ig'as
glorigi	glor'ig'i
glorigis	glor'ig'is
glorigo	glor'ig'o
glorigos	glor'ig'os
glortempo	glor'temp'o
glosa	glos'a
glosoj	glos'o'j
glosaro	glos'ar'o
glosaroj	glos'ar'o'j
glosaron	glos'ar'o'n
glota	glot'a
glotaj	glot'a'j
glotan	glot'a'n
gloto	glot'o
glua	glu'a
gluas	glu'as
glui	glu'i
gluis	glu'is
gluo	glu'o
gluoj	glu'o'j
gluon	glu'o'n
gluu	glu'u
gluado	glu'ad'o
gluaĵo	glu'aĵ'o
gluaĵoj	glu'aĵ'o'j
glubendo	glu'bend'o
glubendoj	glu'bend'o'j
glubendon	glu'bend'o'n
glubildoj	glu'bild'o'j
glueca	glu'ec'a
gluecaj	glu'ec'a'j
gluecan	glu'ec'a'n
gluiĝas	glu'iĝ'as
gluiĝis	glu'iĝ'is
gluiĝema	glu'iĝ'em'a
gluita	glu'it'a
gluitaj	glu'it'a'j
glumarko	glu'mark'o
glumarkoj	glu'mark'o'j
glumarkojn	glu'mark'o'j'n
glumozaiko	glu'mozaik'o
glukozo	glukoz'o
glukozon	glukoz'o'n
glukozido	glukoz'id'o
glumo	glum'o
glumoj	glum'o'j
gluonoj	gluon'o'j
glutas	glut'as
gluti	glut'i
glutis	glut'is
gluto	glut'o
glutoj	glut'o'j
gluton	glut'o'n
glutado	glut'ad'o
glutante	glut'ant'e
glutita	glut'it'a
glutamato	glutam'at'o
glutamaton	glutam'at'o'n
glutamino	glutamin'o
glutationo	glutation'o
gluteoj	glute'o'j
gluteno	gluten'o
gnome	gnom'e
gnomo	gnom'o
gnomoj	gnom'o'j
gnomojn	gnom'o'j'n
gnomon	gnom'o'n
gnostika	gnostik'a
gnostikaj	gnostik'a'j
gnostikismo	gnostik'ism'o
gnostikuloj	gnostik'ul'o'j
gnozo	gnoz'o
gnua	gnu'a
gnuo	gnu'o
gnuoj	gnu'o'j
goa	go'a
goan	go'a'n
goo	go'o
goon	go'o'n
goludo	go'lud'o
gobelino	gobelin'o
gobelinoj	gobelin'o'j
gobio	gobi'o
goeto	goet'o
golan	gol'a'n
golo	gol'o
goloj	gol'o'j
golojn	gol'o'j'n
golon	gol'o'n
goldoni	gol'don'i
golejo	gol'ej'o
golejoj	gol'ej'o'j
golejon	gol'ej'o'n
golulo	gol'ul'o
golumo	gol'um'o
golumon	gol'um'o'n
golfa	golf'a
golfaj	golf'a'j
golfo	golf'o
golfoj	golf'o'j
golfojn	golf'o'j'n
golfon	golf'o'n
golfejo	golf'ej'o
golfejoj	golf'ej'o'j
golfejon	golf'ej'o'n
golfeto	golf'et'o
golfetoj	golf'et'o'j
golfeton	golf'et'o'n
golfludas	golf'lud'as
golfludi	golf'lud'i
golfludo	golf'lud'o
golfludanto	golf'lud'ant'o
golfludantoj	golf'lud'ant'o'j
golfregiono	golf'region'o
golgoto	golgot'o
goliato	goliat'o
gombe	gomb'e
gondolo	gondol'o
gondoloj	gondol'o'j
gondvano	gondvan'o
gongo	gong'o
gongoj	gong'o'j
gongterapiistoj	gong'terapi'ist'o'j
gonzalo	gonzal'o
gorĝa	gorĝ'a
gorĝo	gorĝ'o
gorĝoj	gorĝ'o'j
gorĝojn	gorĝ'o'j'n
gorĝon	gorĝ'o'n
gorĝareo	gorĝ'are'o
gorĝareon	gorĝ'are'o'n
gorĝosako	gorĝ'o'sak'o
gorilo	goril'o
goriloj	goril'o'j
gorilojn	goril'o'j'n
gorilon	goril'o'n
gospelo	gospel'o
gota	got'a
goto	got'o
gotoj	got'o'j
gotojn	got'o'j'n
gotlanda	got'land'a
gotlando	got'land'o
gotamo	gotam'o
gotenburga	gotenburg'a
gotenburgo	gotenburg'o
gotika	gotik'a
gotikaj	gotik'a'j
gotikajn	gotik'a'j'n
gotikan	gotik'a'n
gotiko	gotik'o
graca	grac'a
grace	grac'e
graco	grac'o
gracoj	grac'o'j
gracojn	grac'o'j'n
gracon	grac'o'n
gracoplena	grac'o'plen'a
gracia	graci'a
graciaj	graci'a'j
graciajn	graci'a'j'n
gracian	graci'a'n
gracie	graci'e
gracio	graci'o
gracioj	graci'o'j
gracion	graci'o'n
gracieco	graci'ec'o
graciecon	graci'ec'o'n
graciano	gracian'o
gracila	gracil'a
gracilaj	gracil'a'j
grada	grad'a
gradaj	grad'a'j
gradan	grad'a'n
grade	grad'e
grado	grad'o
gradoj	grad'o'j
gradojn	grad'o'j'n
gradon	grad'o'n
gradeco	grad'ec'o
gradigas	grad'ig'as
gradigita	grad'ig'it'a
gradigitaj	grad'ig'it'a'j
gradiĝis	grad'iĝ'is
gradprogramo	grad'program'o
gradprogramoj	grad'program'o'j
gradprogramojn	grad'program'o'j'n
gradstudantoj	grad'stud'ant'o'j
gradiento	gradient'o
gradientoj	gradient'o'j
gradientojn	gradient'o'j'n
gradienton	gradient'o'n
grafa	graf'a
grafo	graf'o
grafoj	graf'o'j
grafon	graf'o'n
grafejo	graf'ej'o
grafidinoj	graf'id'in'o'j
grafino	graf'in'o
graflando	graf'land'o
graflandoj	graf'land'o'j
grafeo	grafe'o
grafeoj	grafe'o'j
grafeojn	grafe'o'j'n
grafeon	grafe'o'n
grafeteorio	grafe'teori'o
grafemo	grafem'o
grafemoj	grafem'o'j
grafeno	grafen'o
grafika	grafik'a
grafikaj	grafik'a'j
grafikajn	grafik'a'j'n
grafikan	grafik'a'n
grafike	grafik'e
grafiko	grafik'o
grafikoj	grafik'o'j
grafikojn	grafik'o'j'n
grafikon	grafik'o'n
grafikaĵo	grafik'aĵ'o
grafikaĵoj	grafik'aĵ'o'j
grafikaĵojn	grafik'aĵ'o'j'n
grafikaĵon	grafik'aĵ'o'n
grafikisto	grafik'ist'o
grafikistoj	grafik'ist'o'j
grafito	grafit'o
grafiton	grafit'o'n
grafitio	grafiti'o
grajno	grajn'o
grajnoj	grajn'o'j
grajnojn	grajn'o'j'n
grajnon	grajn'o'n
grajneca	grajn'ec'a
grajnecaj	grajn'ec'a'j
grajnetoj	grajn'et'o'j
grajngrandeco	grajn'grand'ec'o
gramo	gram'o
gramoj	gram'o'j
gramojn	gram'o'j'n
gramnegativaj	gram'negativ'a'j
grampozitivaj	gram'pozitiv'a'j
gramatika	gramatik'a
gramatikaj	gramatik'a'j
gramatikajn	gramatik'a'j'n
gramatikan	gramatik'a'n
gramatike	gramatik'e
gramatiko	gramatik'o
gramatikoj	gramatik'o'j
gramatikojn	gramatik'o'j'n
gramatikon	gramatik'o'n
gramatikaĵoj	gramatik'aĵ'o'j
gramatikaĵojn	gramatik'aĵ'o'j'n
gramatikigo	gramatik'ig'o
gramatikisto	gramatik'ist'o
gramatikistoj	gramatik'ist'o'j
gramofono	gramofon'o
gramofonon	gramofon'o'n
granato	granat'o
granatoj	granat'o'j
granatojn	granat'o'j'n
granda	grand'a
grandaj	grand'a'j
grandajn	grand'a'j'n
grandan	grand'a'n
grandas	grand'as
grande	grand'e
grandis	grand'is
grando	grand'o
grandoj	grand'o'j
grandojn	grand'o'j'n
grandon	grand'o'n
grandamezure	grand'a'mezur'e
grandaĝa	grand'aĝ'a
grandaĝulo	grand'aĝ'ul'o
grandaĝuloj	grand'aĝ'ul'o'j
grandaĵojn	grand'aĵ'o'j'n
grandampleksa	grand'ampleks'a
grandamplekse	grand'ampleks'e
grandanima	grand'anim'a
grandanimaj	grand'anim'a'j
grandaniman	grand'anim'a'n
grandanime	grand'anim'e
grandanimeco	grand'anim'ec'o
grandanimecon	grand'anim'ec'o'n
grandaparte	grand'apart'e
grandarea	grand'are'a
grandareaj	grand'are'a'j
grandbieno	grand'bien'o
grandbienoj	grand'bien'o'j
grandbienuloj	grand'bien'ul'o'j
grandbritio	grand'brit'i'o
grandcerbo	grand'cerb'o
grandduko	grand'duk'o
granddukejo	grand'duk'ej'o
grandduklando	grand'duk'land'o
grandeco	grand'ec'o
grandecoj	grand'ec'o'j
grandecojn	grand'ec'o'j'n
grandecon	grand'ec'o'n
grandega	grand'eg'a
grandegaj	grand'eg'a'j
grandegajn	grand'eg'a'j'n
grandegan	grand'eg'a'n
grandegas	grand'eg'as
grandege	grand'eg'e
grandegulo	grand'eg'ul'o
grandeguloj	grand'eg'ul'o'j
grandfamilio	grand'famili'o
grandformata	grand'format'a
grandformataj	grand'format'a'j
grandigas	grand'ig'as
grandigi	grand'ig'i
grandigis	grand'ig'is
grandigo	grand'ig'o
grandigos	grand'ig'os
grandiĝas	grand'iĝ'as
grandiĝi	grand'iĝ'i
grandiĝis	grand'iĝ'is
grandiĝo	grand'iĝ'o
grandiĝos	grand'iĝ'os
grandiĝanta	grand'iĝ'ant'a
grandkapa	grand'kap'a
grandkvanta	grand'kvant'a
grandkvante	grand'kvant'e
grandlitere	grand'liter'e
grandmagazeno	grand'magazen'o
grandmagazenoj	grand'magazen'o'j
grandmajstro	grand'majstr'o
grandmajstroj	grand'majstr'o'j
grandmezura	grand'mezur'a
grandmezure	grand'mezur'e
grandmoravia	grand'moravi'a
grandnombra	grand'nombr'a
grandnombraj	grand'nombr'a'j
grandnombrajn	grand'nombr'a'j'n
grandnombran	grand'nombr'a'n
grandnombre	grand'nombr'e
grandnombro	grand'nombr'o
grandnombron	grand'nombr'o'n
grandordo	grand'ord'o
grandparte	grand'part'e
grandparto	grand'part'o
grandparton	grand'part'o'n
grandpaŝe	grand'paŝ'e
grandpersonoj	grand'person'o'j
grandpotenco	grand'potenc'o
grandpotencoj	grand'potenc'o'j
grandprinco	grand'princ'o
grandprinclando	grand'princ'land'o
grandsinjoro	grand'sinjor'o
grandsinjoroj	grand'sinjor'o'j
grandskala	grand'skal'a
grandskalaj	grand'skal'a'j
grandskalajn	grand'skal'a'j'n
grandskalan	grand'skal'a'n
grandskale	grand'skal'e
grandulo	grand'ul'o
granduloj	grand'ul'o'j
grandurba	grand'urb'a
grandurbo	grand'urb'o
grandurboj	grand'urb'o'j
grandurbojn	grand'urb'o'j'n
grandurbon	grand'urb'o'n
grandvalora	grand'valor'a
grandvaloraj	grand'valor'a'j
grandvilaĝo	grand'vilaĝ'o
grandioza	grandioz'a
grandiozaj	grandioz'a'j
grandiozajn	grandioz'a'j'n
grandiozan	grandioz'a'n
grandioze	grandioz'e
grandiozeco	grandioz'ec'o
grandiozecon	grandioz'ec'o'n
granita	granit'a
granitaj	granit'a'j
granitan	granit'a'n
granito	granit'o
graniton	granit'o'n
grapfruktoj	grapfrukt'o'j
grapolo	grapol'o
grapoloj	grapol'o'j
grapolbomboj	grapol'bomb'o'j
grasa	gras'a
grasaj	gras'a'j
grasajn	gras'a'j'n
grasan	gras'a'n
grasas	gras'as
grase	gras'e
graso	gras'o
grasoj	gras'o'j
grasojn	gras'o'j'n
grason	gras'o'n
grasos	gras'os
grasacido	gras'acid'o
grasacidoj	gras'acid'o'j
grasacidojn	gras'acid'o'j'n
grasaĵo	gras'aĵ'o
grasaĵoj	gras'aĵ'o'j
grasegaj	gras'eg'a'j
graseta	gras'et'a
grashisto	gras'hist'o
grasigas	gras'ig'as
grasigi	gras'ig'i
grasiĝas	gras'iĝ'as
grata	grat'a
gratas	grat'as
grati	grat'i
gratis	grat'is
gratu	grat'u
gratado	grat'ad'o
gratante	grat'ant'e
gratita	grat'it'a
gratitaj	grat'it'a'j
gratvundeto	grat'vund'et'o
gratvundetoj	grat'vund'et'o'j
gratifiko	gratifik'o
gratifikoj	gratifik'o'j
gratifikojn	gratifik'o'j'n
gratifikon	gratifik'o'n
gratula	gratul'a
gratulajn	gratul'a'j'n
gratulan	gratul'a'n
gratulas	gratul'as
gratuli	gratul'i
gratulis	gratul'is
gratulo	gratul'o
gratuloj	gratul'o'j
gratulojn	gratul'o'j'n
gratulon	gratul'o'n
gratulu	gratul'u
gratulante	gratul'ant'e
gratulantoj	gratul'ant'o'j
gratulinda	gratul'ind'a
graŭlis	graŭl'is
grava	grav'a
gravaj	grav'a'j
gravajn	grav'a'j'n
gravan	grav'a'n
gravas	grav'as
grave	grav'e
gravi	grav'i
gravis	grav'is
gravo	grav'o
gravon	grav'o'n
gravos	grav'os
gravus	grav'us
gravaĵo	grav'aĵ'o
gravaĵoj	grav'aĵ'o'j
gravakcento	grav'akcent'o
graveco	grav'ec'o
gravecon	grav'ec'o'n
gravega	grav'eg'a
gravegaj	grav'eg'a'j
gravegajn	grav'eg'a'j'n
gravegan	grav'eg'a'n
gravegas	grav'eg'as
gravege	grav'eg'e
gravegis	grav'eg'is
gravejoj	grav'ej'o'j
gravigas	grav'ig'as
graviĝis	grav'iĝ'is
gravita	grav'it'a
gravitaj	grav'it'a'j
gravitajn	grav'it'a'j'n
gravitan	grav'it'a'n
gravitas	grav'it'as
gravite	grav'it'e
gravitis	grav'it'is
gravmiena	grav'mien'a
gravmienaj	grav'mien'a'j
gravmienan	grav'mien'a'n
gravmiene	grav'mien'e
gravulo	grav'ul'o
gravuloj	grav'ul'o'j
gravulojn	grav'ul'o'j'n
gravulon	grav'ul'o'n
graveda	graved'a
gravedaj	graved'a'j
gravedajn	graved'a'j'n
gravedan	graved'a'n
gravedas	graved'as
gravedo	graved'o
gravedeca	graved'ec'a
gravedeco	graved'ec'o
gravedecoj	graved'ec'o'j
gravedecon	graved'ec'o'n
gravedecperiodo	graved'ec'period'o
gravedigis	graved'ig'is
gravedigo	graved'ig'o
gravediĝas	graved'iĝ'as
gravediĝi	graved'iĝ'i
gravediĝis	graved'iĝ'is
gravediĝo	graved'iĝ'o
gravediĝon	graved'iĝ'o'n
gravedulino	graved'ul'in'o
gravedulinoj	graved'ul'in'o'j
gravita	gravit'a
gravitaj	gravit'a'j
gravitajn	gravit'a'j'n
gravitan	gravit'a'n
gravitas	gravit'as
gravite	gravit'e
gravitis	gravit'is
gravito	gravit'o
graviton	gravit'o'n
gravitado	gravit'ad'o
gravitforto	gravit'fort'o
gravitkampo	gravit'kamp'o
gravuraj	gravur'a'j
gravuras	gravur'as
gravuri	gravur'i
gravuris	gravur'is
gravurado	gravur'ad'o
gravuraĵo	gravur'aĵ'o
gravuraĵoj	gravur'aĵ'o'j
gravuraĵojn	gravur'aĵ'o'j'n
gravuraĵon	gravur'aĵ'o'n
gravuriĝis	gravur'iĝ'is
gravurilo	gravur'il'o
gravuristo	gravur'ist'o
gravuristoj	gravur'ist'o'j
gravurita	gravur'it'a
gravuritaj	gravur'it'a'j
gravuritajn	gravur'it'a'j'n
gravuritan	gravur'it'a'n
grebo	greb'o
greboj	greb'o'j
greftas	greft'as
grefto	greft'o
greftado	greft'ad'o
grego	greg'o
gregoj	greg'o'j
gregojn	greg'o'j'n
gregon	greg'o'n
gregaro	greg'ar'o
gregema	greg'em'a
gregemaj	greg'em'a'j
gregiga	greg'ig'a
gregoria	gregori'a
gregorian	gregori'a'n
gregorio	gregori'o
grejso	grejs'o
grejsoj	grejs'o'j
greka	grek'a
grekaj	grek'a'j
grekajn	grek'a'j'n
grekan	grek'a'n
greke	grek'e
greko	grek'o
grekoj	grek'o'j
grekojn	grek'o'j'n
grekon	grek'o'n
grekalatina	grek'a'latin'a
grekdevena	grek'de'ven'a
grekia	grek'i'a
grekio	grek'i'o
grekion	grek'i'o'n
grekkatolika	grek'katolik'a
greklando	grek'land'o
greklingva	grek'lingv'a
grekoromia	grek'o'romi'a
grekparolanta	grek'parol'ant'a
grekromia	grek'romi'a
grekujo	grek'uj'o
grekuloj	grek'ul'o'j
grena	gren'a
grenaj	gren'a'j
grenan	gren'a'n
greno	gren'o
grenoj	gren'o'j
grenojn	gren'o'j'n
grenon	gren'o'n
grenejo	gren'ej'o
grenejoj	gren'ej'o'j
grenejon	gren'ej'o'n
grenkampo	gren'kamp'o
grenkampoj	gren'kamp'o'j
grenlando	gren'land'o
grenlimoj	gren'lim'o'j
grenprezoj	gren'prez'o'j
grenproduktado	gren'produkt'ad'o
grenrikolto	gren'rikolt'o
grenrikoltoj	gren'rikolt'o'j
grenada	grenad'a
grenado	grenad'o
grenadoj	grenad'o'j
grenadojn	grenad'o'j'n
grenadistoj	grenad'ist'o'j
grenoble	grenobl'e
grenoblo	grenobl'o
greso	gres'o
gresoj	gres'o'j
greson	gres'o'n
grio	gri'o
grifo	grif'o
grifoj	grif'o'j
grifelo	grifel'o
grifelon	grifel'o'n
grilo	gril'o
griloj	gril'o'j
grimacas	grimac'as
grimacis	grimac'is
grimaco	grimac'o
grimacoj	grimac'o'j
grimacojn	grimac'o'j'n
grimacon	grimac'o'n
grimpas	grimp'as
grimpi	grimp'i
grimpis	grimp'is
grimpo	grimp'o
grimpos	grimp'os
grimpu	grimp'u
grimpado	grimp'ad'o
grimpadoj	grimp'ad'o'j
grimpadon	grimp'ad'o'n
grimpanta	grimp'ant'a
grimpantaj	grimp'ant'a'j
grimpante	grimp'ant'e
grimpinte	grimp'int'e
grimpisto	grimp'ist'o
grimpoplantoj	grimp'o'plant'o'j
grimpplantoj	grimp'plant'o'j
grimpulo	grimp'ul'o
grimpuloj	grimp'ul'o'j
grincas	grinc'as
grincis	grinc'is
grinco	grinc'o
grincado	grinc'ad'o
grincadoj	grinc'ad'o'j
grincigis	grinc'ig'is
griotoj	griot'o'j
gripa	grip'a
gripaj	grip'a'j
gripo	grip'o
gripon	grip'o'n
gripvirusoj	grip'virus'o'j
griza	griz'a
grizaj	griz'a'j
grizajn	griz'a'j'n
grizan	griz'a'n
grizas	griz'as
grize	griz'e
grizo	griz'o
grizon	griz'o'n
grizblanka	griz'blank'a
grizblankaj	griz'blank'a'j
grizblua	griz'blu'a
grizbruna	griz'brun'a
grizbrunaj	griz'brun'a'j
grizbrunan	griz'brun'a'n
grizeca	griz'ec'a
grizecaj	griz'ec'a'j
grizecajn	griz'ec'a'j'n
grizecan	griz'ec'a'n
grizeco	griz'ec'o
grizecbruna	griz'ec'brun'a
grizecbrunaj	griz'ec'brun'a'j
grizeta	griz'et'a
grizhara	griz'har'a
griziĝas	griz'iĝ'as
griziĝis	griz'iĝ'is
grizkapa	griz'kap'a
grizkolora	griz'kolor'a
griznigraj	griz'nigr'a'j
grizverda	griz'verd'a
grizono	grizon'o
gropo	grop'o
groso	gros'o
grosoj	gros'o'j
groŝo	groŝ'o
groŝoj	groŝ'o'j
groŝojn	groŝ'o'j'n
groŝon	groŝ'o'n
groŝmono	groŝ'mon'o
groŝmonoj	groŝ'mon'o'j
groto	grot'o
grotoj	grot'o'j
groton	grot'o'n
grotaro	grot'ar'o
groteska	grotesk'a
groteskaj	grotesk'a'j
groteskajn	grotesk'a'j'n
groteskan	grotesk'a'n
groteske	grotesk'e
gruo	gru'o
gruoj	gru'o'j
gruojn	gru'o'j'n
gruon	gru'o'n
grumbla	grumbl'a
grumblas	grumbl'as
grumble	grumbl'e
grumbli	grumbl'i
grumblis	grumbl'is
grumblo	grumbl'o
grumbloj	grumbl'o'j
grumblon	grumbl'o'n
grumblu	grumbl'u
grumblado	grumbl'ad'o
grumblante	grumbl'ant'e
grumblema	grumbl'em'a
grunda	grund'a
grundaj	grund'a'j
grundajn	grund'a'j'n
grundan	grund'a'n
grundis	grund'is
grundo	grund'o
grundoj	grund'o'j
grundojn	grund'o'j'n
grundon	grund'o'n
grundakva	grund'akv'a
grundakvo	grund'akv'o
grundakvoj	grund'akv'o'j
grundakvon	grund'akv'o'n
grundbazita	grund'baz'it'a
grundbazitaj	grund'baz'it'a'j
grunderozio	grund'erozi'o
grundfekundeco	grund'fekund'ec'o
grundnivelo	grund'nivel'o
grundostacio	grund'o'staci'o
grundostacioj	grund'o'staci'o'j
grundotipoj	grund'o'tip'o'j
grundsurfaco	grund'surfac'o
gruntas	grunt'as
gruntis	grunt'is
gruntoj	grunt'o'j
gruntado	grunt'ad'o
gruntbovo	grunt'bov'o
gruntbovoj	grunt'bov'o'j
grupa	grup'a
grupaj	grup'a'j
grupajn	grup'a'j'n
grupan	grup'a'n
grupe	grup'e
grupo	grup'o
grupoj	grup'o'j
grupojn	grup'o'j'n
grupon	grup'o'n
grupano	grup'an'o
grupanoj	grup'an'o'j
grupanojn	grup'an'o'j'n
grupestro	grup'estr'o
grupeto	grup'et'o
grupetoj	grup'et'o'j
grupetojn	grup'et'o'j'n
grupeton	grup'et'o'n
grupigas	grup'ig'as
grupigi	grup'ig'i
grupigis	grup'ig'is
grupigo	grup'ig'o
grupigon	grup'ig'o'n
grupigante	grup'ig'ant'e
grupigita	grup'ig'it'a
grupigitaj	grup'ig'it'a'j
grupiĝas	grup'iĝ'as
grupiĝis	grup'iĝ'is
grupiĝo	grup'iĝ'o
grupiĝoj	grup'iĝ'o'j
grupiĝojn	grup'iĝ'o'j'n
grupiĝon	grup'iĝ'o'n
grupiĝintaj	grup'iĝ'int'a'j
grupstrukturo	grup'struktur'o
gruza	gruz'a
gruzo	gruz'o
gruzon	gruz'o'n
guano	guan'o
guantanamo	guantanam'o
gubernatoro	gubernator'o
gubernia	guberni'a
guberniaj	guberni'a'j
gubernio	guberni'o
gubernioj	guberni'o'j
guberniojn	guberni'o'j'n
gubernion	guberni'o'n
guberniestro	guberni'estr'o
guberniestroj	guberni'estr'o'j
guberniestrojn	guberni'estr'o'j'n
guberniestron	guberni'estr'o'n
guberniestreco	guberni'estr'ec'o
gudro	gudr'o
gufo	guf'o
gufoj	guf'o'j
gufujo	guf'uj'o
gujano	gujan'o
gujavo	gujav'o
gulo	gul'o
guloj	gul'o'j
gulago	gulag'o
gulagoj	gulag'o'j
gulaŝo	gulaŝ'o
guldeno	gulden'o
guldenoj	gulden'o'j
guldenojn	gulden'o'j'n
guma	gum'a
gumo	gum'o
gumoj	gum'o'j
gumon	gum'o'n
guruo	guru'o
guruoj	guru'o'j
guruon	guru'o'n
gusta	gust'a
gustas	gust'as
guste	gust'e
gusti	gust'i
gustis	gust'is
gusto	gust'o
gustoj	gust'o'j
gustojn	gust'o'j'n
guston	gust'o'n
gustos	gust'os
gustiga	gust'ig'a
gustigagento	gust'ig'agent'o
gustigilo	gust'ig'il'o
gustoplena	gust'o'plen'a
gustoplenaj	gust'o'plen'a'j
gustumas	gust'um'as
gustumi	gust'um'i
gustumis	gust'um'is
gustumo	gust'um'o
gustumos	gust'um'os
gustumu	gust'um'u
gustumado	gust'um'ad'o
gustumante	gust'um'ant'e
gustave	gustav'e
gustavo	gustav'o
guŝo	guŝ'o
guŝoj	guŝ'o'j
guŝojn	guŝ'o'j'n
gutas	gut'as
gute	gut'e
gutis	gut'is
guto	gut'o
gutoj	gut'o'j
gutojn	gut'o'j'n
guton	gut'o'n
gutanta	gut'ant'a
gutetis	gut'et'is
guteto	gut'et'o
gutetoj	gut'et'o'j
gutetojn	gut'et'o'j'n
guteton	gut'et'o'n
guturala	gutural'a
guvernisto	guvern'ist'o
guvernistino	guvern'ist'in'o
gvadelupo	gvadelup'o
gvamo	gvam'o
gvardio	gvardi'o
gvardioj	gvardi'o'j
gvardion	gvardi'o'n
gvardianoj	gvardi'an'o'j
gvatas	gvat'as
gvati	gvat'i
gvatis	gvat'is
gvatado	gvat'ad'o
gvatadon	gvat'ad'o'n
gvatante	gvat'ant'e
gvatejo	gvat'ej'o
gvatnesto	gvat'nest'o
gvatturo	gvat'tur'o
gvattureto	gvat'tur'et'o
gvatturetoj	gvat'tur'et'o'j
gvatemala	gvatemal'a
gvatemalo	gvatemal'o
gvida	gvid'a
gvidaj	gvid'a'j
gvidajn	gvid'a'j'n
gvidan	gvid'a'n
gvidas	gvid'as
gvide	gvid'e
gvidi	gvid'i
gvidis	gvid'is
gvido	gvid'o
gvidon	gvid'o'n
gvidos	gvid'os
gvidu	gvid'u
gvidus	gvid'us
gvidado	gvid'ad'o
gvidadoj	gvid'ad'o'j
gvidadon	gvid'ad'o'n
gvidanta	gvid'ant'a
gvidantaj	gvid'ant'a'j
gvidantajn	gvid'ant'a'j'n
gvidantan	gvid'ant'a'n
gvidante	gvid'ant'e
gvidanto	gvid'ant'o
gvidantoj	gvid'ant'o'j
gvidantojn	gvid'ant'o'j'n
gvidanton	gvid'ant'o'n
gvidantaro	gvid'ant'ar'o
gvidantaron	gvid'ant'ar'o'n
gvidantino	gvid'ant'in'o
gvidata	gvid'at'a
gvidataj	gvid'at'a'j
gvidatajn	gvid'at'a'j'n
gvidatan	gvid'at'a'n
gvidate	gvid'at'e
gvidilo	gvid'il'o
gvidiloj	gvid'il'o'j
gvidilojn	gvid'il'o'j'n
gvidilon	gvid'il'o'n
gvidisto	gvid'ist'o
gvidistoj	gvid'ist'o'j
gvidistojn	gvid'ist'o'j'n
gvidiston	gvid'ist'o'n
gvidita	gvid'it'a
gviditaj	gvid'it'a'j
gviditajn	gvid'it'a'j'n
gviditan	gvid'it'a'n
gvidite	gvid'it'e
gvidlibro	gvid'libr'o
gvidlibroj	gvid'libr'o'j
gvidlibrojn	gvid'libr'o'j'n
gvidlibron	gvid'libr'o'n
gvidlinio	gvid'lini'o
gvidlinioj	gvid'lini'o'j
gvidliniojn	gvid'lini'o'j'n
gvidlinion	gvid'lini'o'n
gvidorganoj	gvid'organ'o'j
gvidota	gvid'ot'a
gvidrezolucio	gvid'rezoluci'o
gvidrolon	gvid'rol'o'n
gvidsistemo	gvid'sistem'o
gvinea	gvine'a
gvineo	gvine'o