habelo	habel'o
habitata	habitat'a
habitato	habitat'o
habitatoj	habitat'o'j
habitatojn	habitat'o'j'n
habitaton	habitat'o'n
habitatodetruo	habitat'o'detru'o
habitatoperdo	habitat'o'perd'o
habitatperdo	habitat'perd'o
haĉado	haĉ'ad'o
hadeso	hades'o
hadeson	hades'o'n
hadito	hadit'o
haditoj	hadit'o'j
haditon	hadit'o'n
hadronoj	hadron'o'j
hafnio	hafni'o
haga	hag'a
hagen	hag'e'n
hago	hag'o
hagiografoj	hagiograf'o'j
hagiografioj	hagiograf'i'o'j
haĝo	haĝ'o
haitia	haiti'a
haitiaj	haiti'a'j
haitian	haiti'a'n
haitio	haiti'o
haition	haiti'o'n
haitianoj	haiti'an'o'j
hajko	hajk'o
hajkoj	hajk'o'j
hajkojn	hajk'o'j'n
hajkon	hajk'o'n
hajlo	hajl'o
hajlon	hajl'o'n
hajleroj	hajl'er'o'j
hakas	hak'as
haki	hak'i
hakis	hak'is
hako	hak'o
hakoj	hak'o'j
haku	hak'u
hakadis	hak'ad'is
hakado	hak'ad'o
hakante	hak'ant'e
hakilo	hak'il'o
hakiloj	hak'il'o'j
hakilojn	hak'il'o'j'n
hakilon	hak'il'o'n
hakisto	hak'ist'o
hakistoj	hak'ist'o'j
hakiston	hak'ist'o'n
hakita	hak'it'a
hakitaj	hak'it'a'j
hakamo	hakam'o
hala	hal'a
hale	hal'e
halo	hal'o
haloj	hal'o'j
halojn	hal'o'j'n
halon	hal'o'n
haleja	hal'ej'a
haladzo	haladz'o
haleluja	haleluja
haliotoj	haliot'o'j
haloo	halo'o
halopreĝejo	halo'preĝ'ej'o
halogeno	halogen'o
halogenoj	halogen'o'j
halogenido	halogen'id'o
halogenidoj	halogen'id'o'j
haloveno	haloven'o
haltas	halt'as
halti	halt'i
haltis	halt'is
halto	halt'o
haltoj	halt'o'j
haltojn	halt'o'j'n
halton	halt'o'n
haltos	halt'os
haltu	halt'u
haltus	halt'us
haltadis	halt'ad'is
haltado	halt'ad'o
haltante	halt'ant'e
haltejo	halt'ej'o
haltejoj	halt'ej'o'j
haltejon	halt'ej'o'n
haltigas	halt'ig'as
haltigi	halt'ig'i
haltigis	halt'ig'is
haltigo	halt'ig'o
haltigon	halt'ig'o'n
haltigos	halt'ig'os
haltigu	halt'ig'u
haltigante	halt'ig'ant'e
haltigata	halt'ig'at'a
haltigebla	halt'ig'ebl'a
haltigita	halt'ig'it'a
haltigitaj	halt'ig'it'a'j
haltiĝas	halt'iĝ'as
haltinte	halt'int'e
haltita	halt'it'a
haltitaj	halt'it'a'j
haltostreko	halt'o'strek'o
halterlevo	halter'lev'o
halucina	halucin'a
halucino	halucin'o
halucinoj	halucin'o'j
halucinojn	halucin'o'j'n
halucinon	halucin'o'n
hamako	hamak'o
hamano	haman'o
hamburga	hamburg'a
hamburgo	hamburg'o
hamburgaĵon	hamburg'aĵ'o'n
hamburgero	hamburger'o
hamburgeroj	hamburger'o'j
hamburgerojn	hamburger'o'j'n
hamburgeron	hamburger'o'n
hamiltoniana	hamiltonian'a
hamstro	hamstr'o
hamstrojn	hamstr'o'j'n
hamstron	hamstr'o'n
handikapita	handikap'it'a
handikapitaj	handikap'it'a'j
handikapitajn	handikap'it'a'j'n
handikapitoj	handikap'it'o'j
handikapula	handikap'ul'a
handikapulaj	handikap'ul'a'j
handikapulo	handikap'ul'o
handikapuloj	handikap'ul'o'j
handikapulojn	handikap'ul'o'j'n
hangaro	hangar'o
hangaroj	hangar'o'j
hanibalo	hanibal'o
hanibalon	hanibal'o'n
hansa	hans'a
hanson	hans'o'n
hara	har'a
haraj	har'a'j
hare	har'e
haro	har'o
haroj	har'o'j
harojn	har'o'j'n
haron	har'o'n
hararo	har'ar'o
hararoj	har'ar'o'j
hararon	har'ar'o'n
hararĉeloj	har'ar'ĉel'o'j
hararanĝo	har'aranĝ'o
hararanĝon	har'aranĝ'o'n
harbuklo	har'bukl'o
haregoj	har'eg'o'j
haregojn	har'eg'o'j'n
hareto	har'et'o
haretoj	har'et'o'j
harfendado	har'fend'ad'o
harkoloro	har'kolor'o
harkovrita	har'kovr'it'a
harkovritaj	har'kovr'it'a'j
harligoj	har'lig'o'j
harligojn	har'lig'o'j'n
harplektaĵoj	har'plekt'aĵ'o'j
harplena	har'plen'a
harplenaj	har'plen'a'j
harpomado	har'pomad'o
harsekigilon	har'sek'ig'il'o'n
harstariga	har'star'ig'a
hartufo	har'tuf'o
hardas	hard'as
hardi	hard'i
hardis	hard'is
hardado	hard'ad'o
hardita	hard'it'a
harditaj	hard'it'a'j
harditan	hard'it'a'n
hardvara	hardvar'a
hardvaraj	hardvar'a'j
hardvaro	hardvar'o
hardvaron	hardvar'o'n
haremo	harem'o
haremoj	harem'o'j
haremojn	harem'o'j'n
haremon	harem'o'n
haringo	haring'o
haringoj	haring'o'j
haringon	haring'o'n
harlemo	harlem'o
harmona	harmon'a
harmono	harmon'o
harmonoj	harmon'o'j
harmonojn	harmon'o'j'n
harmonia	harmoni'a
harmoniaj	harmoni'a'j
harmoniajn	harmoni'a'j'n
harmonian	harmoni'a'n
harmonias	harmoni'as
harmonie	harmoni'e
harmonii	harmoni'i
harmoniis	harmoni'is
harmonio	harmoni'o
harmonioj	harmoni'o'j
harmoniojn	harmoni'o'j'n
harmonion	harmoni'o'n
harmonios	harmoni'os
harmoniado	harmoni'ad'o
harmoniante	harmoni'ant'e
harmoniigas	harmoni'ig'as
harmoniigi	harmoni'ig'i
harmoniigis	harmoni'ig'is
harmoniigo	harmoni'ig'o
harmoniigon	harmoni'ig'o'n
harmoniigita	harmoni'ig'it'a
harmoniigitaj	harmoni'ig'it'a'j
harmoniscienco	harmoni'scienc'o
harmoniko	harmonik'o
harpo	harp'o
harpoj	harp'o'j
harpon	harp'o'n
harpio	harpi'o
harpioj	harpi'o'j
harpuno	harpun'o
harpunoj	harpun'o'j
hasta	hast'a
hastaj	hast'a'j
hastan	hast'a'n
hastas	hast'as
haste	hast'e
hasti	hast'i
hastis	hast'is
hasto	hast'o
hastoj	hast'o'j
hastu	hast'u
hastado	hast'ad'o
hastante	hast'ant'e
hasteco	hast'ec'o
hastema	hast'em'a
hasthoro	hast'hor'o
haŝio	haŝi'o
haŝiŝo	haŝiŝ'o
haŝiŝon	haŝiŝ'o'n
haŭsoj	haŭs'o'j
haŭta	haŭt'a
haŭtaj	haŭt'a'j
haŭtan	haŭt'a'n
haŭto	haŭt'o
haŭtoj	haŭt'o'j
haŭtojn	haŭt'o'j'n
haŭton	haŭt'o'n
haŭtaĵo	haŭt'aĵ'o
haŭtaĵoj	haŭt'aĵ'o'j
haŭtaĵon	haŭt'aĵ'o'n
haŭtkoloro	haŭt'kolor'o
haŭtkoloroj	haŭt'kolor'o'j
haŭtkoloron	haŭt'kolor'o'n
haŭtmakulo	haŭt'makul'o
haŭtokoloro	haŭt'o'kolor'o
haŭtokontakto	haŭt'o'kontakt'o
hava	hav'a
havas	hav'as
have	hav'e
havi	hav'i
havis	hav'is
havo	hav'o
havon	hav'o'n
havos	hav'os
havu	hav'u
havus	hav'us
havado	hav'ad'o
havajho	hav'aĵ'o
havaĵo	hav'aĵ'o
havaĵoj	hav'aĵ'o'j
havaĵojn	hav'aĵ'o'j'n
havaĵon	hav'aĵ'o'n
havanta	hav'ant'a
havantaj	hav'ant'a'j
havantajn	hav'ant'a'j'n
havantan	hav'ant'a'n
havante	hav'ant'e
havantoj	hav'ant'o'j
havata	hav'at'a
havebla	hav'ebl'a
haveblaj	hav'ebl'a'j
haveblajn	hav'ebl'a'j'n
haveblan	hav'ebl'a'n
haveblas	hav'ebl'as
haveble	hav'ebl'e
haveblis	hav'ebl'is
haveblos	hav'ebl'os
havebleco	hav'ebl'ec'o
haveblecon	hav'ebl'ec'o'n
havenda	hav'end'a
havendaj	hav'end'a'j
havendaĵo	hav'end'aĵ'o
havendaĵoj	hav'end'aĵ'o'j
havigas	hav'ig'as
havigi	hav'ig'i
havigis	hav'ig'is
havigo	hav'ig'o
havigon	hav'ig'o'n
havigos	hav'ig'os
havigu	hav'ig'u
havigus	hav'ig'us
havigado	hav'ig'ad'o
havigante	hav'ig'ant'e
havigita	hav'ig'it'a
havigitaj	hav'ig'it'a'j
havinda	hav'ind'a
havinta	hav'int'a
havintaj	hav'int'a'j
havinte	hav'int'e
havintus	hav'int'us
havita	hav'it'a
havitaj	hav'it'a'j
havaja	havaj'a
havajaj	havaj'a'j
havajan	havaj'a'n
havajo	havaj'o
havajon	havaj'o'n
havajano	havaj'an'o
havajanoj	havaj'an'o'j
havana	havan'a
havano	havan'o
havena	haven'a
havenaj	haven'a'j
havenan	haven'a'n
haveno	haven'o
havenoj	haven'o'j
havenojn	haven'o'j'n
havenon	haven'o'n
haveneto	haven'et'o
havenurbo	haven'urb'o
havenurboj	haven'urb'o'j
havenurbojn	haven'urb'o'j'n
havenurbon	haven'urb'o'n
hazarda	hazard'a
hazardaj	hazard'a'j
hazardajn	hazard'a'j'n
hazardan	hazard'a'n
hazarde	hazard'e
hazardo	hazard'o
hazardoj	hazard'o'j
hazardon	hazard'o'n
hazardeco	hazard'ec'o
hazardigo	hazard'ig'o
hazardludo	hazard'lud'o
hazardludoj	hazard'lud'o'j
hazardludon	hazard'lud'o'n
hazardludanto	hazard'lud'ant'o
hebrea	hebre'a
hebreaj	hebre'a'j
hebreajn	hebre'a'j'n
hebrean	hebre'a'n
hebree	hebre'e
hebreo	hebre'o
hebreoj	hebre'o'j
hebreojn	hebre'o'j'n
hebreon	hebre'o'n
hebreismo	hebre'ism'o
hebridoj	hebrid'o'j
hedera	heder'a
hedero	heder'o
hedonismo	hedonism'o
hedonisto	hedonist'o
hefesto	hefest'o
hegemonia	hegemoni'a
hegemoniaj	hegemoni'a'j
hegemonian	hegemoni'a'n
hegemonias	hegemoni'as
hegemonie	hegemoni'e
hegemoniis	hegemoni'is
hegemonio	hegemoni'o
hegemonion	hegemoni'o'n
heĝo	heĝ'o
heĝoj	heĝ'o'j
heĝon	heĝ'o'n
heĝfondusoj	heĝ'fondus'o'j
hejma	hejm'a
hejmaj	hejm'a'j
hejmajn	hejm'a'j'n
hejman	hejm'a'n
hejmas	hejm'as
hejme	hejm'e
hejmen	hejm'e'n
hejmo	hejm'o
hejmoj	hejm'o'j
hejmojn	hejm'o'j'n
hejmon	hejm'o'n
hejmanoj	hejm'an'o'j
hejmanto	hejm'ant'o
hejmantoj	hejm'ant'o'j
hejmaparatoj	hejm'aparat'o'j
hejmaresto	hejm'arest'o
hejmareston	hejm'arest'o'n
hejmbestoj	hejm'best'o'j
hejmeniras	hejm'e'n'ir'as
hejmeniri	hejm'e'n'ir'i
hejmeniris	hejm'e'n'ir'is
hejmeniro	hejm'e'n'ir'o
hejmeniros	hejm'e'n'ir'os
hejmeniru	hejm'e'n'ir'u
hejmenirante	hejm'e'n'ir'ant'e
hejmenvenis	hejm'e'n'ven'is
hejmenveninta	hejm'e'n'ven'int'a
hejmeca	hejm'ec'a
hejmece	hejm'ec'e
hejmfaritaj	hejm'far'it'a'j
hejmfronto	hejm'front'o
hejmigitaj	hejm'ig'it'a'j
hejmiĝas	hejm'iĝ'as
hejmiĝi	hejm'iĝ'i
hejmiĝis	hejm'iĝ'is
hejmkomunumo	hejm'komun'um'o
hejmkomunumoj	hejm'komun'um'o'j
hejmkomunumojn	hejm'komun'um'o'j'n
hejmlaboro	hejm'labor'o
hejmlanda	hejm'land'a
hejmlanden	hejm'land'e'n
hejmlando	hejm'land'o
hejmlandoj	hejm'land'o'j
hejmlandon	hejm'land'o'n
hejmloko	hejm'lok'o
hejmlokoj	hejm'lok'o'j
hejmlokon	hejm'lok'o'n
hejmmatĉojn	hejm'matĉ'o'j'n
hejmmondo	hejm'mond'o
hejmoloko	hejm'o'lok'o
hejmpaĝa	hejm'paĝ'a
hejmpagho	hejm'paĝ'o
hejmpaĝo	hejm'paĝ'o
hejmpaĝoj	hejm'paĝ'o'j
hejmpaĝon	hejm'paĝ'o'n
hejmplanedo	hejm'planed'o
hejmregiono	hejm'region'o
hejmsopiras	hejm'sopir'as
hejmsopiro	hejm'sopir'o
hejmsopiron	hejm'sopir'o'n
hejmŝtato	hejm'ŝtat'o
hejmtasko	hejm'task'o
hejmtaskoj	hejm'task'o'j
hejmtaskojn	hejm'task'o'j'n
hejmtaskon	hejm'task'o'n
hejmteritorio	hejm'teritori'o
hejmteritorioj	hejm'teritori'o'j
hejmurbo	hejm'urb'o
hejmurbon	hejm'urb'o'n
hejmuzo	hejm'uz'o
hejmuzantoj	hejm'uz'ant'o'j
hejmvilaĝo	hejm'vilaĝ'o
hejmvojo	hejm'voj'o
hejtas	hejt'as
hejti	hejt'i
hejtis	hejt'is
hejto	hejt'o
hejtado	hejt'ad'o
hejtadon	hejt'ad'o'n
hejtaĵoj	hejt'aĵ'o'j
hejtaĵon	hejt'aĵ'o'n
hejtata	hejt'at'a
hejtilo	hejt'il'o
hejtiloj	hejt'il'o'j
hejtilon	hejt'il'o'n
hejtisto	hejt'ist'o
hejtistoj	hejt'ist'o'j
hekato	hekat'o
heksametro	heksametr'o
heksametroj	heksametr'o'j
hektaro	hektar'o
hektaroj	hektar'o'j
hektarojn	hektar'o'j'n
hektoro	hektor'o
hektoron	hektor'o'n
hela	hel'a
helaj	hel'a'j
helajn	hel'a'j'n
helan	hel'a'n
helas	hel'as
hele	hel'e
helo	hel'o
helada	hel'ad'a
helblua	hel'blu'a
helbluaj	hel'blu'a'j
helbluan	hel'blu'a'n
helbruna	hel'brun'a
helbrunaj	hel'brun'a'j
helbrunajn	hel'brun'a'j'n
helbrunan	hel'brun'a'n
heleco	hel'ec'o
helecon	hel'ec'o'n
helflava	hel'flav'a
helflavaj	hel'flav'a'j
helgriza	hel'griz'a
helgrizaj	hel'griz'a'j
helgrizajn	hel'griz'a'j'n
helgrizan	hel'griz'a'n
heligas	hel'ig'as
heligis	hel'ig'is
heliĝas	hel'iĝ'as
heliĝis	hel'iĝ'is
heliĝos	hel'iĝ'os
helkolora	hel'kolor'a
helkoloraj	hel'kolor'a'j
helkoloroj	hel'kolor'o'j
helokula	hel'okul'a
helotoj	hel'ot'o'j
helruĝa	hel'ruĝ'a
helverda	hel'verd'a
helverdaj	hel'verd'a'j
helena	helen'a
helenaj	helen'a'j
helenajn	helen'a'j'n
helenan	helen'a'n
helene	helen'e
heleno	helen'o
helenoj	helen'o'j
helenojn	helen'o'j'n
helenon	helen'o'n
helenisma	helen'ism'a
helenismaj	helen'ism'a'j
helenisman	helen'ism'a'n
helenismo	helen'ism'o
helenujo	helen'uj'o
helica	helic'a
helico	helic'o
helicoj	helic'o'j
helicojn	helic'o'j'n
helicon	helic'o'n
helika	helik'a
heliko	helik'o
helikoj	helik'o'j
helikojn	helik'o'j'n
helikon	helik'o'n
helikforma	helik'form'a
helikformaj	helik'form'a'j
helikformajn	helik'form'a'j'n
helikforman	helik'form'a'n
helikoptero	helikopter'o
helikopteroj	helikopter'o'j
helikopterojn	helikopter'o'j'n
helikopteron	helikopter'o'n
heliopolo	heliopol'o
heliumo	helium'o
heliumon	helium'o'n
helmo	helm'o
helmon	helm'o'n
helpa	help'a
helpaj	help'a'j
helpajn	help'a'j'n
helpan	help'a'n
helpas	help'as
helpe	help'e
helpi	help'i
helpis	help'is
helpo	help'o
helpoj	help'o'j
helpojn	help'o'j'n
helpon	help'o'n
helpos	help'os
helpu	help'u
helpus	help'us
helpadi	help'ad'i
helpadis	help'ad'is
helpado	help'ad'o
helpadon	help'ad'o'n
helpanta	help'ant'a
helpantaj	help'ant'a'j
helpantajn	help'ant'a'j'n
helpantan	help'ant'a'n
helpante	help'ant'e
helpanto	help'ant'o
helpantoj	help'ant'o'j
helpantojn	help'ant'o'j'n
helpanton	help'ant'o'n
helpantino	help'ant'in'o
helpantinon	help'ant'in'o'n
helpata	help'at'a
helpataj	help'at'a'j
helpate	help'at'e
helpdeĵorantaro	help'deĵor'ant'ar'o
helpdona	help'don'a
helpdonaj	help'don'a'j
helpema	help'em'a
helpemaj	help'em'a'j
helpemajn	help'em'a'j'n
helpeman	help'em'a'n
helpeme	help'em'e
helpemo	help'em'o
helpemon	help'em'o'n
helpepiskopo	help'episkop'o
helpeti	help'et'i
helpilo	help'il'o
helpiloj	help'il'o'j
helpilojn	help'il'o'j'n
helpilon	help'il'o'n
helpinta	help'int'a
helpintaj	help'int'a'j
helpintus	help'int'us
helpisto	help'ist'o
helpistoj	help'ist'o'j
helpita	help'it'a
helpitaj	help'it'a'j
helpite	help'it'e
helplingvo	help'lingv'o
helplingvoj	help'lingv'o'j
helplingvon	help'lingv'o'n
helpobezona	help'o'bezon'a
helpobezonaj	help'o'bezon'a'j
helpopeton	help'o'pet'o'n
helposignoj	help'o'sign'o'j
helppaĝon	help'paĝ'o'n
helpservoj	help'serv'o'j
helpservojn	help'serv'o'j'n
helpsistemo	help'sistem'o
helpsistemoj	help'sistem'o'j
helpverbo	help'verb'o
helpverboj	help'verb'o'j
helpverbon	help'verb'o'n
helsinka	helsink'a
helsinki	helsink'i
helsinko	helsink'o
helveta	helvet'a
hematio	hemati'o
hematito	hematit'o
hemianopsio	hemi'anopsi'o
hemisfero	hemi'sfer'o
hemisferoj	hemi'sfer'o'j
hemisferojn	hemi'sfer'o'j'n
hemisferon	hemi'sfer'o'n
hemikranio	hemikrani'o
hemoglobino	hemoglobin'o
hemoglobinon	hemoglobin'o'n
hemoragia	hemoragi'a
hemoragio	hemoragi'o
hemoroidoj	hemoroid'o'j
hemoroidojn	hemoroid'o'j'n
henan	hen'a'n
henas	hen'as
henis	hen'is
henano	henan'o
henanprovinco	henan'provinc'o
henriko	henrik'o
henrikon	henrik'o'n
hentajo	hentaj'o
hepata	hepat'a
hepataj	hepat'a'j
hepatan	hepat'a'n
hepato	hepat'o
hepatoj	hepat'o'j
hepaton	hepat'o'n
hepatitis	hepat'it'is
hepatito	hepat'it'o
hepatmalsano	hepat'mal'san'o
hepatocitoj	hepat'o'cit'o'j
herakla	herakl'a
heraklo	herakl'o
heraklon	herakl'o'n
heraklidoj	herakl'id'o'j
heraklito	heraklit'o
heraldika	heraldik'a
heraldikaj	heraldik'a'j
heraldike	heraldik'e
heraldiko	heraldik'o
herba	herb'a
herbaj	herb'a'j
herbajn	herb'a'j'n
herban	herb'a'n
herbo	herb'o
herboj	herb'o'j
herbojn	herb'o'j'n
herbon	herb'o'n
herbaĉo	herb'aĉ'o
herbaĉoj	herb'aĉ'o'j
herbaĵo	herb'aĵ'o
herbaro	herb'ar'o
herbaron	herb'ar'o'n
herbeca	herb'ec'a
herbecaj	herb'ec'a'j
herbeja	herb'ej'a
herbejaj	herb'ej'a'j
herbejo	herb'ej'o
herbejoj	herb'ej'o'j
herbejojn	herb'ej'o'j'n
herbejon	herb'ej'o'n
herberoj	herb'er'o'j
herbeto	herb'et'o
herbokovrita	herb'o'kovr'it'a
herboradikoj	herb'o'radik'o'j
herbotapiŝo	herb'o'tapiŝ'o
herbotapiŝon	herb'o'tapiŝ'o'n
herbovoraj	herb'o'vor'a'j
herbovoruloj	herb'o'vor'ul'o'j
herbicido	herbicid'o
herbicidoj	herbicid'o'j
herbicidojn	herbicid'o'j'n
hercegovino	hercegovin'o
hereda	hered'a
heredaj	hered'a'j
heredajn	hered'a'j'n
heredan	hered'a'n
heredas	hered'as
herede	hered'e
heredi	hered'i
heredis	hered'is
heredo	hered'o
heredoj	hered'o'j
heredon	hered'o'n
heredos	hered'os
heredu	hered'u
heredus	hered'us
heredado	hered'ad'o
heredadon	hered'ad'o'n
heredaĵa	hered'aĵ'a
heredaĵaj	hered'aĵ'a'j
heredajho	hered'aĵ'o
heredaĵo	hered'aĵ'o
heredaĵoj	hered'aĵ'o'j
heredaĵojn	hered'aĵ'o'j'n
heredaĵon	hered'aĵ'o'n
heredaĵbiblioteko	hered'aĵ'bibliotek'o
heredante	hered'ant'e
heredanto	hered'ant'o
heredantoj	hered'ant'o'j
heredantojn	hered'ant'o'j'n
heredanton	hered'ant'o'n
heredantino	hered'ant'in'o
heredata	hered'at'a
heredataj	hered'at'a'j
heredeco	hered'ec'o
heredecon	hered'ec'o'n
heredigas	hered'ig'as
heredigi	hered'ig'i
heredigis	hered'ig'is
heredigante	hered'ig'ant'e
heredigita	hered'ig'it'a
herediĝas	hered'iĝ'as
heredinta	hered'int'a
heredinto	hered'int'o
heredintoj	hered'int'o'j
heredita	hered'it'a
hereditaj	hered'it'a'j
hereditajn	hered'it'a'j'n
hereditan	hered'it'a'n
heredonto	hered'ont'o
heredontoj	hered'ont'o'j
heredonton	hered'ont'o'n
hereza	herez'a
herezaj	herez'a'j
herezan	herez'a'n
herezo	herez'o
herezoj	herez'o'j
herezojn	herez'o'j'n
herezon	herez'o'n
herezulo	herez'ul'o
herezuloj	herez'ul'o'j
herezulojn	herez'ul'o'j'n
herkulo	herkul'o
hermafroditaj	hermafrodit'a'j
hermafrodito	hermafrodit'o
hermafroditoj	hermafrodit'o'j
hermana	herman'a
hermano	herman'o
hermeneŭtika	hermeneŭtik'a
hermeneŭtiko	hermeneŭtik'o
hermeso	hermes'o
hermetika	hermetik'a
hermetikaj	hermetik'a'j
hermetikan	hermetik'a'n
hermetike	hermetik'e
hernio	herni'o
herniobandaĝo	herni'o'bandaĝ'o
herniobandaĝoj	herni'o'bandaĝ'o'j
heroa	hero'a
heroaj	hero'a'j
heroajn	hero'a'j'n
heroan	hero'a'n
heroe	hero'e
heroo	hero'o
herooj	hero'o'j
heroojn	hero'o'j'n
heroon	hero'o'n
heroaĵo	hero'aĵ'o
heroaĵoj	hero'aĵ'o'j
heroaĵojn	hero'aĵ'o'j'n
heroaĵon	hero'aĵ'o'n
heroeca	hero'ec'a
heroeco	hero'ec'o
heroecon	hero'ec'o'n
heroismo	hero'ism'o
herodo	herod'o
herodoto	herodot'o
heroino	heroin'o
heroinoj	heroin'o'j
heroinojn	heroin'o'j'n
heroinon	heroin'o'n
heroldas	herold'as
heroldo	herold'o
heroldoj	herold'o'j
heroldon	herold'o'n
herpeto	herpet'o
hesio	hes'i'o
heslando	hes'land'o
hetajro	hetajr'o
hetajroj	hetajr'o'j
hetajron	hetajr'o'n
heteroatomoj	hetero'atom'o'j
heterocikla	heterocikl'a
heterogena	heterogen'a
heterogenaj	heterogen'a'j
heterogenan	heterogen'a'n
hetmano	hetman'o
heziodo	heziod'o
hezita	hezit'a
hezitas	hezit'as
hezite	hezit'e
heziti	hezit'i
hezitis	hezit'is
hezito	hezit'o
hezitoj	hezit'o'j
hezitojn	hezit'o'j'n
heziton	hezit'o'n
hezitos	hezit'os
hezitu	hezit'u
hezitus	hezit'us
hezitado	hezit'ad'o
hezitante	hezit'ant'e
hezitema	hezit'em'a
hezitemaj	hezit'em'a'j
heziteme	hezit'em'e
hezitemo	hezit'em'o
hiacinto	hiacint'o
hiato	hiat'o
hibrida	hibrid'a
hibridaj	hibrid'a'j
hibridajn	hibrid'a'j'n
hibridan	hibrid'a'n
hibrido	hibrid'o
hibridoj	hibrid'o'j
hibridojn	hibrid'o'j'n
hibridon	hibrid'o'n
hibridigo	hibrid'ig'o
hibridiĝas	hibrid'iĝ'as
hibridiĝo	hibrid'iĝ'o
hida	hid'a
hidaj	hid'a'j
hidan	hid'a'n
hidrosovebla	hid'ros'ov'ebl'a
hidrosoveblaj	hid'ros'ov'ebl'a'j
hidalgo	hidalg'o
hidro	hidr'o
hidrdinamika	hidr'dinamik'a
hidrelektra	hidr'elektr'a
hidrelektraj	hidr'elektr'a'j
hidrido	hidr'id'o
hidridoj	hidr'id'o'j
hidroelektra	hidr'o'elektr'a
hidroelektraj	hidr'o'elektr'a'j
hidrofobia	hidr'o'fobi'a
hidrofobiaj	hidr'o'fobi'a'j
hidrokarbido	hidr'o'karb'id'o
hidrokarbidoj	hidr'o'karb'id'o'j
hidrokarbidojn	hidr'o'karb'id'o'j'n
hidrokarbona	hidr'o'karbon'a
hidrokarbonaj	hidr'o'karbon'a'j
hidrokarbonoj	hidr'o'karbon'o'j
hidrokarbonido	hidr'o'karbon'id'o
hidrokarbonidoj	hidr'o'karbon'id'o'j
hidrokulturo	hidr'o'kultur'o
hidrostatika	hidr'o'statik'a
hidrotermikaj	hidr'o'termik'a'j
hidroksido	hidr'oksid'o
hidroksidon	hidr'oksid'o'n
hidrarga	hidrarg'a
hidrargo	hidrarg'o
hidrargon	hidrarg'o'n
hidrataj	hidrat'a'j
hidratoj	hidrat'o'j
hidratigo	hidrat'ig'o
hidratigita	hidrat'ig'it'a
hidratigitaj	hidrat'ig'it'a'j
hidraŭlika	hidraŭlik'a
hidraŭlikaj	hidraŭlik'a'j
hidraŭlikajn	hidraŭlik'a'j'n
hidraŭlikan	hidraŭlik'a'n
hidraŭlike	hidraŭlik'e
hidraŭliko	hidraŭlik'o
hidrofila	hidrofil'a
hidrofilaj	hidrofil'a'j
hidrofoba	hidrofob'a
hidrofobaj	hidrofob'a'j
hidrogena	hidrogen'a
hidrogenaj	hidrogen'a'j
hidrogenajn	hidrogen'a'j'n
hidrogenan	hidrogen'a'n
hidrogeno	hidrogen'o
hidrogenoj	hidrogen'o'j
hidrogenon	hidrogen'o'n
hidrogenatomo	hidrogen'atom'o
hidrogenatomoj	hidrogen'atom'o'j
hidrogenbombo	hidrogen'bomb'o
hidrogenbomboj	hidrogen'bomb'o'j
hidrogenfuelo	hidrogen'fuel'o
hidrogengaso	hidrogen'gas'o
hidrogengason	hidrogen'gas'o'n
hidrogenjonoj	hidrogen'jon'o'j
hidrogenproduktado	hidrogen'produkt'ad'o
hidrogenstokado	hidrogen'stok'ad'o
hidrografia	hidrografi'a
hidroksila	hidroksil'a
hidrologia	hidrolog'i'a
hidrologiaj	hidrolog'i'a'j
hidrologio	hidrolog'i'o
hidroplano	hidroplan'o
hieno	hien'o
hienoj	hien'o'j
hienojn	hien'o'j'n
hierarĥio	hierarĥi'o
hierarkia	hierarki'a
hierarkiaj	hierarki'a'j
hierarkiajn	hierarki'a'j'n
hierarkian	hierarki'a'n
hierarkie	hierarki'e
hierarkio	hierarki'o
hierarkioj	hierarki'o'j
hierarkiojn	hierarki'o'j'n
hierarkion	hierarki'o'n
hieraŭ	hieraŭ
hieraŭa	hieraŭ'a
hieraŭaj	hieraŭ'a'j
hieraŭan	hieraŭ'a'n
hieraŭo	hieraŭ'o
hieroglifa	hieroglif'a
hieroglifaj	hieroglif'a'j
hieroglifo	hieroglif'o
hieroglifoj	hieroglif'o'j
hieroglifojn	hieroglif'o'j'n
hieronimo	hieronim'o
higiena	higien'a
higienaj	higien'a'j
higienajn	higien'a'j'n
higienan	higien'a'n
higieno	higien'o
higienon	higien'o'n
higroskopa	higroskop'a
hilberta	hilbert'a
hilbertaj	hilbert'a'j
himalaja	himalaj'a
himalajaj	himalaj'a'j
himalajo	himalaj'o
himalajoj	himalaj'o'j
himeno	himen'o
himenopteroj	himenopter'o'j
himno	himn'o
himnoj	himn'o'j
himnojn	himn'o'j'n
himnon	himn'o'n
himnaro	himn'ar'o
hino	hin'o
hinoj	hin'o'j
hinda	hind'a
hindaj	hind'a'j
hindajn	hind'a'j'n
hindan	hind'a'n
hindo	hind'o
hindoj	hind'o'j
hindon	hind'o'n
hindeŭropa	hind'eŭrop'a
hindeŭropaj	hind'eŭrop'a'j
hindia	hind'i'a
hindiaj	hind'i'a'j
hindian	hind'i'a'n
hindio	hind'i'o
hindion	hind'i'o'n
hindirana	hind'iran'a
hindoĉina	hind'o'ĉin'a
hindoĉinio	hind'o'ĉin'i'o
hindoeŭropa	hind'o'eŭrop'a
hindoeŭropaj	hind'o'eŭrop'a'j
hindoeŭropajn	hind'o'eŭrop'a'j'n
hindoeŭropan	hind'o'eŭrop'a'n
hindujo	hind'uj'o
hindujon	hind'uj'o'n
hindua	hindu'a
hinduaj	hindu'a'j
hinduajn	hindu'a'j'n
hinduan	hindu'a'n
hinduo	hindu'o
hinduoj	hindu'o'j
hinduojn	hindu'o'j'n
hinduisma	hindu'ism'a
hinduismaj	hindu'ism'a'j
hinduismo	hindu'ism'o
hinduismon	hindu'ism'o'n
hinduistoj	hindu'ist'o'j
hindutemploj	hindu'templ'o'j
hindukuŝo	hindukuŝ'o
hindustana	hindustan'a
hindustano	hindustan'o
hipertrofio	hiper'trofi'o
hiperbola	hiperbol'a
hiperbolo	hiperbol'o
hiperebeno	hipereben'o
hiphopa	hiphop'a
hiphopo	hiphop'o
hipioj	hipi'o'j
hipnota	hipnot'a
hipnotaj	hipnot'a'j
hipnoto	hipnot'o
hipnotigita	hipnot'ig'it'a
hipodromo	hipodrom'o
hipogeo	hipoge'o
hipokampo	hipokamp'o
hipokampoj	hipokamp'o'j
hipokrata	hipokrat'a
hipokrato	hipokrat'o
hipokrita	hipokrit'a
hipokritaj	hipokrit'a'j
hipokritan	hipokrit'a'n
hipokrite	hipokrit'e
hipokrito	hipokrit'o
hipokriteco	hipokrit'ec'o
hipokritecon	hipokrit'ec'o'n
hipokritulo	hipokrit'ul'o
hipokrituloj	hipokrit'ul'o'j
hipolito	hipolit'o
hipoliton	hipolit'o'n
hipopotamo	hipopotam'o
hipopotamoj	hipopotam'o'j
hipostazo	hipostaz'o
hipoteko	hipotek'o
hipotekoj	hipotek'o'j
hipotekon	hipotek'o'n
hipotenuzo	hipotenuz'o
hipoteza	hipotez'a
hipotezaj	hipotez'a'j
hipotezajn	hipotez'a'j'n
hipotezan	hipotez'a'n
hipotezas	hipotez'as
hipoteze	hipotez'e
hipotezi	hipotez'i
hipotezis	hipotez'is
hipotezo	hipotez'o
hipotezoj	hipotez'o'j
hipotezojn	hipotez'o'j'n
hipotezon	hipotez'o'n
hipotezita	hipotez'it'a
hipotezitaj	hipotez'it'a'j
hipotezite	hipotez'it'e
hipoteztestado	hipotez'test'ad'o
hirta	hirt'a
hirtaj	hirt'a'j
hirtan	hirt'a'n
hirtigis	hirt'ig'is
hirtiĝis	hirt'iĝ'is
hirudo	hirud'o
hirudoj	hirud'o'j
hirunda	hirund'a
hirundo	hirund'o
hirundoj	hirund'o'j
hisi	his'i
hisis	his'is
hisita	his'it'a
hispana	hispan'a
hispanaj	hispan'a'j
hispanajn	hispan'a'j'n
hispanan	hispan'a'n
hispane	hispan'e
hispano	hispan'o
hispanoj	hispan'o'j
hispanojn	hispan'o'j'n
hispanon	hispan'o'n
hispanamerika	hispan'amerik'a
hispanamerikaj	hispan'amerik'a'j
hispanameriko	hispan'amerik'o
hispania	hispan'i'a
hispaniaj	hispan'i'a'j
hispanio	hispan'i'o
hispanion	hispan'i'o'n
hispanino	hispan'in'o
hispanlingva	hispan'lingv'a
hispanlingvaj	hispan'lingv'a'j
hispanlingvan	hispan'lingv'a'n
hispanlingve	hispan'lingv'e
hispanlingvanoj	hispan'lingv'an'o'j
hispanparolanta	hispan'parol'ant'a
hispanparolantaj	hispan'parol'ant'a'j
hispanujo	hispan'uj'o
hista	hist'a
histo	hist'o
histoj	hist'o'j
histojn	hist'o'j'n
histon	hist'o'n
histodamaĝo	hist'o'damaĝ'o
histologio	hist'olog'i'o
histamina	histamin'a
histamino	histamin'o
histeria	histeri'a
histeriaj	histeri'a'j
histerie	histeri'e
histerio	histeri'o
histerion	histeri'o'n
historia	histori'a
historiaj	histori'a'j
historiajn	histori'a'j'n
historian	histori'a'n
historie	histori'e
historio	histori'o
historioj	histori'o'j
historiojn	histori'o'j'n
historion	histori'o'n
historiaĵoj	histori'aĵ'o'j
historieco	histori'ec'o
historiesploro	histori'esplor'o
historieta	histori'et'a
historieto	histori'et'o
historietoj	histori'et'o'j
historietojn	histori'et'o'j'n
historieton	histori'et'o'n
historiismo	histori'ism'o
historiisto	histori'ist'o
historiistoj	histori'ist'o'j
historiistojn	histori'ist'o'j'n
historiiston	histori'ist'o'n
historiistino	histori'ist'in'o
historiografia	historiograf'i'a
historiografiaj	historiograf'i'a'j
historiografio	historiograf'i'o
historiografion	historiograf'i'o'n
histriko	histrik'o
histrikoj	histrik'o'j
hitlera	hitler'a
hitlero	hitler'o
hitleron	hitler'o'n
hitleranoj	hitler'an'o'j
hobia	hobi'a
hobiaj	hobi'a'j
hobie	hobi'e
hobio	hobi'o
hobioj	hobi'o'j
hobiojn	hobi'o'j'n
hobion	hobi'o'n
hobiistoj	hobi'ist'o'j
hobiuloj	hobi'ul'o'j
hobojo	hoboj'o
hobojoj	hoboj'o'j
hobojon	hoboj'o'n
hodiau	hodiaŭ
hodiaŭ	hodiaŭ
hodiaua	hodiaŭ'a
hodiaŭa	hodiaŭ'a
hodiauaj	hodiaŭ'a'j
hodiaŭaj	hodiaŭ'a'j
hodiaŭajn	hodiaŭ'a'j'n
hodiaŭan	hodiaŭ'a'n
hodiaŭe	hodiaŭ'e
hodiaŭo	hodiaŭ'o
hodiaŭon	hodiaŭ'o'n
hoka	hok'a
hokan	hok'a'n
hoko	hok'o
hokoj	hok'o'j
hokojn	hok'o'j'n
hokon	hok'o'n
hoketo	hok'et'o
hoketon	hok'et'o'n
hokita	hok'it'a
hokoforma	hok'o'form'a
hokajdo	hokajd'o
hokeo	hoke'o
hokeon	hoke'o'n
hokedisko	hoke'disk'o
hokediskon	hoke'disk'o'n
holanda	holand'a
holandaj	holand'a'j
holando	holand'o
holandanoj	holand'an'o'j
holdo	hold'o
holivuda	holivud'a
holivudo	holivud'o
holoceno	holocen'o
holografia	holografi'a
holografian	holografi'a'n
holografio	holografi'o
hologramo	hologram'o
hologramoj	hologram'o'j
holokaŭsto	holokaŭst'o
holokaŭston	holokaŭst'o'n
holomorfa	holomorf'a
holoturioj	holoturi'o'j
homa	hom'a
homaj	hom'a'j
homajn	hom'a'j'n
homan	hom'a'n
home	hom'e
homo	hom'o
homoj	hom'o'j
homojn	hom'o'j'n
homon	hom'o'n
homarajtaj	hom'a'rajt'a'j
homajrajtojmalobservoj	hom'aj'rajt'oj'mal'observ'o'j
homama	hom'am'a
homamaj	hom'am'a'j
homamo	hom'am'o
homamon	hom'am'o'n
homamaso	hom'amas'o
homamasoj	hom'amas'o'j
homamasojn	hom'amas'o'j'n
homamason	hom'amas'o'n
homamasfinancado	hom'amas'financ'ad'o
homamasiĝo	hom'amas'iĝ'o
homanimo	hom'anim'o
homanimoj	hom'anim'o'j
homanimon	hom'anim'o'n
homara	hom'ar'a
homaraj	hom'ar'a'j
homaran	hom'ar'a'n
homaro	hom'ar'o
homaroj	hom'ar'o'j
homaron	hom'ar'o'n
homarana	hom'ar'an'a
homarane	hom'ar'an'e
homarano	hom'ar'an'o
homaranoj	hom'ar'an'o'j
homaranisma	hom'ar'an'ism'a
homaranismo	hom'ar'an'ism'o
homaranismon	hom'ar'an'ism'o'n
hombuĉado	hom'buĉ'ad'o
homcerbo	hom'cerb'o
homeca	hom'ec'a
homecaj	hom'ec'a'j
homecan	hom'ec'a'n
homeco	hom'ec'o
homecon	hom'ec'o'n
homedoj	hom'ed'o'j
homekipa	hom'ekip'a
homekipas	hom'ekip'as
homekipi	hom'ekip'i
homekipis	hom'ekip'is
homekipo	hom'ekip'o
homekipita	hom'ekip'it'a
homekipitaj	hom'ekip'it'a'j
hometo	hom'et'o
hometoj	hom'et'o'j
hometon	hom'et'o'n
homfarita	hom'far'it'a
homfaritaj	hom'far'it'a'j
homfaritajn	hom'far'it'a'j'n
homfiguro	hom'figur'o
homfiguroj	hom'figur'o'j
homfigurojn	hom'figur'o'j'n
homformaj	hom'form'a'j
homforto	hom'fort'o
homfortoj	hom'fort'o'j
homfratoj	hom'frat'o'j
homgrupo	hom'grup'o
homgrupoj	hom'grup'o'j
homgrupon	hom'grup'o'n
homido	hom'id'o
homidoj	hom'id'o'j
homiĝo	hom'iĝ'o
homino	hom'in'o
hominda	hom'ind'a
homkompreno	hom'kompren'o
homkomputila	hom'komput'il'a
homkoro	hom'kor'o
homloĝloko	hom'loĝ'lok'o
homlupo	hom'lup'o
hommanĝantoj	hom'manĝ'ant'o'j
hommaŝina	hom'maŝin'a
hommortigo	hom'mort'ig'o
homnaturo	hom'natur'o
homnaturon	hom'natur'o'n
homofobio	hom'o'fobi'o
homofero	hom'ofer'o
hompenso	hom'pens'o
hompersono	hom'person'o
homplena	hom'plen'a
homplenaj	hom'plen'a'j
homrajta	hom'rajt'a
homrajtaj	hom'rajt'a'j
homrajtan	hom'rajt'a'n
homrajto	hom'rajt'o
homrajtoj	hom'rajt'o'j
homrajtojn	hom'rajt'o'j'n
homscienco	hom'scienc'o
homsimio	hom'simi'o
homsimioj	hom'simi'o'j
homsimila	hom'simil'a
homsimilaj	hom'simil'a'j
homspeco	hom'spec'o
homspirito	hom'spirit'o
homeopatiaj	homeopat'i'a'j
homeopatio	homeopat'i'o
homera	homer'a
homeraj	homer'a'j
homero	homer'o
homeron	homer'o'n
homofonaj	homofon'a'j
homogena	homogen'a
homogenaj	homogen'a'j
homogenajn	homogen'a'j'n
homogenan	homogen'a'n
homogene	homogen'e
homogeneco	homogen'ec'o
homogenecon	homogen'ec'o'n
homogenigo	homogen'ig'o
homologa	homolog'a
homologaj	homolog'a'j
homologajn	homolog'a'j'n
homologio	homolog'i'o
homomorfio	homomorfi'o
homomorfioj	homomorfi'o'j
homonima	homonim'a
homonimo	homonim'o
homonimoj	homonim'o'j
homonimojn	homonim'o'j'n
honduro	hondur'o
honesta	honest'a
honestaj	honest'a'j
honestajn	honest'a'j'n
honestan	honest'a'n
honestas	honest'as
honeste	honest'e
honesto	honest'o
honeston	honest'o'n
honesteco	honest'ec'o
honestecon	honest'ec'o'n
honestulo	honest'ul'o
honestuloj	honest'ul'o'j
honkonga	honkong'a
honkongaj	honkong'a'j
honkongo	honkong'o
honkongon	honkong'o'n
honora	honor'a
honoraj	honor'a'j
honorajn	honor'a'j'n
honoran	honor'a'n
honoras	honor'as
honore	honor'e
honori	honor'i
honoris	honor'is
honoro	honor'o
honoroj	honor'o'j
honorojn	honor'o'j'n
honoron	honor'o'n
honoros	honor'os
honoru	honor'u
honorus	honor'us
honorado	honor'ad'o
honoranta	honor'ant'a
honorante	honor'ant'e
honorata	honor'at'a
honorataj	honor'at'a'j
honorgrado	honor'grad'o
honorgradon	honor'grad'o'n
honoriga	honor'ig'a
honorigas	honor'ig'as
honorigi	honor'ig'i
honorigis	honor'ig'is
honorigo	honor'ig'o
honorigoj	honor'ig'o'j
honorigon	honor'ig'o'n
honorigita	honor'ig'it'a
honorinda	honor'ind'a
honorindaj	honor'ind'a'j
honorindan	honor'ind'a'n
honorindulo	honor'ind'ul'o
honorita	honor'it'a
honoritaj	honor'it'a'j
honorofica	honor'ofic'a
honorofice	honor'ofic'e
honorario	honorari'o
honorarioj	honorari'o'j
honorariojn	honorari'o'j'n
honorarion	honorari'o'n
honta	hont'a
hontaj	hont'a'j
hontas	hont'as
honte	hont'e
honti	hont'i
hontis	hont'is
honto	hont'o
honton	hont'o'n
hontu	hont'u
hontus	hont'us
hontante	hont'ant'e
hontema	hont'em'a
honteme	hont'em'e
hontemo	hont'em'o
hontiga	hont'ig'a
hontigas	hont'ig'as
hontige	hont'ig'e
hontigi	hont'ig'i
hontigis	hont'ig'is
hontigo	hont'ig'o
hontigon	hont'ig'o'n
hontigita	hont'ig'it'a
hontinda	hont'ind'a
hontindaj	hont'ind'a'j
hontindajn	hont'ind'a'j'n
hontindan	hont'ind'a'n
hontindas	hont'ind'as
hontinde	hont'ind'e
hontindaĵo	hont'ind'aĵ'o
hope	hop'e
hopi	hop'i
hopioj	hopi'o'j
hoplito	hoplit'o
hoplitoj	hoplit'o'j
hora	hor'a
horaj	hor'a'j
hore	hor'e
horo	hor'o
horoj	hor'o'j
horojn	hor'o'j'n
horon	hor'o'n
horaro	hor'ar'o
horaroj	hor'ar'o'j
horarojn	hor'ar'o'j'n
horaron	hor'ar'o'n
horduono	hor'du'on'o
horduonon	hor'du'on'o'n
horeto	hor'et'o
horkvarono	hor'kvar'on'o
horzono	hor'zon'o
horzonoj	hor'zon'o'j
horacio	horaci'o
horda	hord'a
hordo	hord'o
hordoj	hord'o'j
hordon	hord'o'n
hordea	horde'a
hordeo	horde'o
hordeon	horde'o'n
horizonta	horizont'a
horizontaj	horizont'a'j
horizonte	horizont'e
horizonto	horizont'o
horizontoj	horizont'o'j
horizontojn	horizont'o'j'n
horizonton	horizont'o'n
horizontlinio	horizont'lini'o
horizontlinioj	horizont'lini'o'j
horizontala	horizontal'a
horizontalaj	horizontal'a'j
horizontalajn	horizontal'a'j'n
horizontalan	horizontal'a'n
horizontale	horizontal'e
horizontalo	horizontal'o
horloĝa	horloĝ'a
horlogho	horloĝ'o
horloĝo	horloĝ'o
horloĝoj	horloĝ'o'j
horloĝojn	horloĝ'o'j'n
horloĝon	horloĝ'o'n
horloĝciklo	horloĝ'cikl'o
horloĝeton	horloĝ'et'o'n
horloĝisto	horloĝ'ist'o
hormona	hormon'a
hormonaj	hormon'a'j
hormono	hormon'o
hormonoj	hormon'o'j
hormonojn	hormon'o'j'n
hormonon	hormon'o'n
horora	horor'a
hororaj	horor'a'j
hororajn	horor'a'j'n
hororan	horor'a'n
horore	horor'e
hororo	horor'o
hororoj	horor'o'j
hororon	horor'o'n
hororaĵoj	horor'aĵ'o'j
hororfilmojn	horor'film'o'j'n
hororiga	horor'ig'a
horoskopo	horoskop'o
horoskopoj	horoskop'o'j
horoskopon	horoskop'o'n
hortensia	hortensi'a
hortensio	hortensi'o
hortikultura	hortikultur'a
hortikulturaj	hortikultur'a'j
hortikulturo	hortikultur'o
hortikulturisto	hortikultur'ist'o
hortikulturistoj	hortikultur'ist'o'j
horuso	horus'o
hospico	hospic'o
hospicoj	hospic'o'j
hospitala	hospital'a
hospitalaj	hospital'a'j
hospitalajn	hospital'a'j'n
hospitalan	hospital'a'n
hospitalen	hospital'e'n
hospitalo	hospital'o
hospitaloj	hospital'o'j
hospitalojn	hospital'o'j'n
hospitalon	hospital'o'n
hospitaligitaj	hospital'ig'it'a'j
hostio	hosti'o
hostioj	hosti'o'j
hostiojn	hosti'o'j'n
hostion	hosti'o'n
hotela	hotel'a
hotelaj	hotel'a'j
hotelan	hotel'a'n
hotelo	hotel'o
hoteloj	hotel'o'j
hotelojn	hotel'o'j'n
hotelon	hotel'o'n
hotelĉambro	hotel'ĉambr'o
hotelĉambron	hotel'ĉambr'o'n
hotelestro	hotel'estr'o
hoteleto	hotel'et'o
hubuloj	hub'ul'o'j
hubejo	hubej'o
huberto	hubert'o
hufo	huf'o
hufoj	huf'o'j
hufojn	huf'o'j'n
hufon	huf'o'n
hufofero	huf'o'fer'o
hufuloj	huf'ul'o'j
hufumo	huf'um'o
hufumoj	huf'um'o'j
hugo	hug'o
hugon	hug'o'n
hugenotoj	hugenot'o'j
huligano	huligan'o
huliganoj	huligan'o'j
hume	hum'e
humo	hum'o
humon	hum'o'n
humana	human'a
humanaj	human'a'j
humanajn	human'a'j'n
humanan	human'a'n
humane	human'e
humaneca	human'ec'a
humanecan	human'ec'a'n
humaneco	human'ec'o
humanecon	human'ec'o'n
humanisma	human'ism'a
humanismaj	human'ism'a'j
humanisman	human'ism'a'n
humanismo	human'ism'o
humanismon	human'ism'o'n
humanista	human'ist'a
humanisto	human'ist'o
humanistoj	human'ist'o'j
humanitara	humanitar'a
humanitaraj	humanitar'a'j
humanitarajn	humanitar'a'j'n
humanitaran	humanitar'a'n
humanoida	humanoid'a
humanoidaj	humanoid'a'j
humanoidan	humanoid'a'n
humanoidoj	humanoid'o'j
humero	humer'o
humida	humid'a
humidaj	humid'a'j
humidajn	humid'a'j'n
humidan	humid'a'n
humide	humid'e
humido	humid'o
humidon	humid'o'n
humideco	humid'ec'o
humidecon	humid'ec'o'n
humidejoj	humid'ej'o'j
humidenhavo	humid'en'hav'o
humila	humil'a
humilaj	humil'a'j
humilan	humil'a'n
humile	humil'e
humilo	humil'o
humileco	humil'ec'o
humilecon	humil'ec'o'n
humiliga	humil'ig'a
humiligaj	humil'ig'a'j
humiligan	humil'ig'a'n
humiligas	humil'ig'as
humilige	humil'ig'e
humiligi	humil'ig'i
humiligis	humil'ig'is
humiligo	humil'ig'o
humiligoj	humil'ig'o'j
humiligojn	humil'ig'o'j'n
humiligon	humil'ig'o'n
humiligado	humil'ig'ad'o
humiligita	humil'ig'it'a
humiligitaj	humil'ig'it'a'j
humiliĝas	humil'iĝ'as
humiliĝi	humil'iĝ'i
humiliĝis	humil'iĝ'is
humiliĝo	humil'iĝ'o
humiluloj	humil'ul'o'j
humora	humor'a
humoraj	humor'a'j
humoro	humor'o
humoroj	humor'o'j
humorojn	humor'o'j'n
humoron	humor'o'n
humura	humur'a
humuraj	humur'a'j
humurajn	humur'a'j'n
humuran	humur'a'n
humure	humur'e
humuro	humur'o
humuroj	humur'o'j
humuron	humur'o'n
humuraĵo	humur'aĵ'o
humuraĵoj	humur'aĵ'o'j
humuristo	humur'ist'o
humurplena	humur'plen'a
humursento	humur'sent'o
humursenton	humur'sent'o'n
huna	hun'a
hunaj	hun'a'j
hunan	hun'a'n
hunoj	hun'o'j
hunojn	hun'o'j'n
hunano	hun'an'o
hunda	hund'a
hundaj	hund'a'j
hundan	hund'a'n
hunde	hund'e
hundo	hund'o
hundoj	hund'o'j
hundojn	hund'o'j'n
hundon	hund'o'n
hundaĉo	hund'aĉ'o
hundaro	hund'ar'o
hundeto	hund'et'o
hundeton	hund'et'o'n
hundido	hund'id'o
hundidoj	hund'id'o'j
hundidojn	hund'id'o'j'n
hundidon	hund'id'o'n
hundino	hund'in'o
hundinon	hund'in'o'n
hundodometon	hund'o'dom'et'o'n
hungara	hungar'a
hungaraj	hungar'a'j
hungarajn	hungar'a'j'n
hungaran	hungar'a'n
hungare	hungar'e
hungaro	hungar'o
hungaroj	hungar'o'j
hungarojn	hungar'o'j'n
hungardevena	hungar'de'ven'a
hungaria	hungar'i'a
hungarian	hungar'i'a'n
hungario	hungar'i'o
hungarion	hungar'i'o'n
hungarino	hungar'in'o
hungarlando	hungar'land'o
hungarlingva	hungar'lingv'a
hungarlingvaj	hungar'lingv'a'j
hungarlingve	hungar'lingv'e
hungarujo	hungar'uj'o
hupo	hup'o
hupado	hup'ad'o
hura	hura
hurais	hura'is
hurao	hura'o
huraado	hura'ad'o
huraistino	hura'ist'in'o
hurdo	hurd'o
hurdoj	hurd'o'j
hurlas	hurl'as
hurli	hurl'i
hurlis	hurl'is
hurlo	hurl'o
hurlado	hurl'ad'o
hurlante	hurl'ant'e
husana	hus'an'a
husanaj	hus'an'a'j
husanoj	hus'an'o'j
husaroj	husar'o'j