ia	i'a
iaj	i'a'j
iajn	i'a'j'n
ian	i'a'n
io	i'o
ion	i'o'n
iafoje	i'a'foj'e
iagrade	i'a'grad'e
iamaniere	i'a'manier'e
iarevanoj	i'a'rev'an'o'j
iasence	i'a'senc'e
iaspeca	i'a'spec'a
iaspecaj	i'a'spec'a'j
iaspecan	i'a'spec'a'n
ial	ial
iala	ial'a
iam	iam
iama	iam'a
iamaj	iam'a'j
iamajn	iam'a'j'n
iaman	iam'a'n
iame	iam'e
iamtiam	iam'tiam
iamajna	iam'ajn'a
iamajnakreskanta	iam'ajn'a'kresk'ant'a
iamajnakreskantan	iam'ajn'a'kresk'ant'a'n
iamajnavaria	iam'ajn'a'vari'a
ibera	iber'a
iberaj	iber'a'j
iberoj	iber'o'j
iberia	iber'i'a
iberiaj	iber'i'a'j
iberian	iber'i'a'n
iberio	iber'i'o
ibiso	ibis'o
ibisoj	ibis'o'j
ida	id'a
idaj	id'a'j
ide	id'e
ido	id'o
idoj	id'o'j
idojn	id'o'j'n
idon	id'o'n
idaro	id'ar'o
idaron	id'ar'o'n
idista	id'ist'a
idisto	id'ist'o
idistoj	id'ist'o'j
idkarto	id'kart'o
idozorgado	id'o'zorg'ad'o
idaho	idah'o
idea	ide'a
ideaj	ide'a'j
ideajn	ide'a'j'n
idean	ide'a'n
idee	ide'e
ideo	ide'o
ideoj	ide'o'j
ideojn	ide'o'j'n
ideon	ide'o'n
idearo	ide'ar'o
idearon	ide'ar'o'n
ideismo	ide'ism'o
ideologo	ide'olog'o
ideologoj	ide'olog'o'j
ideologia	ide'olog'i'a
ideologiaj	ide'olog'i'a'j
ideologiajn	ide'olog'i'a'j'n
ideologian	ide'olog'i'a'n
ideologie	ide'olog'i'e
ideologio	ide'olog'i'o
ideologioj	ide'olog'i'o'j
ideologiojn	ide'olog'i'o'j'n
ideologion	ide'olog'i'o'n
ideala	ideal'a
idealaj	ideal'a'j
idealajn	ideal'a'j'n
idealan	ideal'a'n
ideale	ideal'e
idealo	ideal'o
idealoj	ideal'o'j
idealojn	ideal'o'j'n
idealon	ideal'o'n
idealekzemplo	ideal'ekzempl'o
idealigo	ideal'ig'o
idealigita	ideal'ig'it'a
idealigitaj	ideal'ig'it'a'j
idealigitajn	ideal'ig'it'a'j'n
idealisma	ideal'ism'a
idealismaj	ideal'ism'a'j
idealisman	ideal'ism'a'n
idealisme	ideal'ism'e
idealismo	ideal'ism'o
idealismon	ideal'ism'o'n
idealista	ideal'ist'a
idealisto	ideal'ist'o
idealistoj	ideal'ist'o'j
identa	ident'a
identaj	ident'a'j
identajn	ident'a'j'n
identan	ident'a'n
identas	ident'as
idente	ident'e
idento	ident'o
identon	ident'o'n
identeca	ident'ec'a
identecan	ident'ec'a'n
identeco	ident'ec'o
identecoj	ident'ec'o'j
identecojn	ident'ec'o'j'n
identecon	ident'ec'o'n
identeckarton	ident'ec'kart'o'n
identiga	ident'ig'a
identigaj	ident'ig'a'j
identigajn	ident'ig'a'j'n
identigan	ident'ig'a'n
identigas	ident'ig'as
identigi	ident'ig'i
identigis	ident'ig'is
identigo	ident'ig'o
identigoj	ident'ig'o'j
identigon	ident'ig'o'n
identigos	ident'ig'os
identigu	ident'ig'u
identigado	ident'ig'ad'o
identigaĵo	ident'ig'aĵ'o
identigaĵoj	ident'ig'aĵ'o'j
identiganta	ident'ig'ant'a
identigante	ident'ig'ant'e
identigata	ident'ig'at'a
identigebla	ident'ig'ebl'a
identigeblaj	ident'ig'ebl'a'j
identigeblan	ident'ig'ebl'a'n
identigeblas	ident'ig'ebl'as
identigilo	ident'ig'il'o
identigiloj	ident'ig'il'o'j
identigilojn	ident'ig'il'o'j'n
identigilon	ident'ig'il'o'n
identigita	ident'ig'it'a
identigitaj	ident'ig'it'a'j
identigitajn	ident'ig'it'a'j'n
identigitan	ident'ig'it'a'n
identigite	ident'ig'it'e
identiĝas	ident'iĝ'as
identiĝi	ident'iĝ'i
identiĝis	ident'iĝ'is
identiĝo	ident'iĝ'o
ideografiaĵoj	ideografi'aĵ'o'j
ideografiaĵojn	ideografi'aĵ'o'j'n
ideogramo	ideogram'o
ideogramoj	ideogram'o'j
ideogramojn	ideogram'o'j'n
ideogramon	ideogram'o'n
idilia	idili'a
idiliaj	idili'a'j
idilian	idili'a'n
idilio	idili'o
idilioj	idili'o'j
idilion	idili'o'n
idioma	idiom'a
idiomo	idiom'o
idiomoj	idiom'o'j
idiomojn	idiom'o'j'n
idiomon	idiom'o'n
idiomajho	idiom'aĵ'o
idiomaĵo	idiom'aĵ'o
idiomaĵoj	idiom'aĵ'o'j
idiomaĵojn	idiom'aĵ'o'j'n
idiomaĵon	idiom'aĵ'o'n
idiosinkrazia	idiosinkrazi'a
idiosinkraziaj	idiosinkrazi'a'j
idiosinkrazioj	idiosinkrazi'o'j
idiota	idiot'a
idiotaj	idiot'a'j
idiotajn	idiot'a'j'n
idiote	idiot'e
idioto	idiot'o
idiotoj	idiot'o'j
idiotojn	idiot'o'j'n
idioton	idiot'o'n
idiotaĵo	idiot'aĵ'o
idioteco	idiot'ec'o
idiotismo	idiot'ism'o
idiotismoj	idiot'ism'o'j
idiotismojn	idiot'ism'o'j'n
idolo	idol'o
idoloj	idol'o'j
idolojn	idol'o'j'n
idolon	idol'o'n
idolanoj	idol'an'o'j
idolkulto	idol'kult'o
ie	ie
iea	ie'a
ien	ie'n
ietie	ie'tie
iel	iel
iele	iel'e
ieltiel	iel'tiel
ies	ies
iga	ig'a
igas	ig'as
igi	ig'i
igis	ig'is
igos	ig'os
igu	ig'u
igus	ig'us
igado	ig'ad'o
iganta	ig'ant'a
igantaj	ig'ant'a'j
igantajn	ig'ant'a'j'n
igantan	ig'ant'a'n
igante	ig'ant'e
iginta	ig'int'a
igintus	ig'int'us
igita	ig'it'a
igitaj	ig'it'a'j
igitajn	ig'it'a'j'n
igitan	ig'it'a'n
igite	ig'it'e
igverbo	ig'verb'o
igverboj	ig'verb'o'j
iĝas	iĝ'as
iĝi	iĝ'i
iĝis	iĝ'is
iĝos	iĝ'os
iĝu	iĝ'u
iĝus	iĝ'us
iĝadis	iĝ'ad'is
iĝado	iĝ'ad'o
iĝanta	iĝ'ant'a
iĝantaj	iĝ'ant'a'j
iĝantan	iĝ'ant'a'n
iĝante	iĝ'ant'e
iĝinta	iĝ'int'a
iĝinte	iĝ'int'e
iĝintus	iĝ'int'us
iĝverbo	iĝ'verb'o
iĝverboj	iĝ'verb'o'j
ignacio	ignaci'o
ignamo	ignam'o
ignamoj	ignam'o'j
ignoras	ignor'as
ignori	ignor'i
ignoris	ignor'is
ignoro	ignor'o
ignoron	ignor'o'n
ignoros	ignor'os
ignoru	ignor'u
ignorus	ignor'us
ignorado	ignor'ad'o
ignoranta	ignor'ant'a
ignorante	ignor'ant'e
ignorata	ignor'at'a
ignorataj	ignor'at'a'j
ignorebla	ignor'ebl'a
ignorita	ignor'it'a
ignoritaj	ignor'it'a'j
ikaro	ikar'o
ikario	ikar'i'o
ikebukuro	ikebukur'o
ikono	ikon'o
ikonoj	ikon'o'j
ikonojn	ikon'o'j'n
ikonon	ikon'o'n
ikoneca	ikon'ec'a
ikonecaj	ikon'ec'a'j
ikonografia	ikonografi'a
ikonografio	ikonografi'o
ikonostazo	ikonostaz'o
ikso	iks'o
iksoj	iks'o'j
iksoradia	iks'o'radi'a
iksoradioj	iks'o'radi'o'j
iksosistemon	iks'o'sistem'o'n
iksiono	iksion'o
iksodoj	iksod'o'j
iksodojn	iksod'o'j'n
iktero	ikter'o
ikteroj	ikter'o'j
ila	il'a
ile	il'e
ilo	il'o
iloj	il'o'j
ilojn	il'o'j'n
ilon	il'o'n
ilaro	il'ar'o
ilaroj	il'ar'o'j
ilarojn	il'ar'o'j'n
ilaron	il'ar'o'n
ilarkesto	il'ar'kest'o
ilera	il'er'a
ilei	ilei
ileiuea	ilei'uea
ileikonferenco	ilei'konferenc'o
ileisekcio	ilei'sekci'o
ilekso	ileks'o
ili	ili
ilia	ili'a
iliaj	ili'a'j
iliajn	ili'a'j'n
ilian	ili'a'n
ilin	ili'n
iliado	iliad'o
iliono	ilion'o
ilira	ilir'a
iliro	ilir'o
iliroj	ilir'o'j
illuminati	illumin'at'i
ilona	ilon'a
ilumini	ilumin'i
iluminis	ilumin'is
ilumino	ilumin'o
iluminiĝo	ilumin'iĝ'o
iluminita	ilumin'it'a
iluminito	ilumin'it'o
ilustra	ilustr'a
ilustras	ilustr'as
ilustri	ilustr'i
ilustris	ilustr'is
ilustrado	ilustr'ad'o
ilustraĵo	ilustr'aĵ'o
ilustraĵoj	ilustr'aĵ'o'j
ilustraĵojn	ilustr'aĵ'o'j'n
ilustraĵon	ilustr'aĵ'o'n
ilustrantaj	ilustr'ant'a'j
ilustrante	ilustr'ant'e
ilustristo	ilustr'ist'o
ilustristoj	ilustr'ist'o'j
ilustrita	ilustr'it'a
ilustritaj	ilustr'it'a'j
ilustritajn	ilustr'it'a'j'n
ilustritan	ilustr'it'a'n
ilustrite	ilustr'it'e
iluzia	iluzi'a
iluziaj	iluzi'a'j
iluzian	iluzi'a'n
iluzie	iluzi'e
iluzio	iluzi'o
iluzioj	iluzi'o'j
iluziojn	iluzi'o'j'n
iluzion	iluzi'o'n
iluziaĵo	iluzi'aĵ'o
iluziaĵon	iluzi'aĵ'o'n
iluziisto	iluzi'ist'o
imaga	imag'a
imagaj	imag'a'j
imagajn	imag'a'j'n
imagan	imag'a'n
imagas	imag'as
image	imag'e
imagi	imag'i
imagis	imag'is
imago	imag'o
imagoj	imag'o'j
imagojn	imag'o'j'n
imagon	imag'o'n
imagos	imag'os
imagu	imag'u
imagus	imag'us
imagado	imag'ad'o
imagaĵo	imag'aĵ'o
imagante	imag'ant'e
imagata	imag'at'a
imagataj	imag'at'a'j
imagebla	imag'ebl'a
imageblaj	imag'ebl'a'j
imageblan	imag'ebl'a'n
imageblas	imag'ebl'as
imageble	imag'ebl'e
imagipovo	imag'i'pov'o
imagipovon	imag'i'pov'o'n
imaginta	imag'int'a
imagintus	imag'int'us
imagita	imag'it'a
imagitaj	imag'it'a'j
imagitajn	imag'it'a'j'n
imagitan	imag'it'a'n
imagopovo	imag'o'pov'o
imagopovon	imag'o'pov'o'n
imagpovo	imag'pov'o
imagpovon	imag'pov'o'n
imaginara	imaginar'a
imamo	imam'o
imamoj	imam'o'j
imanenta	imanent'a
imanentaj	imanent'a'j
imanentan	imanent'a'n
imita	imit'a
imitas	imit'as
imite	imit'e
imiti	imit'i
imitis	imit'is
imito	imit'o
imitoj	imit'o'j
imiton	imit'o'n
imitos	imit'os
imitu	imit'u
imitus	imit'us
imitado	imit'ad'o
imitadon	imit'ad'o'n
imitaĵo	imit'aĵ'o
imitaĵoj	imit'aĵ'o'j
imitaĵojn	imit'aĵ'o'j'n
imitaĵon	imit'aĵ'o'n
imitanta	imit'ant'a
imitantaj	imit'ant'a'j
imitante	imit'ant'e
imitanto	imit'ant'o
imitantoj	imit'ant'o'j
imitata	imit'at'a
imiteco	imit'ec'o
imitinda	imit'ind'a
imitindan	imit'ind'a'n
imitisto	imit'ist'o
imitistoj	imit'ist'o'j
imitistreĝo	imit'ist'reĝ'o
imitita	imit'it'a
imititaj	imit'it'a'j
imititajn	imit'it'a'j'n
imituloj	imit'ul'o'j
impedanco	impedanc'o
impedancon	impedanc'o'n
imperativo	imperativ'o
imperativoj	imperativ'o'j
imperativon	imperativ'o'n
imperfekto	imperfekt'o
imperfektive	imperfektiv'e
imperia	imperi'a
imperiaj	imperi'a'j
imperiajn	imperi'a'j'n
imperian	imperi'a'n
imperio	imperi'o
imperioj	imperi'o'j
imperiojn	imperi'o'j'n
imperion	imperi'o'n
imperiestra	imperi'estr'a
imperiestraj	imperi'estr'a'j
imperiestran	imperi'estr'a'n
imperiestro	imperi'estr'o
imperiestroj	imperi'estr'o'j
imperiestrojn	imperi'estr'o'j'n
imperiestron	imperi'estr'o'n
imperiestrino	imperi'estr'in'o
imperiestrinoj	imperi'estr'in'o'j
imperiestrinon	imperi'estr'in'o'n
imperiisma	imperi'ism'a
imperiismaj	imperi'ism'a'j
imperiisman	imperi'ism'a'n
imperiismo	imperi'ism'o
imperiismoj	imperi'ism'o'j
imperiismon	imperi'ism'o'n
imperiistoj	imperi'ist'o'j
imperialismo	imperial'ism'o
imperialisto	imperial'ist'o
imperialistoj	imperial'ist'o'j
imperiumo	imperium'o
imperiumon	imperium'o'n
impertinenta	impertinent'a
impertinentaj	impertinent'a'j
impertinentan	impertinent'a'n
impertinente	impertinent'e
impertinenteco	impertinent'ec'o
impeta	impet'a
impetaj	impet'a'j
impetan	impet'a'n
impetas	impet'as
impete	impet'e
impeti	impet'i
impetis	impet'is
impeto	impet'o
impeton	impet'o'n
implica	implic'a
implicaj	implic'a'j
implicajn	implic'a'j'n
implican	implic'a'n
implicas	implic'as
implice	implic'e
implici	implic'i
implicis	implic'is
implico	implic'o
implicoj	implic'o'j
implicojn	implic'o'j'n
implicon	implic'o'n
implicos	implic'os
implicus	implic'us
implicado	implic'ad'o
implicante	implic'ant'e
implicita	implic'it'a
implicitaj	implic'it'a'j
implicitan	implic'it'a'n
implicite	implic'it'e
implikas	implik'as
impliki	implik'i
implikis	implik'is
impliko	implik'o
implikos	implik'os
impliku	implik'u
implikus	implik'us
implikado	implik'ad'o
implikaĵo	implik'aĵ'o
implikaĵoj	implik'aĵ'o'j
implikanta	implik'ant'a
implikantaj	implik'ant'a'j
implikantajn	implik'ant'a'j'n
implikantan	implik'ant'a'n
implikante	implik'ant'e
implikata	implik'at'a
implikiĝas	implik'iĝ'as
implikiĝi	implik'iĝ'i
implikiĝis	implik'iĝ'is
implikiĝo	implik'iĝ'o
implikiĝon	implik'iĝ'o'n
implikita	implik'it'a
implikitaj	implik'it'a'j
implikitajn	implik'it'a'j'n
implikitan	implik'it'a'n
implikite	implik'it'e
impona	impon'a
imponaj	impon'a'j
imponajn	impon'a'j'n
imponan	impon'a'n
imponas	impon'as
impone	impon'e
imponi	impon'i
imponis	impon'is
imponeco	impon'ec'o
imponecon	impon'ec'o'n
imponega	impon'eg'a
imponita	impon'it'a
imponitaj	impon'it'a'j
importa	import'a
importas	import'as
importi	import'i
importis	import'is
importo	import'o
importoj	import'o'j
importon	import'o'n
importado	import'ad'o
importadoj	import'ad'o'j
importadon	import'ad'o'n
importaĵo	import'aĵ'o
importaĵoj	import'aĵ'o'j
importante	import'ant'e
importisto	import'ist'o
importistoj	import'ist'o'j
importita	import'it'a
importitaj	import'it'a'j
importitajn	import'it'a'j'n
importitan	import'it'a'n
imposta	impost'a
impostaj	impost'a'j
impostajn	impost'a'j'n
impostan	impost'a'n
impostas	impost'as
imposte	impost'e
imposti	impost'i
imposto	impost'o
impostoj	impost'o'j
impostojn	impost'o'j'n
imposton	impost'o'n
impostado	impost'ad'o
impostadon	impost'ad'o'n
impostdeklaroj	impost'deklar'o'j
impostisto	impost'ist'o
impostistoj	impost'ist'o'j
impostita	impost'it'a
impostitaj	impost'it'a'j
impostkolektado	impost'kolekt'ad'o
impostmono	impost'mon'o
impostodeva	impost'o'dev'a
impostodevaj	impost'o'dev'a'j
impostoficejo	impost'ofic'ej'o
impostpaganto	impost'pag'ant'o
impostpagantoj	impost'pag'ant'o'j
impostpagantojn	impost'pag'ant'o'j'n
impostpremo	impost'prem'o
impostrabatoj	impost'rabat'o'j
impostreduktoj	impost'redukt'o'j
impostsistemo	impost'sistem'o
impostsistemoj	impost'sistem'o'j
imposttarifo	impost'tarif'o
imposttarifoj	impost'tarif'o'j
imposttarifojn	impost'tarif'o'j'n
impotenta	impotent'a
impotentaj	impotent'a'j
impotenteco	impotent'ec'o
impresa	impres'a
impresaj	impres'a'j
impresajn	impres'a'j'n
impresan	impres'a'n
impresas	impres'as
imprese	impres'e
impresi	impres'i
impresis	impres'is
impreso	impres'o
impresoj	impres'o'j
impresojn	impres'o'j'n
impreson	impres'o'n
impresos	impres'os
impresu	impres'u
impresus	impres'us
impresanta	impres'ant'a
impresebla	impres'ebl'a
impresiĝis	impres'iĝ'is
impresiĝema	impres'iĝ'em'a
impresita	impres'it'a
impresitaj	impres'it'a'j
impresite	impres'it'e
impresario	impresari'o
impresionisma	impresionism'a
impresionismaj	impresionism'a'j
impresionismo	impresionism'o
impresionistoj	impresionist'o'j
improviza	improviz'a
improvizaj	improviz'a'j
improvizan	improviz'a'n
improvizas	improviz'as
improvize	improviz'e
improvizi	improviz'i
improvizis	improviz'is
improvizo	improviz'o
improvizon	improviz'o'n
improvizado	improviz'ad'o
improvizadoj	improviz'ad'o'j
improvizadon	improviz'ad'o'n
improvizaĵo	improviz'aĵ'o
improvizata	improviz'at'a
improvizita	improviz'it'a
improvizitaj	improviz'it'a'j
improvizitan	improviz'it'a'n
impulsa	impuls'a
impulsan	impuls'a'n
impulse	impuls'e
impulsi	impuls'i
impulsis	impuls'is
impulso	impuls'o
impulsoj	impuls'o'j
impulsojn	impuls'o'j'n
impulson	impuls'o'n
impulsema	impuls'em'a
impulspotencialo	impuls'potencial'o
impulspotencialoj	impuls'potencial'o'j
impulspotencialojn	impuls'potencial'o'j'n
impulspotencialon	impuls'potencial'o'n
imputas	imput'as
imputi	imput'i
imputis	imput'is
imputita	imput'it'a
imputitaj	imput'it'a'j
imuna	imun'a
imunaj	imun'a'j
imunan	imun'a'n
imunĉeloj	imun'ĉel'o'j
imuneco	imun'ec'o
imunecon	imun'ec'o'n
imunigo	imun'ig'o
imunologio	imun'olog'i'o
imunreago	imun're'ag'o
imunreagon	imun're'ag'o'n
imunsistemo	imun'sistem'o
imunsistemon	imun'sistem'o'n
ina	in'a
inaj	in'a'j
inajn	in'a'j'n
inan	in'a'n
ine	in'e
ino	in'o
inoj	in'o'j
inojn	in'o'j'n
inon	in'o'n
ineco	in'ec'o
inaĥo	inaĥ'o
inano	inan'o
inaŭgura	inaŭgur'a
inaŭguran	inaŭgur'a'n
inaŭguras	inaŭgur'as
inaŭguri	inaŭgur'i
inaŭguris	inaŭgur'is
inaŭguro	inaŭgur'o
inaŭguron	inaŭgur'o'n
inaŭguriĝis	inaŭgur'iĝ'is
inaŭgurita	inaŭgur'it'a
incendiis	incendi'is
incendio	incendi'o
incendioj	incendi'o'j
incendiojn	incendi'o'j'n
incendion	incendi'o'n
incensa	incens'a
incenso	incens'o
incensoj	incens'o'j
incensojn	incens'o'j'n
incenson	incens'o'n
incensilon	incens'il'o'n
incensujo	incens'uj'o
incesta	incest'a
incesto	incest'o
incida	incid'a
incidento	incident'o
incidentoj	incident'o'j
incidenton	incident'o'n
incita	incit'a
incitas	incit'as
inciti	incit'i
incitis	incit'is
incito	incit'o
incitu	incit'u
incitus	incit'us
incitado	incit'ad'o
incitante	incit'ant'e
incitetas	incit'et'as
inciteti	incit'et'i
incitetis	incit'et'is
incitiĝis	incit'iĝ'is
incitiĝo	incit'iĝ'o
incitiĝema	incit'iĝ'em'a
incitita	incit'it'a
incititaj	incit'it'a'j
incitite	incit'it'e
incizivoj	inciziv'o'j
inda	ind'a
indaj	ind'a'j
indajn	ind'a'j'n
indan	ind'a'n
indas	ind'as
inde	ind'e
indis	ind'is
indo	ind'o
indon	ind'o'n
indos	ind'os
indus	ind'us
indeco	ind'ec'o
indecon	ind'ec'o'n
indeksa	indeks'a
indeksas	indeks'as
indeksi	indeks'i
indekso	indeks'o
indeksoj	indeks'o'j
indeksojn	indeks'o'j'n
indekson	indeks'o'n
indeksado	indeks'ad'o
indeksita	indeks'it'a
indeksitaj	indeks'it'a'j
india	indi'a
indiaj	indi'a'j
indian	indi'a'n
indie	indi'e
indio	indi'o
indioj	indi'o'j
indiana	indi'an'a
indianaj	indi'an'a'j
indianajn	indi'an'a'j'n
indianan	indi'an'a'n
indiano	indi'an'o
indianoj	indi'an'o'j
indianojn	indi'an'o'j'n
indianino	indi'an'in'o
indianvilaĝo	indi'an'vilaĝ'o
indianio	indiani'o
indica	indic'a
indico	indic'o
indicoj	indic'o'j
indicojn	indic'o'j'n
indicon	indic'o'n
indicigo	indic'ig'o
indicita	indic'it'a
indicitaj	indic'it'a'j
indicite	indic'it'e
indiferenta	indiferent'a
indiferentaj	indiferent'a'j
indiferentan	indiferent'a'n
indiferentas	indiferent'as
indiferente	indiferent'e
indiferento	indiferent'o
indiferenton	indiferent'o'n
indiferenteco	indiferent'ec'o
indiferentecon	indiferent'ec'o'n
indiferentismo	indiferent'ism'o
indiga	indig'a
indigo	indig'o
indiĝena	indiĝen'a
indiĝenaj	indiĝen'a'j
indighenaj	indiĝen'a'j
indiĝenajn	indiĝen'a'j'n
indiĝenan	indiĝen'a'n
indiĝene	indiĝen'e
indiĝeno	indiĝen'o
indiĝenoj	indiĝen'o'j
indighenoj	indiĝen'o'j
indiĝenojn	indiĝen'o'j'n
indiĝenon	indiĝen'o'n
indigna	indign'a
indignaj	indign'a'j
indignas	indign'as
indigne	indign'e
indigni	indign'i
indignis	indign'is
indigno	indign'o
indignon	indign'o'n
indigniga	indign'ig'a
indignigas	indign'ig'as
indignigi	indign'ig'i
indignigis	indign'ig'is
indignigita	indign'ig'it'a
indignigitaj	indign'ig'it'a'j
indigniĝis	indign'iĝ'is
indignita	indign'it'a
indika	indik'a
indikaj	indik'a'j
indikas	indik'as
indiki	indik'i
indikis	indik'is
indiko	indik'o
indikoj	indik'o'j
indikojn	indik'o'j'n
indikon	indik'o'n
indikos	indik'os
indiku	indik'u
indikus	indik'us
indikado	indik'ad'o
indikaĵo	indik'aĵ'o
indikaĵoj	indik'aĵ'o'j
indikaĵojn	indik'aĵ'o'j'n
indikanta	indik'ant'a
indikantaj	indik'ant'a'j
indikantajn	indik'ant'a'j'n
indikantan	indik'ant'a'n
indikante	indik'ant'e
indikata	indik'at'a
indikataj	indik'at'a'j
indikebla	indik'ebl'a
indikeblaj	indik'ebl'a'j
indikeble	indik'ebl'e
indikilo	indik'il'o
indikiloj	indik'il'o'j
indikilojn	indik'il'o'j'n
indikilon	indik'il'o'n
indikita	indik'it'a
indikitaj	indik'it'a'j
indikitajn	indik'it'a'j'n
indikitan	indik'it'a'n
indikite	indik'it'e
indikativo	indikativ'o
individua	individu'a
individuaj	individu'a'j
individuajn	individu'a'j'n
individuan	individu'a'n
individue	individu'e
individuo	individu'o
individuoj	individu'o'j
individuojn	individu'o'j'n
individuon	individu'o'n
individuaĵoj	individu'aĵ'o'j
individueca	individu'ec'a
individueco	individu'ec'o
individuecon	individu'ec'o'n
individuigo	individu'ig'o
individuigita	individu'ig'it'a
individuigitaj	individu'ig'it'a'j
individuisma	individu'ism'a
individuismo	individu'ism'o
individuismon	individu'ism'o'n
individualismo	individualism'o
indra	indr'a
indukta	indukt'a
induktaj	indukt'a'j
induktan	indukt'a'n
induktas	indukt'as
indukte	indukt'e
indukti	indukt'i
induktis	indukt'is
indukto	indukt'o
indukton	indukt'o'n
induktado	indukt'ad'o
induktante	indukt'ant'e
induktiloj	indukt'il'o'j
induktita	indukt'it'a
induktitaj	indukt'it'a'j
induktitan	indukt'it'a'n
induktanco	induktanc'o
induktancon	induktanc'o'n
induktoro	induktor'o
induktoroj	induktor'o'j
indulga	indulg'a
indulgaj	indulg'a'j
indulgas	indulg'as
indulge	indulg'e
indulgi	indulg'i
indulgis	indulg'is
indulgo	indulg'o
indulgoj	indulg'o'j
indulgon	indulg'o'n
indulgos	indulg'os
indulgu	indulg'u
indulgema	indulg'em'a
indulgemaj	indulg'em'a'j
indulgemo	indulg'em'o
indulgenco	indulgenc'o
indusa	indus'a
indusaj	indus'a'j
induso	indus'o
indusocivilizacio	indus'o'civilizaci'o
industria	industri'a
industriaj	industri'a'j
industriajn	industri'a'j'n
industrian	industri'a'n
industrie	industri'e
industrio	industri'o
industrioj	industri'o'j
industriojn	industri'o'j'n
industrion	industri'o'n
industribranĉo	industri'branĉ'o
industribranĉoj	industri'branĉ'o'j
industriiga	industri'ig'a
industriigi	industri'ig'i
industriigis	industri'ig'is
industriigo	industri'ig'o
industriigon	industri'ig'o'n
industriigita	industri'ig'it'a
industriigitaj	industri'ig'it'a'j
industriiĝo	industri'iĝ'o
industriisto	industri'ist'o
industriistoj	industri'ist'o'j
industrikulturo	industri'kultur'o
industrilando	industri'land'o
industrilandoj	industri'land'o'j
industrinormo	industri'norm'o
industriproduktoj	industri'produkt'o'j
industriregionoj	industri'region'o'j
industriulo	industri'ul'o
industriuloj	industri'ul'o'j
industrivaroj	industri'var'o'j
inercia	inerci'a
inercio	inerci'o
inercion	inerci'o'n
inercikadro	inerci'kadr'o
inercirado	inerci'rad'o
inerciradoj	inerci'rad'o'j
inerciradon	inerci'rad'o'n
inerta	inert'a
inertaj	inert'a'j
inertan	inert'a'n
inerte	inert'e
inerteco	inert'ec'o
infana	infan'a
infanaj	infan'a'j
infanajn	infan'a'j'n
infanan	infan'a'n
infane	infan'e
infano	infan'o
infanoj	infan'o'j
infanojn	infan'o'j'n
infanon	infan'o'n
infanaĝa	infan'aĝ'a
infanaĝaj	infan'aĝ'a'j
infanaĝe	infan'aĝ'e
infanagho	infan'aĝ'o
infanaĝo	infan'aĝ'o
infanaĝon	infan'aĝ'o'n
infanaĵo	infan'aĵ'o
infanaro	infan'ar'o
infaneca	infan'ec'a
infanecaj	infan'ec'a'j
infanecan	infan'ec'a'n
infanece	infan'ec'e
infaneco	infan'ec'o
infanecon	infan'ec'o'n
infanedukado	infan'eduk'ad'o
infanejo	infan'ej'o
infaneto	infan'et'o
infanetoj	infan'et'o'j
infanetojn	infan'et'o'j'n
infaneton	infan'et'o'n
infanĝardeno	infan'ĝarden'o
infanĝardenoj	infan'ĝarden'o'j
infanĝardenon	infan'ĝarden'o'n
infanino	infan'in'o
infaninoj	infan'in'o'j
infaninon	infan'in'o'n
infanjaroj	infan'jar'o'j
infanlaboro	infan'labor'o
infanlaboron	infan'labor'o'n
infanlibro	infan'libr'o
infanlibroj	infan'libr'o'j
infanludo	infan'lud'o
infanmurdo	infan'murd'o
infanpornografio	infan'pornograf'i'o
infantempa	infan'temp'a
infantempaj	infan'temp'a'j
infantempan	infan'temp'a'n
infanvartejo	infan'vart'ej'o
infanvartejoj	infan'vart'ej'o'j
infanvartejon	infan'vart'ej'o'n
infanzorgado	infan'zorg'ad'o
infanto	infant'o
infanteria	infanteri'a
infanteriaj	infanteri'a'j
infanterio	infanteri'o
infanterion	infanteri'o'n
infanterianoj	infanteri'an'o'j
infanteriistoj	infanteri'ist'o'j
infanteriodivizioj	infanteri'o'divizi'o'j
infanterisoldatoj	infanteri'soldat'o'j
infanteritrupoj	infanteri'trup'o'j
infekta	infekt'a
infektaj	infekt'a'j
infektajn	infekt'a'j'n
infektan	infekt'a'n
infektas	infekt'as
infekti	infekt'i
infektis	infekt'is
infekto	infekt'o
infektoj	infekt'o'j
infektojn	infekt'o'j'n
infekton	infekt'o'n
infektado	infekt'ad'o
infektiĝas	infekt'iĝ'as
infektiĝi	infekt'iĝ'i
infektiĝis	infekt'iĝ'is
infektiĝo	infekt'iĝ'o
infektiĝoj	infekt'iĝ'o'j
infektiĝon	infekt'iĝ'o'n
infektita	infekt'it'a
infektitaj	infekt'it'a'j
infektitan	infekt'it'a'n
infektitoj	infekt'it'o'j
infera	infer'a
inferaj	infer'a'j
inferan	infer'a'n
infere	infer'e
inferen	infer'e'n
infero	infer'o
inferoj	infer'o'j
inferon	infer'o'n
infereco	infer'ec'o
infestiĝo	infest'iĝ'o
infestita	infest'it'a
infiltras	infiltr'as
infiltri	infiltr'i
infiltris	infiltr'is
infinita	infinit'a
infinite	infinit'e
infinito	infinit'o
infinitezima	infinitezim'a
infinitiva	infinitiv'a
infinitivo	infinitiv'o
infinitivoj	infinitiv'o'j
infinitivon	infinitiv'o'n
inflacia	inflaci'a
inflaciajn	inflaci'a'j'n
inflacio	inflaci'o
inflacion	inflaci'o'n
inflaciindico	inflaci'indic'o
inflama	inflam'a
inflamaj	inflam'a'j
inflaman	inflam'a'n
inflamo	inflam'o
inflamoj	inflam'o'j
inflamojn	inflam'o'j'n
inflamon	inflam'o'n
infloresko	infloresk'o
infloreskoj	infloresk'o'j
infloreskojn	infloresk'o'j'n
influa	influ'a
influaj	influ'a'j
influajn	influ'a'j'n
influan	influ'a'n
influas	influ'as
influe	influ'e
influi	influ'i
influis	influ'is
influo	influ'o
influoj	influ'o'j
influojn	influ'o'j'n
influon	influ'o'n
influos	influ'os
influu	influ'u
influus	influ'us
influado	influ'ad'o
influanta	influ'ant'a
influantaj	influ'ant'a'j
influantajn	influ'ant'a'j'n
influantan	influ'ant'a'n
influante	influ'ant'e
influata	influ'at'a
influataj	influ'at'a'j
influate	influ'at'e
influebla	influ'ebl'a
influeblaj	influ'ebl'a'j
influhava	influ'hav'a
influhavaj	influ'hav'a'j
influiĝis	influ'iĝ'is
influinta	influ'int'a
influita	influ'it'a
influitaj	influ'it'a'j
influitajn	influ'it'a'j'n
influitan	influ'it'a'n
influite	influ'it'e
influkampo	influ'kamp'o
influkampoj	influ'kamp'o'j
influkampon	influ'kamp'o'n
influsfero	influ'sfer'o
informa	inform'a
informaj	inform'a'j
informajn	inform'a'j'n
informan	inform'a'n
informas	inform'as
informi	inform'i
informis	inform'is
informo	inform'o
informoj	inform'o'j
informojn	inform'o'j'n
informon	inform'o'n
informos	inform'os
informu	inform'u
informus	inform'us
informada	inform'ad'a
informadi	inform'ad'i
informado	inform'ad'o
informadon	inform'ad'o'n
informadika	inform'ad'ik'a
informadikaj	inform'ad'ik'a'j
informadikan	inform'ad'ik'a'n
informadiko	inform'ad'ik'o
informadikon	inform'ad'ik'o'n
informadikisto	inform'ad'ik'ist'o
informagentejo	inform'agent'ej'o
informagentejoj	inform'agent'ej'o'j
informaĵo	inform'aĵ'o
informaĵoj	inform'aĵ'o'j
informaĵon	inform'aĵ'o'n
informante	inform'ant'e
informanto	inform'ant'o
informantoj	inform'ant'o'j
informantojn	inform'ant'o'j'n
informaro	inform'ar'o
informaron	inform'ar'o'n
informata	inform'at'a
informataj	inform'at'a'j
informatiko	inform'at'ik'o
informcentro	inform'centr'o
informejo	inform'ej'o
informejon	inform'ej'o'n
informenhavo	inform'en'hav'o
informero	inform'er'o
informeroj	inform'er'o'j
informfluo	inform'flu'o
informfluon	inform'flu'o'n
informfonto	inform'font'o
informfontoj	inform'font'o'j
informiĝas	inform'iĝ'as
informiĝi	inform'iĝ'i
informiĝis	inform'iĝ'is
informiĝo	inform'iĝ'o
informiĝos	inform'iĝ'os
informiĝu	inform'iĝ'u
informiĝinte	inform'iĝ'int'e
informilo	inform'il'o
informiloj	inform'il'o'j
informilojn	inform'il'o'j'n
informilon	inform'il'o'n
informinterŝanĝo	inform'inter'ŝanĝ'o
informisto	inform'ist'o
informita	inform'it'a
informitaj	inform'it'a'j
informite	inform'it'e
informiteco	inform'it'ec'o
informkampanjo	inform'kampanj'o
informkanaloj	inform'kanal'o'j
informkesto	inform'kest'o
informkestoreferencoj	inform'kest'o'referenc'o'j
informkvanto	inform'kvant'o
informkvanton	inform'kvant'o'n
informmaterialo	inform'material'o
informofontoj	inform'o'font'o'j
informpetoj	inform'pet'o'j
informpetojn	inform'pet'o'j'n
informpretigo	inform'pret'ig'o
informriĉa	inform'riĉ'a
informserĉado	inform'serĉ'ad'o
informservo	inform'serv'o
informservoj	inform'serv'o'j
informsistemo	inform'sistem'o
informsistemoj	inform'sistem'o'j
informsistemojn	inform'sistem'o'j'n
informsocio	inform'soci'o
informstandon	inform'stand'o'n
informtabuloj	inform'tabul'o'j
informteknologia	inform'teknologi'a
informteknologiaj	inform'teknologi'a'j
informteknologioepoko	inform'teknologi'o'epok'o
informacio	informaci'o
informacion	informaci'o'n
infrastruktura	infra'struktur'a
infrastrukturaj	infra'struktur'a'j
infrastrukturajn	infra'struktur'a'j'n
infrastrukturo	infra'struktur'o
infrastrukturoj	infra'struktur'o'j
infrastrukturojn	infra'struktur'o'j'n
infrastrukturon	infra'struktur'o'n
infrastrukturevoluo	infra'struktur'evolu'o
infrastrukturprojektoj	infra'struktur'projekt'o'j
infuzas	infuz'as
infuzi	infuz'i
infuzis	infuz'is
infuzo	infuz'o
infuzaĵo	infuz'aĵ'o
infuzaĵon	infuz'aĵ'o'n
infuzita	infuz'it'a
inge	ing'e
ingo	ing'o
ingoj	ing'o'j
ingojn	ing'o'j'n
ingon	ing'o'n
inĝenia	inĝeni'a
inĝeniaj	inĝeni'a'j
inĝenie	inĝeni'e
inĝeniera	inĝenier'a
inĝenieraj	inĝenier'a'j
inĝenieran	inĝenier'a'n
inĝeniero	inĝenier'o
ingheniero	inĝenier'o
inĝenieroj	inĝenier'o'j
inĝenierojn	inĝenier'o'j'n
inĝenieron	inĝenier'o'n
inĝenierado	inĝenier'ad'o
inĝenieradon	inĝenier'ad'o'n
inĝenierarto	inĝenier'art'o
inĝenierio	inĝenier'i'o
inĝenieriaĵo	inĝenier'i'aĵ'o
inĝenieriaĵoj	inĝenier'i'aĵ'o'j
inĝenieriaĵon	inĝenier'i'aĵ'o'n
inĝenierino	inĝenier'in'o
inĝenieristika	inĝenier'ist'ik'a
inĝenieristikaj	inĝenier'ist'ik'a'j
inĝenieristiko	inĝenier'ist'ik'o
inĝenieristikon	inĝenier'ist'ik'o'n
inĝenieristikaplikoj	inĝenier'ist'ik'aplik'o'j
ingesto	ingest'o
ingestado	ingest'ad'o
ingestita	ingest'it'a
ingoto	ingot'o
ingredienco	ingredienc'o
ingrediencoj	ingredienc'o'j
ingrediencojn	ingredienc'o'j'n
ingrediencon	ingredienc'o'n
ingvena	ingven'a
ingveno	ingven'o
inhalado	inhal'ad'o
inhalita	inhal'it'a
inhibas	inhib'as
inhibado	inhib'ad'o
inhibanto	inhib'ant'o
inhibicia	inhibici'a
inhibiciaj	inhibici'a'j
inhibicias	inhibici'as
inhibicii	inhibici'i
inhibicio	inhibici'o
inhibicion	inhibici'o'n
inhibiciante	inhibici'ant'e
inhibiciita	inhibici'it'a
inhibiciitaj	inhibici'it'a'j
inica	inic'a
inicis	inic'is
inico	inic'o
inicon	inic'o'n
inicado	inic'ad'o
inicitaj	inic'it'a'j
inicitoj	inic'it'o'j
inicialo	inicial'o
inicialoj	inicial'o'j
inicialojn	inicial'o'j'n
inicialigo	inicial'ig'o
iniciata	iniciat'a
iniciatas	iniciat'as
iniciate	iniciat'e
iniciati	iniciat'i
iniciatis	iniciat'is
iniciato	iniciat'o
iniciatoj	iniciat'o'j
iniciatojn	iniciat'o'j'n
iniciaton	iniciat'o'n
iniciatos	iniciat'os
iniciatado	iniciat'ad'o
iniciatante	iniciat'ant'e
iniciatema	iniciat'em'a
iniciatemaj	iniciat'em'a'j
iniciateme	iniciat'em'e
iniciatemo	iniciat'em'o
iniciatemon	iniciat'em'o'n
iniciatinto	iniciat'int'o
iniciatintoj	iniciat'int'o'j
iniciatinton	iniciat'int'o'n
iniciatita	iniciat'it'a
iniciatitaj	iniciat'it'a'j
iniciatitan	iniciat'it'a'n
iniciatite	iniciat'it'e
iniciative	iniciativ'e
iniciativo	iniciativ'o
iniciativoj	iniciativ'o'j
iniciativon	iniciativ'o'n
iniciatoro	iniciator'o
injektas	injekt'as
injekti	injekt'i
injektis	injekt'is
injekto	injekt'o
injektoj	injekt'o'j
injektojn	injekt'o'j'n
injekton	injekt'o'n
injektado	injekt'ad'o
injektilo	injekt'il'o
injektiloj	injekt'il'o'j
injektilon	injekt'il'o'n
injektita	injekt'it'a
injektitaj	injekt'it'a'j
inka	ink'a
inkaj	ink'a'j
inko	ink'o
inkoj	ink'o'j
inkojn	ink'o'j'n
inkon	ink'o'n
inkŝprucaj	ink'ŝpruc'a'j
inkujo	ink'uj'o
inkujon	ink'uj'o'n
inkaa	inka'a
inkaaj	inka'a'j
inkao	inka'o
inkaoj	inka'o'j
inkandeska	inkandesk'a
inkandeskaj	inkandesk'a'j
inklina	inklin'a
inklinaj	inklin'a'j
inklinajn	inklin'a'j'n
inklinan	inklin'a'n
inklinas	inklin'as
inklinis	inklin'is
inklino	inklin'o
inklinoj	inklin'o'j
inklinojn	inklin'o'j'n
inklinon	inklin'o'n
inkludas	inklud'as
inklude	inklud'e
inkludi	inklud'i
inkludis	inklud'is
inkludo	inklud'o
inkludon	inklud'o'n
inkludos	inklud'os
inkludu	inklud'u
inkludus	inklud'us
inkludado	inklud'ad'o
inkludante	inklud'ant'e
inkludata	inklud'at'a
inkludataj	inklud'at'a'j
inkludintus	inklud'int'us
inkludita	inklud'it'a
inkluditaj	inklud'it'a'j
inkluditajn	inklud'it'a'j'n
inkludite	inklud'it'e
inkluziva	inkluziv'a
inkluzivaj	inkluziv'a'j
inkluzivan	inkluziv'a'n
inkluzivas	inkluziv'as
inkluzive	inkluziv'e
inkluzivi	inkluziv'i
inkluzivis	inkluziv'is
inkluzivo	inkluziv'o
inkluzivos	inkluziv'os
inkluzivu	inkluziv'u
inkluzivus	inkluziv'us
inkluzivanta	inkluziv'ant'a
inkluzivante	inkluziv'ant'e
inkluziveco	inkluziv'ec'o
inkluzivema	inkluziv'em'a
inkluzivita	inkluziv'it'a
inkluzivitaj	inkluziv'it'a'j
inkrustita	inkrust'it'a
inkrustitaj	inkrust'it'a'j
inkubo	inkub'o
inkubsonĝojn	inkub'sonĝ'o'j'n
inkubacio	inkubaci'o
inkubatoro	inkubator'o
inkvizicia	inkvizici'a
inkvizicio	inkvizici'o
inkvizicion	inkvizici'o'n
inocento	inocent'o
inokulado	inokul'ad'o
inokulita	inokul'it'a
inokulitaj	inokul'it'a'j
insekta	insekt'a
insektaj	insekt'a'j
insekto	insekt'o
insektoj	insekt'o'j
insektojn	insekt'o'j'n
insekton	insekt'o'n
insektetoj	insekt'et'o'j
insektnesto	insekt'nest'o
insektovora	insekt'o'vor'a
insektovoraj	insekt'o'vor'a'j
insekticido	insekticid'o
insekticidoj	insekticid'o'j
insekticidojn	insekticid'o'j'n
insekticidon	insekticid'o'n
insida	insid'a
insidaj	insid'a'j
insidas	insid'as
inside	insid'e
insidoj	insid'o'j
insidema	insid'em'a
insidmurdisto	insid'murd'ist'o
insidmurdistoj	insid'murd'ist'o'j
insigno	insign'o
insignoj	insign'o'j
insignojn	insign'o'j'n
insignon	insign'o'n
insinuas	insinu'as
insinuis	insinu'is
insista	insist'a
insistaj	insist'a'j
insistas	insist'as
insiste	insist'e
insisti	insist'i
insistis	insist'is
insisto	insist'o
insistoj	insist'o'j
insistos	insist'os
insistu	insist'u
insistus	insist'us
insistado	insist'ad'o
insistante	insist'ant'e
inspekta	inspekt'a
inspektas	inspekt'as
inspekti	inspekt'i
inspektis	inspekt'is
inspekto	inspekt'o
inspekton	inspekt'o'n
inspektos	inspekt'os
inspektu	inspekt'u
inspektado	inspekt'ad'o
inspektadoj	inspekt'ad'o'j
inspektadojn	inspekt'ad'o'j'n
inspektadon	inspekt'ad'o'n
inspektante	inspekt'ant'e
inspektisto	inspekt'ist'o
inspektistoj	inspekt'ist'o'j
inspektistojn	inspekt'ist'o'j'n
inspektita	inspekt'it'a
inspektitaj	inspekt'it'a'j
inspektoro	inspektor'o
inspektoroj	inspektor'o'j
inspektoron	inspektor'o'n
inspira	inspir'a
inspiraj	inspir'a'j
inspirajn	inspir'a'j'n
inspiran	inspir'a'n
inspiras	inspir'as
inspire	inspir'e
inspiri	inspir'i
inspiris	inspir'is
inspiro	inspir'o
inspiroj	inspir'o'j
inspirojn	inspir'o'j'n
inspiron	inspir'o'n
inspiros	inspir'os
inspiru	inspir'u
inspirus	inspir'us
inspirado	inspir'ad'o
inspirante	inspir'ant'e
inspiranto	inspir'ant'o
inspirata	inspir'at'a
inspirataj	inspir'at'a'j
inspiriĝas	inspir'iĝ'as
inspiriĝi	inspir'iĝ'i
inspiriĝis	inspir'iĝ'is
inspirita	inspir'it'a
inspiritaj	inspir'it'a'j
inspiritajn	inspir'it'a'j'n
inspiritan	inspir'it'a'n
inspirite	inspir'it'e
instalas	instal'as
instali	instal'i
instalis	instal'is
instalo	instal'o
instalon	instal'o'n
instalos	instal'os
instalu	instal'u
instalado	instal'ad'o
instaladoj	instal'ad'o'j
instaladon	instal'ad'o'n
instalaĵo	instal'aĵ'o
instalaĵoj	instal'aĵ'o'j
instalaĵojn	instal'aĵ'o'j'n
instalaĵon	instal'aĵ'o'n
instalante	instal'ant'e
instaliĝas	instal'iĝ'as
instaliĝi	instal'iĝ'i
instaliĝis	instal'iĝ'is
instalilo	instal'il'o
instalita	instal'it'a
instalitaj	instal'it'a'j
instalitajn	instal'it'a'j'n
instalitan	instal'it'a'n
instalite	instal'it'e
instalota	instal'ot'a
instanco	instanc'o
instancoj	instanc'o'j
instancojn	instanc'o'j'n
instancon	instanc'o'n
instiga	instig'a
instigaj	instig'a'j
instigas	instig'as
instige	instig'e
instigi	instig'i
instigis	instig'is
instigo	instig'o
instigoj	instig'o'j
instigojn	instig'o'j'n
instigon	instig'o'n
instigos	instig'os
instigu	instig'u
instigus	instig'us
instigado	instig'ad'o
instiganta	instig'ant'a
instigantaj	instig'ant'a'j
instigantan	instig'ant'a'n
instigante	instig'ant'e
instiganto	instig'ant'o
instigantoj	instig'ant'o'j
instigata	instig'at'a
instigataj	instig'at'a'j
instigilo	instig'il'o
instigita	instig'it'a
instigitaj	instig'it'a'j
instigitan	instig'it'a'n
instigite	instig'it'e
instinkta	instinkt'a
instinktan	instinkt'a'n
instinkte	instinkt'e
instinkto	instinkt'o
instinktoj	instinkt'o'j
instinktojn	instinkt'o'j'n
instinkton	instinkt'o'n
institucia	instituci'a
instituciaj	instituci'a'j
instituciajn	instituci'a'j'n
institucian	instituci'a'n
institucie	instituci'e
institucio	instituci'o
institucioj	instituci'o'j
instituciojn	instituci'o'j'n
institucion	instituci'o'n
instituciigis	instituci'ig'is
instituciigo	instituci'ig'o
instituciigita	instituci'ig'it'a
instituciigitaj	instituci'ig'it'a'j
instituta	institut'a
institute	institut'e
instituto	institut'o
institutoj	institut'o'j
institutojn	institut'o'j'n
instituton	institut'o'n
instrua	instru'a
instruaj	instru'a'j
instruajn	instru'a'j'n
instruan	instru'a'n
instruas	instru'as
instrue	instru'e
instrui	instru'i
instruis	instru'is
instruo	instru'o
instruoj	instru'o'j
instruojn	instru'o'j'n
instruon	instru'o'n
instruos	instru'os
instruu	instru'u
instruus	instru'us
instruadi	instru'ad'i
instruadis	instru'ad'is
instruado	instru'ad'o
instruadoj	instru'ad'o'j
instruadon	instru'ad'o'n
instruadlingvo	instru'ad'lingv'o
instruaĵoj	instru'aĵ'o'j
instruaĵojn	instru'aĵ'o'j'n
instruanta	instru'ant'a
instruantaj	instru'ant'a'j
instruantan	instru'ant'a'n
instruante	instru'ant'e
instruanto	instru'ant'o
instruantoj	instru'ant'o'j
instruata	instru'at'a
instruataj	instru'at'a'j
instrudepagoj	instru'de'pag'o'j
instruejo	instru'ej'o
instruejoj	instru'ej'o'j
instruejojn	instru'ej'o'j'n
instruhoroj	instru'hor'o'j
instruiĝas	instru'iĝ'as
instruiĝi	instru'iĝ'i
instruiĝo	instru'iĝ'o
instruilo	instru'il'o
instruiloj	instru'il'o'j
instruista	instru'ist'a
instruistaj	instru'ist'a'j
instruistajn	instru'ist'a'j'n
instruistan	instru'ist'a'n
instruisto	instru'ist'o
instruistoj	instru'ist'o'j
instruistojn	instru'ist'o'j'n
instruiston	instru'ist'o'n
instruistaro	instru'ist'ar'o
instruistino	instru'ist'in'o
instruistinoj	instru'ist'in'o'j
instruistinon	instru'ist'in'o'n
instruita	instru'it'a
instruitaj	instru'it'a'j
instruitajn	instru'it'a'j'n
instruite	instru'it'e
instruitoj	instru'it'o'j
instruiteco	instru'it'ec'o
instruitecon	instru'it'ec'o'n
instruitulo	instru'it'ul'o
instruituloj	instru'it'ul'o'j
instrukotizo	instru'kotiz'o
instrukotizon	instru'kotiz'o'n
instrulingvo	instru'lingv'o
instrumaterialo	instru'material'o
instrumaterialoj	instru'material'o'j
instrumetodo	instru'metod'o
instrumetodoj	instru'metod'o'j
instrumetodojn	instru'metod'o'j'n
instrumetodon	instru'metod'o'n
instruplano	instru'plan'o
instruplanoj	instru'plan'o'j
instruplanojn	instru'plan'o'j'n
instruplanon	instru'plan'o'n
instruprogramo	instru'program'o
instruprogramoj	instru'program'o'j
instruprogramojn	instru'program'o'j'n
instruprogramon	instru'program'o'n
instrukcias	instrukci'as
instrukcii	instrukci'i
instrukciis	instrukci'is
instrukcio	instrukci'o
instrukcioj	instrukci'o'j
instrukciojn	instrukci'o'j'n
instrukcion	instrukci'o'n
instrukciaĵo	instrukci'aĵ'o
instrukciaĵon	instrukci'aĵ'o'n
instrukciante	instrukci'ant'e
instrukciisto	instrukci'ist'o
instrukciistoj	instrukci'ist'o'j
instrukciita	instrukci'it'a
instrukciitaj	instrukci'it'a'j
instrukciserio	instrukci'seri'o
instrumenta	instrument'a
instrumentaj	instrument'a'j
instrumentajn	instrument'a'j'n
instrumentan	instrument'a'n
instrumento	instrument'o
instrumentoj	instrument'o'j
instrumentojn	instrument'o'j'n
instrumenton	instrument'o'n
instrumentado	instrument'ad'o
instrumentadon	instrument'ad'o'n
instrumentaro	instrument'ar'o
instrumentistoj	instrument'ist'o'j
instrumentpanelo	instrument'panel'o
instrumentalo	instrumental'o
insula	insul'a
insulaj	insul'a'j
insulan	insul'a'n
insulo	insul'o
insuloj	insul'o'j
insulojn	insul'o'j'n
insulon	insul'o'n
insulanoj	insul'an'o'j
insulanojn	insul'an'o'j'n
insularo	insul'ar'o
insularoj	insul'ar'o'j
insularon	insul'ar'o'n
insulestro	insul'estr'o
insuleto	insul'et'o
insuletoj	insul'et'o'j
insuletojn	insul'et'o'j'n
insuleton	insul'et'o'n
insulino	insulin'o
insulinon	insulin'o'n
insulta	insult'a
insultaj	insult'a'j
insultajn	insult'a'j'n
insultan	insult'a'n
insultas	insult'as
insulte	insult'e
insulti	insult'i
insultis	insult'is
insulto	insult'o
insultoj	insult'o'j
insultojn	insult'o'j'n
insulton	insult'o'n
insultos	insult'os
insultu	insult'u
insultado	insult'ad'o
insultadon	insult'ad'o'n
insultante	insult'ant'e
insultata	insult'at'a
insultita	insult'it'a
insultitaj	insult'it'a'j
insurekcia	insurekci'a
insurekcio	insurekci'o
insurekcioj	insurekci'o'j
insurekcion	insurekci'o'n
inta	int'a
intaj	int'a'j
inte	int'e
into	int'o
interkomprenigho	int'er'kom'pren'iĝ'o
intajlo	intajl'o
integra	integr'a
integraj	integr'a'j
integrajn	integr'a'j'n
integran	integr'a'n
integras	integr'as
integre	integr'e
integri	integr'i
integris	integr'is
integrado	integr'ad'o
integradon	integr'ad'o'n
integrante	integr'ant'e
integreca	integr'ec'a
integreco	integr'ec'o
integrecon	integr'ec'o'n
integriga	integr'ig'a
integrigas	integr'ig'as
integrigi	integr'ig'i
integrigis	integr'ig'is
integrigo	integr'ig'o
integrigon	integr'ig'o'n
integrigado	integr'ig'ad'o
integrigante	integr'ig'ant'e
integrigita	integr'ig'it'a
integrigitaj	integr'ig'it'a'j
integriĝa	integr'iĝ'a
integriĝas	integr'iĝ'as
integriĝi	integr'iĝ'i
integriĝis	integr'iĝ'is
integriĝo	integr'iĝ'o
integriĝon	integr'iĝ'o'n
integriĝinta	integr'iĝ'int'a
integriĝintaj	integr'iĝ'int'a'j
integriĝintajn	integr'iĝ'int'a'j'n
integriĝintan	integr'iĝ'int'a'n
integrismo	integr'ism'o
integrita	integr'it'a
integritaj	integr'it'a'j
integritajn	integr'it'a'j'n
integritan	integr'it'a'n
integrite	integr'it'e
integrala	integral'a
integralo	integral'o
integraloj	integral'o'j
integralojn	integral'o'j'n
integralon	integral'o'n
integralado	integral'ad'o
intelekta	intelekt'a
intelektaj	intelekt'a'j
intelektajn	intelekt'a'j'n
intelektan	intelekt'a'n
intelekte	intelekt'e
intelekto	intelekt'o
intelektoj	intelekt'o'j
intelekton	intelekt'o'n
intelektapropraĵaj	intelekt'a'propr'aĵ'a'j
intelektula	intelekt'ul'a
intelektulo	intelekt'ul'o
intelektuloj	intelekt'ul'o'j
intelektulojn	intelekt'ul'o'j'n
intelektulon	intelekt'ul'o'n
intelektularo	intelekt'ul'ar'o
inteligencio	inteligenci'o
inteligenta	inteligent'a
inteligentaj	inteligent'a'j
inteligentajn	inteligent'a'j'n
inteligentan	inteligent'a'n
inteligentas	inteligent'as
inteligente	inteligent'e
inteligento	inteligent'o
inteligenton	inteligent'o'n
inteligenteco	inteligent'ec'o
inteligentecoj	inteligent'ec'o'j
inteligentecon	inteligent'ec'o'n
inteligentecotestoj	inteligent'ec'o'test'o'j
inteligentulo	inteligent'ul'o
inteligentuloj	inteligent'ul'o'j
inteligentularo	inteligent'ul'ar'o
intenca	intenc'a
intencaj	intenc'a'j
intencan	intenc'a'n
intencas	intenc'as
intence	intenc'e
intenci	intenc'i
intencis	intenc'is
intenco	intenc'o
intencoj	intenc'o'j
intencojn	intenc'o'j'n
intencon	intenc'o'n
intencos	intenc'os
intencu	intenc'u
intencus	intenc'us
intencanta	intenc'ant'a
intencantaj	intenc'ant'a'j
intencante	intenc'ant'e
intencata	intenc'at'a
intencita	intenc'it'a
intencitaj	intenc'it'a'j
intencitajn	intenc'it'a'j'n
intencitan	intenc'it'a'n
intencite	intenc'it'e
intendanto	intendant'o
intendanton	intendant'o'n
intendantado	intendant'ad'o
intendantadon	intendant'ad'o'n
intensa	intens'a
intensaj	intens'a'j
intensajn	intens'a'j'n
intensan	intens'a'n
intense	intens'e
intenso	intens'o
intenson	intens'o'n
intenseco	intens'ec'o
intensecoj	intens'ec'o'j
intensecon	intens'ec'o'n
intensega	intens'eg'a
intensigas	intens'ig'as
intensigi	intens'ig'i
intensigis	intens'ig'is
intensigo	intens'ig'o
intensigos	intens'ig'os
intensigita	intens'ig'it'a
intensigitaj	intens'ig'it'a'j
intensiĝas	intens'iĝ'as
intensiĝis	intens'iĝ'is
intensiĝo	intens'iĝ'o
intensive	intensiv'e
inter	inter
intera	inter'a
interaj	inter'a'j
interan	inter'a'n
intere	inter'e
interaga	inter'ag'a
interagaj	inter'ag'a'j
interagajn	inter'ag'a'j'n
interagan	inter'ag'a'n
interagas	inter'ag'as
interage	inter'ag'e
interagi	inter'ag'i
interagis	inter'ag'is
interago	inter'ag'o
interagoj	inter'ag'o'j
interagojn	inter'ag'o'j'n
interagon	inter'ag'o'n
interagada	inter'ag'ad'a
interagadas	inter'ag'ad'as
interagadi	inter'ag'ad'i
interagado	inter'ag'ad'o
interagadoj	inter'ag'ad'o'j
interagadon	inter'ag'ad'o'n
interaganta	inter'ag'ant'a
interagantaj	inter'ag'ant'a'j
interagante	inter'ag'ant'e
interaĵo	inter'aĵ'o
interakto	inter'akt'o
interaktiva	inter'aktiv'a
interaktivaj	inter'aktiv'a'j
interalie	inter'ali'e
interamerika	inter'amerik'a
interamikiĝo	inter'amik'iĝ'o
interastra	inter'astr'a
interastraj	inter'astr'a'j
interbabili	inter'babil'i
interbabilis	inter'babil'is
interbabilado	inter'babil'ad'o
interbatado	inter'bat'ad'o
interbatiĝis	inter'bat'iĝ'is
interbatiĝo	inter'bat'iĝ'o
interbatiĝoj	inter'bat'iĝ'o'j
interbatalas	inter'batal'as
interbatali	inter'batal'i
interbatalis	inter'batal'is
interbatalo	inter'batal'o
interbataloj	inter'batal'o'j
interĉelaj	inter'ĉel'a'j
intercetere	inter'ceter'e
intercivitana	inter'civit'an'a
interdependa	inter'de'pend'a
interdependaj	inter'de'pend'a'j
interdependeco	inter'de'pend'ec'o
intereto	inter'et'o
interetaĝo	inter'etaĝ'o
interetna	inter'etn'a
interetnaj	inter'etn'a'j
interface	inter'fac'e
interfaco	inter'fac'o
interfacoj	inter'fac'o'j
interfacojn	inter'fac'o'j'n
interfacon	inter'fac'o'n
interfaka	inter'fak'a
interfakaj	inter'fak'a'j
interfakajn	inter'fak'a'j'n
interfakan	inter'fak'a'n
interfidon	inter'fid'o'n
interflua	inter'flu'a
interfluan	inter'flu'a'n
interflui	inter'flu'i
interfluo	inter'flu'o
interfluoj	inter'flu'o'j
interfluojn	inter'flu'o'j'n
interfluon	inter'flu'o'n
interfluado	inter'flu'ad'o
interfratiĝo	inter'frat'iĝ'o
intergeedzigo	inter'ge'edz'ig'o
intergeedziĝis	inter'ge'edz'iĝ'is
intergeneracia	inter'generaci'a
intergenta	inter'gent'a
interhelpo	inter'help'o
interhoma	inter'hom'a
interhomaj	inter'hom'a'j
interhomajn	inter'hom'a'j'n
interhoman	inter'hom'a'n
interkapto	inter'kapt'o
interkaptoj	inter'kapt'o'j
interkapton	inter'kapt'o'n
interkisis	inter'kis'is
interkolegia	inter'kolegi'a
interkomprenas	inter'kompren'as
interkompreni	inter'kompren'i
interkompreno	inter'kompren'o
interkomprenon	inter'kompren'o'n
interkompreneblaj	inter'kompren'ebl'a'j
interkompreniĝas	inter'kompren'iĝ'as
interkompreniĝi	inter'kompren'iĝ'i
interkompreniĝis	inter'kompren'iĝ'is
interkompreniĝo	inter'kompren'iĝ'o
interkompreniĝon	inter'kompren'iĝ'o'n
interkompreniĝado	inter'kompren'iĝ'ad'o
interkomprenilo	inter'kompren'il'o
interkomunuma	inter'komun'um'a
interkomunika	inter'komunik'a
interkomunikas	inter'komunik'as
interkomuniki	inter'komunik'i
interkomunikon	inter'komunik'o'n
interkomunikado	inter'komunik'ad'o
interkomunikadon	inter'komunik'ad'o'n
interkomunikiĝas	inter'komunik'iĝ'as
interkomunikiĝi	inter'komunik'iĝ'i
interkomunikiĝo	inter'komunik'iĝ'o
interkomunikiĝon	inter'komunik'iĝ'o'n
interkomunikilo	inter'komunik'il'o
interkona	inter'kon'a
interkonaj	inter'kon'a'j
interkonan	inter'kon'a'n
interkonatiĝi	inter'kon'at'iĝ'i
interkonatiĝis	inter'kon'at'iĝ'is
interkonatiĝo	inter'kon'at'iĝ'o
interkonatiĝu	inter'kon'at'iĝ'u
interkonekta	inter'konekt'a
interkonektaj	inter'konekt'a'j
interkonektajn	inter'konekt'a'j'n
interkonektan	inter'konekt'a'n
interkonektoj	inter'konekt'o'j
interkonektita	inter'konekt'it'a
interkonektitaj	inter'konekt'it'a'j
interkonfesia	inter'konfesi'a
interkonfesiaj	inter'konfesi'a'j
interkonsentas	inter'konsent'as
interkonsente	inter'konsent'e
interkonsenti	inter'konsent'i
interkonsentis	inter'konsent'is
interkonsento	inter'konsent'o
interkonsentoj	inter'konsent'o'j
interkonsentojn	inter'konsent'o'j'n
interkonsenton	inter'konsent'o'n
interkonsentos	inter'konsent'os
interkonsentu	inter'konsent'u
interkonsentita	inter'konsent'it'a
interkonsentitaj	inter'konsent'it'a'j
interkonsentitan	inter'konsent'it'a'n
interkonsentite	inter'konsent'it'e
interkonsiliĝa	inter'konsil'iĝ'a
interkonsiliĝas	inter'konsil'iĝ'as
interkonsiliĝi	inter'konsil'iĝ'i
interkonsiliĝis	inter'konsil'iĝ'is
interkonsiliĝo	inter'konsil'iĝ'o
interkonsiliĝoj	inter'konsil'iĝ'o'j
interkonsiliĝon	inter'konsil'iĝ'o'n
interkonsiliĝado	inter'konsil'iĝ'ad'o
interkontinenta	inter'kontinent'a
interkontinentaj	inter'kontinent'a'j
interkovras	inter'kovr'as
interkovri	inter'kovr'i
interkovris	inter'kovr'is
interkovro	inter'kovr'o
interkovroj	inter'kovr'o'j
interkovron	inter'kovr'o'n
interkovrante	inter'kovr'ant'e
interkovriĝo	inter'kovr'iĝ'o
interkrampe	inter'kramp'e
interkruciĝas	inter'kruc'iĝ'as
interkruciĝo	inter'kruc'iĝ'o
interkruciĝoj	inter'kruc'iĝ'o'j
interkrurigas	inter'krur'ig'as
interkrutejo	inter'krut'ej'o
interkrutejoj	inter'krut'ej'o'j
interkrutejon	inter'krut'ej'o'n
interkultura	inter'kultur'a
interkulturaj	inter'kultur'a'j
interkulturan	inter'kultur'a'n
interkulturo	inter'kultur'o
interliga	inter'lig'a
interligaj	inter'lig'a'j
interligan	inter'lig'a'n
interligas	inter'lig'as
interligi	inter'lig'i
interligis	inter'lig'is
interligo	inter'lig'o
interligoj	inter'lig'o'j
interligojn	inter'lig'o'j'n
interligon	inter'lig'o'n
interligus	inter'lig'us
interligado	inter'lig'ad'o
interliganta	inter'lig'ant'a
interligantaj	inter'lig'ant'a'j
interligante	inter'lig'ant'e
interligiĝas	inter'lig'iĝ'as
interligiĝis	inter'lig'iĝ'is
interligilo	inter'lig'il'o
interligita	inter'lig'it'a
interligitaj	inter'lig'it'a'j
interligitajn	inter'lig'it'a'j'n
interligitan	inter'lig'it'a'n
interligiteco	inter'lig'it'ec'o
interligitecon	inter'lig'it'ec'o'n
interlingva	inter'lingv'a
interlingvo	inter'lingv'o
interlingvoj	inter'lingv'o'j
interlingvon	inter'lingv'o'n
interlingvismo	inter'lingv'ism'o
interlingvisto	inter'lingv'ist'o
interlingvistoj	inter'lingv'ist'o'j
interlingvistika	inter'lingv'ist'ik'a
interlingvistikaj	inter'lingv'ist'ik'a'j
interlingvistiko	inter'lingv'ist'ik'o
interlingvistikon	inter'lingv'ist'ik'o'n
interludo	inter'lud'o
intermama	inter'mam'a
intermetas	inter'met'as
intermeti	inter'met'i
intermetis	inter'met'is
intermetita	inter'met'it'a
intermetitaj	inter'met'it'a'j
intermeza	inter'mez'a
intermezaj	inter'mez'a'j
intermezo	inter'mez'o
intermiksas	inter'miks'as
intermiksi	inter'miks'i
intermiksis	inter'miks'is
intermikso	inter'miks'o
intermiksu	inter'miks'u
intermiksado	inter'miks'ad'o
intermiksiĝas	inter'miks'iĝ'as
intermiksiĝis	inter'miks'iĝ'is
intermiksita	inter'miks'it'a
intermiksitaj	inter'miks'it'a'j
intermilita	inter'milit'a
intermilitaj	inter'milit'a'j
intermodala	inter'modal'a
intermolekulaj	inter'molekul'a'j
intermontaj	inter'mont'a'j
intermonto	inter'mont'o
intermontoj	inter'mont'o'j
intermonton	inter'mont'o'n
internacia	inter'naci'a
internaciaj	inter'naci'a'j
internaciajn	inter'naci'a'j'n
internacian	inter'naci'a'n
internacie	inter'naci'e
internacio	inter'naci'o
internacion	inter'naci'o'n
internaciakomerca	inter'naci'a'komerc'a
internacieca	inter'naci'ec'a
internacieco	inter'naci'ec'o
internaciecon	inter'naci'ec'o'n
internaciigi	inter'naci'ig'i
internaciigo	inter'naci'ig'o
internaciigado	inter'naci'ig'ad'o
internaciigitaj	inter'naci'ig'it'a'j
internaciiĝo	inter'naci'iĝ'o
internaciisma	inter'naci'ism'a
internaciismo	inter'naci'ism'o
internaciismon	inter'naci'ism'o'n
internaciisto	inter'naci'ist'o
internaciistoj	inter'naci'ist'o'j
internacilingva	inter'naci'lingv'a
internacinivele	inter'naci'nivel'e
internaciskale	inter'naci'skal'e
interpaciga	inter'pac'ig'a
interpacigaj	inter'pac'ig'a'j
interpacigajn	inter'pac'ig'a'j'n
interpacigi	inter'pac'ig'i
interpacigo	inter'pac'ig'o
interpaciĝo	inter'pac'iĝ'o
interpafado	inter'paf'ad'o
interparolas	inter'parol'as
interparoli	inter'parol'i
interparolis	inter'parol'is
interparolo	inter'parol'o
interparoloj	inter'parol'o'j
interparolojn	inter'parol'o'j'n
interparolon	inter'parol'o'n
interparolos	inter'parol'os
interparolu	inter'parol'u
interparolus	inter'parol'us
interparoladis	inter'parol'ad'is
interparolado	inter'parol'ad'o
interparoladoj	inter'parol'ad'o'j
interparoladon	inter'parol'ad'o'n
interparolante	inter'parol'ant'e
interparolanto	inter'parol'ant'o
interparolantoj	inter'parol'ant'o'j
interparolanton	inter'parol'ant'o'n
interpersona	inter'person'a
interpersonaj	inter'person'a'j
interplaneda	inter'planed'a
interplanedaj	inter'planed'a'j
interplektas	inter'plekt'as
interplektis	inter'plekt'is
interplektado	inter'plekt'ad'o
interplektaĵo	inter'plekt'aĵ'o
interplektante	inter'plekt'ant'e
interplektiĝas	inter'plekt'iĝ'as
interplektiĝis	inter'plekt'iĝ'is
interplektiĝo	inter'plekt'iĝ'o
interplektita	inter'plekt'it'a
interplektitaj	inter'plekt'it'a'j
interplektitajn	inter'plekt'it'a'j'n
interplektitan	inter'plekt'it'a'n
interpopola	inter'popol'a
interpopolaj	inter'popol'a'j
interpopolan	inter'popol'a'n
interproksimigo	inter'proksim'ig'o
interreagema	inter're'ag'em'a
interregistara	inter'reg'ist'ar'a
interregistaraj	inter'reg'ist'ar'a'j
interregiona	inter'region'a
interregionaj	inter'region'a'j
interreligia	inter'religi'a
interreligiaj	inter'religi'a'j
interreligian	inter'religi'a'n
interreta	inter'ret'a
interretaj	inter'ret'a'j
interretajn	inter'ret'a'j'n
interretan	inter'ret'a'n
interrete	inter'ret'e
interreto	inter'ret'o
interreton	inter'ret'o'n
interretenhavo	inter'ret'en'hav'o
interretuzantoj	inter'ret'uz'ant'o'j
interrigardis	inter'rigard'is
interrilata	inter'rilat'a
interrilataj	inter'rilat'a'j
interrilatajn	inter'rilat'a'j'n
interrilatan	inter'rilat'a'n
interrilatas	inter'rilat'as
interrilati	inter'rilat'i
interrilatis	inter'rilat'is
interrilato	inter'rilat'o
interrilatoj	inter'rilat'o'j
interrilatojn	inter'rilat'o'j'n
interrilaton	inter'rilat'o'n
interrilatado	inter'rilat'ad'o
interrilatantaj	inter'rilat'ant'a'j
interrilatigi	inter'rilat'ig'i
interrompa	inter'romp'a
interrompaj	inter'romp'a'j
interrompan	inter'romp'a'n
interrompas	inter'romp'as
interrompi	inter'romp'i
interrompis	inter'romp'is
interrompo	inter'romp'o
interrompoj	inter'romp'o'j
interrompojn	inter'romp'o'j'n
interrompon	inter'romp'o'n
interrompos	inter'romp'os
interrompu	inter'romp'u
interrompus	inter'romp'us
interrompado	inter'romp'ad'o
interrompanta	inter'romp'ant'a
interrompante	inter'romp'ant'e
interrompata	inter'romp'at'a
interrompiĝas	inter'romp'iĝ'as
interrompiĝis	inter'romp'iĝ'is
interrompita	inter'romp'it'a
interrompitaj	inter'romp'it'a'j
interrompitajn	inter'romp'it'a'j'n
interrompitan	inter'romp'it'a'n
interŝanĝa	inter'ŝanĝ'a
interŝanĝaj	inter'ŝanĝ'a'j
interŝanĝan	inter'ŝanĝ'a'n
interŝanĝas	inter'ŝanĝ'as
interŝanĝe	inter'ŝanĝ'e
interŝanĝi	inter'ŝanĝ'i
interŝanĝis	inter'ŝanĝ'is
interŝanĝo	inter'ŝanĝ'o
interŝanĝoj	inter'ŝanĝ'o'j
interŝanĝojn	inter'ŝanĝ'o'j'n
interŝanĝon	inter'ŝanĝ'o'n
interŝanĝos	inter'ŝanĝ'os
interŝanĝu	inter'ŝanĝ'u
interŝanĝus	inter'ŝanĝ'us
interŝanĝado	inter'ŝanĝ'ad'o
interŝanĝanta	inter'ŝanĝ'ant'a
interŝanĝantaj	inter'ŝanĝ'ant'a'j
interŝanĝante	inter'ŝanĝ'ant'e
interŝanĝebla	inter'ŝanĝ'ebl'a
interŝanĝeblaj	inter'ŝanĝ'ebl'a'j
interŝanĝeblajn	inter'ŝanĝ'ebl'a'j'n
interŝanĝeble	inter'ŝanĝ'ebl'e
interŝanĝita	inter'ŝanĝ'it'a
interŝanĝitaj	inter'ŝanĝ'it'a'j
intersekca	inter'sekc'a
intersekcas	inter'sekc'as
intersekco	inter'sekc'o
intersekciĝo	inter'sekc'iĝ'o
intersekciĝoj	inter'sekc'iĝ'o'j
intersekciĝojn	inter'sekc'iĝ'o'j'n
intersekciĝon	inter'sekc'iĝ'o'n
intersimilas	inter'simil'as
interspacaj	inter'spac'a'j
interspaco	inter'spac'o
interspacoj	inter'spac'o'j
interspacojn	inter'spac'o'j'n
interspacon	inter'spac'o'n
interspacigas	inter'spac'ig'as
interspacigis	inter'spac'ig'is
interspacigo	inter'spac'ig'o
interspacigon	inter'spac'ig'o'n
interspacigitaj	inter'spac'ig'it'a'j
interspecia	inter'speci'a
interspecifa	inter'specif'a
interŝtata	inter'ŝtat'a
interŝtataj	inter'ŝtat'a'j
interŝtatajn	inter'ŝtat'a'j'n
interŝtatan	inter'ŝtat'a'n
interstela	inter'stel'a
interstelaj	inter'stel'a'j
interstelajn	inter'stel'a'j'n
interstelan	inter'stel'a'n
intertajda	inter'tajd'a
intertajdaj	inter'tajd'a'j
interteksteco	inter'tekst'ec'o
intertempa	inter'temp'a
intertempaj	inter'temp'a'j
intertempan	inter'temp'a'n
intertempe	inter'temp'e
intertempo	inter'temp'o
intertempoj	inter'temp'o'j
intertempon	inter'temp'o'n
intertrakta	inter'trakt'a
intertraktas	inter'trakt'as
intertrakti	inter'trakt'i
intertraktis	inter'trakt'is
intertrakto	inter'trakt'o
intertraktoj	inter'trakt'o'j
intertraktojn	inter'trakt'o'j'n
intertraktado	inter'trakt'ad'o
intertraktadoj	inter'trakt'ad'o'j
intertraktadojn	inter'trakt'ad'o'j'n
intertraktadon	inter'trakt'ad'o'n
intertraktanto	inter'trakt'ant'o
intertraktantoj	inter'trakt'ant'o'j
intertropika	inter'tropik'a
intertuŝas	inter'tuŝ'as
intertuŝo	inter'tuŝ'o
interurba	inter'urb'a
interurbaj	inter'urb'a'j
interurbajn	inter'urb'a'j'n
intervenas	inter'ven'as
interveni	inter'ven'i
intervenis	inter'ven'is
interveno	inter'ven'o
intervenoj	inter'ven'o'j
intervenojn	inter'ven'o'j'n
intervenon	inter'ven'o'n
intervenos	inter'ven'os
intervenu	inter'ven'u
intervenus	inter'ven'us
intervenado	inter'ven'ad'o
intervertebra	inter'vertebr'a
intervidiĝi	inter'vid'iĝ'i
intervidiĝis	inter'vid'iĝ'is
intervidiĝo	inter'vid'iĝ'o
intervidiĝon	inter'vid'iĝ'o'n
intervidiĝos	inter'vid'iĝ'os
intervidiĝante	inter'vid'iĝ'ant'e
intervokala	inter'vokal'a
interesa	interes'a
interesaj	interes'a'j
interesajn	interes'a'j'n
interesan	interes'a'n
interesas	interes'as
interese	interes'e
interesi	interes'i
interesis	interes'is
intereso	interes'o
interesoj	interes'o'j
interesojn	interes'o'j'n
intereson	interes'o'n
interesos	interes'os
interesus	interes'us
interesado	interes'ad'o
interesaĵo	interes'aĵ'o
interesaĵoj	interes'aĵ'o'j
interesaĵojn	interes'aĵ'o'j'n
interesata	interes'at'a
interesataj	interes'at'a'j
interesate	interes'at'e
interesato	interes'at'o
interesatoj	interes'at'o'j
interesatojn	interes'at'o'j'n
interesega	interes'eg'a
interesegaj	interes'eg'a'j
interesegan	interes'eg'a'n
interesgrupo	interes'grup'o
interesgrupoj	interes'grup'o'j
interesigas	interes'ig'as
interesigi	interes'ig'i
interesigis	interes'ig'is
interesiĝas	interes'iĝ'as
interesiĝi	interes'iĝ'i
interesiĝis	interes'iĝ'is
interesigho	interes'iĝ'o
interesiĝo	interes'iĝ'o
interesiĝoj	interes'iĝ'o'j
interesiĝon	interes'iĝ'o'n
interesiĝos	interes'iĝ'os
interesiĝu	interes'iĝ'u
interesiĝus	interes'iĝ'us
interesiĝantaj	interes'iĝ'ant'a'j
interesiĝante	interes'iĝ'ant'e
interesiĝantoj	interes'iĝ'ant'o'j
interesiĝantojn	interes'iĝ'ant'o'j'n
interesita	interes'it'a
interesitaj	interes'it'a'j
interesitajn	interes'it'a'j'n
interesite	interes'it'e
interesito	interes'it'o
interesitoj	interes'it'o'j
interesitojn	interes'it'o'j'n
interesuloj	interes'ul'o'j
intereza	interez'a
interezo	interez'o
interezoj	interez'o'j
interezojn	interez'o'j'n
interezon	interez'o'n
interezoprocento	interez'o'procent'o
interezoprocentoj	interez'o'procent'o'j
interezoprocentojn	interez'o'procent'o'j'n
interezoprocenton	interez'o'procent'o'n
interfero	interfer'o
interferoj	interfer'o'j
interferon	interfer'o'n
interferometro	interferometr'o
interjekcio	interjekci'o
interjekcioj	interjekci'o'j
interjekciojn	interjekci'o'j'n
interlingvao	interlingva'o
interlingvaon	interlingva'o'n
intermeza	intermez'a
intermezaj	intermez'a'j
intermezo	intermez'o
intermita	intermit'a
intermitaj	intermit'a'j
intermitajn	intermit'a'j'n
intermitan	intermit'a'n
intermite	intermit'e
intermiti	intermit'i
interna	intern'a
internaj	intern'a'j
internajn	intern'a'j'n
internan	intern'a'n
interne	intern'e
internen	intern'e'n
interno	intern'o
internoj	intern'o'j
internojn	intern'o'j'n
internon	intern'o'n
internaĵo	intern'aĵ'o
internaĵoj	intern'aĵ'o'j
internaĵojn	intern'aĵ'o'j'n
internaĵon	intern'aĵ'o'n
interndeĵoro	intern'deĵor'o
interndeĵoroj	intern'deĵor'o'j
interndeĵorojn	intern'deĵor'o'j'n
interndeĵoron	intern'deĵor'o'n
interneto	intern'et'o
internigas	intern'ig'as
internigi	intern'ig'i
internigis	intern'ig'is
internigo	intern'ig'o
internigita	intern'ig'it'a
internigitaj	intern'ig'it'a'j
interninformantoj	intern'inform'ant'o'j
internuloj	intern'ul'o'j
internulejo	intern'ul'ej'o
interpola	interpol'a
interpolas	interpol'as
interpoli	interpol'i
interpolado	interpol'ad'o
interpreta	interpret'a
interpretaj	interpret'a'j
interpretas	interpret'as
interpreti	interpret'i
interpretis	interpret'is
interpreto	interpret'o
interpretoj	interpret'o'j
interpretojn	interpret'o'j'n
interpreton	interpret'o'n
interpretos	interpret'os
interpretu	interpret'u
interpretus	interpret'us
interpretado	interpret'ad'o
interpretadoj	interpret'ad'o'j
interpretadojn	interpret'ad'o'j'n
interpretadon	interpret'ad'o'n
interpretanta	interpret'ant'a
interpretantaj	interpret'ant'a'j
interpretante	interpret'ant'e
interpretanto	interpret'ant'o
interpretantoj	interpret'ant'o'j
interpretata	interpret'at'a
interpretataj	interpret'at'a'j
interpretebla	interpret'ebl'a
interpreteblaj	interpret'ebl'a'j
interpreteblas	interpret'ebl'as
interpretilo	interpret'il'o
interpretisto	interpret'ist'o
interpretistoj	interpret'ist'o'j
interpretistojn	interpret'ist'o'j'n
interpretiston	interpret'ist'o'n
interpretistino	interpret'ist'in'o
interpretita	interpret'it'a
interpretitaj	interpret'it'a'j
interpretite	interpret'it'e
interpunkcia	interpunkci'a
interpunkciaj	interpunkci'a'j
interpunkcio	interpunkci'o
interpunkcioj	interpunkci'o'j
interpunkcion	interpunkci'o'n
interpunkciosignoj	interpunkci'o'sign'o'j
intervala	interval'a
intervalas	interval'as
intervali	interval'i
intervalis	interval'is
intervalo	interval'o
intervaloj	interval'o'j
intervalojn	interval'o'j'n
intervalon	interval'o'n
intervalanta	interval'ant'a
intervalantaj	interval'ant'a'j
intervalantajn	interval'ant'a'j'n
intervalante	interval'ant'e
intervjuas	intervju'as
intervjui	intervju'i
intervjuis	intervju'is
intervjuo	intervju'o
intervjuoj	intervju'o'j
intervjuojn	intervju'o'j'n
intervjuon	intervju'o'n
intervjuos	intervju'os
intervjuado	intervju'ad'o
intervjuante	intervju'ant'e
intervjuanto	intervju'ant'o
intervjuantoj	intervju'ant'o'j
intervjuata	intervju'at'a
intervjuate	intervju'at'e
intervjuita	intervju'it'a
intervjuitaj	intervju'it'a'j
intervjuite	intervju'it'e
intervjuito	intervju'it'o
intervjuitoj	intervju'it'o'j
intesta	intest'a
intestaj	intest'a'j
intestajn	intest'a'j'n
intestan	intest'a'n
intesto	intest'o
intestoj	intest'o'j
intestojn	intest'o'j'n
inteston	intest'o'n
intestaro	intest'ar'o
intima	intim'a
intimaj	intim'a'j
intimajn	intim'a'j'n
intiman	intim'a'n
intimas	intim'as
intime	intim'e
intimo	intim'o
intimeco	intim'ec'o
intimecon	intim'ec'o'n
intimiĝis	intim'iĝ'is
intimuloj	intim'ul'o'j
intonacio	intonaci'o
intonacioj	intonaci'o'j
intonacion	intonaci'o'n
intraĉela	intra'ĉel'a
intraĉelaj	intra'ĉel'a'j
intraĉelan	intra'ĉel'a'n
intrakrania	intra'krani'a
intrareto	intra'ret'o
intrautera	intra'uter'a
intravejna	intra'vejn'a
intravejnaj	intra'vejn'a'j
intravejne	intra'vejn'e
intriga	intrig'a
intrigas	intrig'as
intrigi	intrig'i
intrigis	intrig'is
intrigo	intrig'o
intrigoj	intrig'o'j
intrigojn	intrig'o'j'n
intrigon	intrig'o'n
intrigado	intrig'ad'o
intrigante	intrig'ant'e
intrigita	intrig'it'a
intrigitaj	intrig'it'a'j
introspekto	introspekt'o
introvertaj	introvert'a'j
introvertita	introvertit'a
intuo	intu'o
intuicia	intuici'a
intuiciaj	intuici'a'j
intuiciajn	intuici'a'j'n
intuician	intuici'a'n
intuicie	intuici'e
intuicio	intuici'o
intuicioj	intuici'o'j
intuicion	intuici'o'n
inuita	inuit'a
inuitaj	inuit'a'j
inuito	inuit'o
inuitoj	inuit'o'j
inunda	inund'a
inundas	inund'as
inundi	inund'i
inundis	inund'is
inundo	inund'o
inundoj	inund'o'j
inundojn	inund'o'j'n
inundon	inund'o'n
inundos	inund'os
inundado	inund'ad'o
inundadon	inund'ad'o'n
inundante	inund'ant'e
inundata	inund'at'a
inundataj	inund'at'a'j
inundita	inund'it'a
inunditaj	inund'it'a'j
inundokontrolo	inund'o'kontrol'o
invada	invad'a
invadaj	invad'a'j
invadan	invad'a'n
invadas	invad'as
invadi	invad'i
invadis	invad'is
invado	invad'o
invadoj	invad'o'j
invadojn	invad'o'j'n
invadon	invad'o'n
invados	invad'os
invadus	invad'us
invadado	invad'ad'o
invadantaj	invad'ant'a'j
invadante	invad'ant'e
invadanto	invad'ant'o
invadantoj	invad'ant'o'j
invadantojn	invad'ant'o'j'n
invadinto	invad'int'o
invadintoj	invad'int'o'j
invadistoj	invad'ist'o'j
invadita	invad'it'a
invaditaj	invad'it'a'j
invalido	invalid'o
invalidoj	invalid'o'j
invalideco	invalid'ec'o
invarianto	invariant'o
invariantoj	invariant'o'j
inventa	invent'a
inventas	invent'as
inventi	invent'i
inventis	invent'is
invento	invent'o
inventoj	invent'o'j
inventojn	invent'o'j'n
inventon	invent'o'n
inventos	invent'os
inventu	invent'u
inventus	invent'us
inventado	invent'ad'o
inventaĵo	invent'aĵ'o
inventaĵoj	invent'aĵ'o'j
inventaĵojn	invent'aĵ'o'j'n
inventaĵon	invent'aĵ'o'n
inventante	invent'ant'e
inventaro	invent'ar'o
inventaron	invent'ar'o'n
inventema	invent'em'a
inventemaj	invent'em'a'j
inventemo	invent'em'o
inventemon	invent'em'o'n
inventiĝis	invent'iĝ'is
inventinto	invent'int'o
inventintoj	invent'int'o'j
inventisto	invent'ist'o
inventistoj	invent'ist'o'j
inventiston	invent'ist'o'n
inventita	invent'it'a
inventitaj	invent'it'a'j
inventitan	invent'it'a'n
inventaro	inventar'o
inventaron	inventar'o'n
inversa	invers'a
inversaj	invers'a'j
inversajn	invers'a'j'n
inversan	invers'a'n
inverse	invers'e
inverso	invers'o
inverson	invers'o'n
inversigas	invers'ig'as
inversigi	invers'ig'i
inversigis	invers'ig'is
inversigo	invers'ig'o
inversigoj	invers'ig'o'j
inversigon	invers'ig'o'n
inversigado	invers'ig'ad'o
inversigante	invers'ig'ant'e
inversigebla	invers'ig'ebl'a
inversigita	invers'ig'it'a
inversigitaj	invers'ig'it'a'j
inversiĝis	invers'iĝ'is
inversita	invers'it'a
inversio	inversi'o
inversioj	inversi'o'j
inversion	inversi'o'n
invertita	invert'it'a
investa	invest'a
investaj	invest'a'j
investajn	invest'a'j'n
investan	invest'a'n
investas	invest'as
investi	invest'i
investis	invest'is
investo	invest'o
investoj	invest'o'j
investojn	invest'o'j'n
investon	invest'o'n
investos	invest'os
investu	invest'u
investus	invest'us
investado	invest'ad'o
investadon	invest'ad'o'n
investaĵo	invest'aĵ'o
investanta	invest'ant'a
investante	invest'ant'e
investanto	invest'ant'o
investantoj	invest'ant'o'j
investantojn	invest'ant'o'j'n
investbankoj	invest'bank'o'j
investistoj	invest'ist'o'j
investita	invest'it'a
investitaj	invest'it'a'j
investituro	investitur'o
invita	invit'a
invitas	invit'as
invite	invit'e
inviti	invit'i
invitis	invit'is
invito	invit'o
invitoj	invit'o'j
invitojn	invit'o'j'n
inviton	invit'o'n
invitos	invit'os
invitu	invit'u
invitus	invit'us
invitado	invit'ad'o
invitanta	invit'ant'a
invitante	invit'ant'e
invitata	invit'at'a
invitataj	invit'at'a'j
invitiĝis	invit'iĝ'is
invitilo	invit'il'o
invitilojn	invit'il'o'j'n
invitilon	invit'il'o'n
invitinta	invit'int'a
invitita	invit'it'a
invititaj	invit'it'a'j
invitite	invit'it'e
invitito	invit'it'o
invititoj	invit'it'o'j
invitleteron	invit'leter'o'n
involukraj	involukr'a'j
involukro	involukr'o
iom	iom
ioma	iom'a
iomaj	iom'a'j
iomajn	iom'a'j'n
ioman	iom'a'n
iome	iom'e
iometa	iom'et'a
iometaj	iom'et'a'j
iometajn	iom'et'a'j'n
iometan	iom'et'a'n
iomete	iom'et'e
iometo	iom'et'o
iometon	iom'et'o'n
iometete	iom'et'et'e
iompostiom	iom'post'iom
iompostioma	iom'post'iom'a
iompostioman	iom'post'iom'a'n
iompostiome	iom'post'iom'e
iona	ion'a
ionia	ioni'a
ionio	ioni'o
ionianoj	ioni'an'o'j
ionika	ionik'a
ionikaj	ionik'a'j
iovao	iova'o
ipo	ip'o
ira	ir'a
iran	ir'a'n
iras	ir'as
ire	ir'e
iri	ir'i
iris	ir'is
iro	ir'o
iron	ir'o'n
iros	ir'os
iru	ir'u
irus	ir'us
iradas	ir'ad'as
iradi	ir'ad'i
iradis	ir'ad'is
irado	ir'ad'o
iradoj	ir'ad'o'j
iradon	ir'ad'o'n
irados	ir'ad'os
iranta	ir'ant'a
irantaj	ir'ant'a'j
irantajn	ir'ant'a'j'n
irantan	ir'ant'a'n
irante	ir'ant'e
irantoj	ir'ant'o'j
irebla	ir'ebl'a
irejo	ir'ej'o
irejon	ir'ej'o'n
irigas	ir'ig'as
irigi	ir'ig'i
irigis	ir'ig'is
irigos	ir'ig'os
irinta	ir'int'a
irintaj	ir'int'a'j
irinte	ir'int'e
irintus	ir'int'us
irita	ir'it'a
iritaj	ir'it'a'j
iritan	ir'it'a'n
iritas	ir'it'as
iriti	ir'it'i
iritis	ir'it'is
irito	ir'it'o
iriton	ir'it'o'n
irmaniero	ir'manier'o
irmanieron	ir'manier'o'n
ironta	ir'ont'a
irontaj	ir'ont'a'j
ironte	ir'ont'e
irota	ir'ot'a
irpreni	ir'pren'i
irvojo	ir'voj'o
iraka	irak'a
irakaj	irak'a'j
irakajn	irak'a'j'n
irakan	irak'a'n
irako	irak'o
irakon	irak'o'n
irakano	irak'an'o
irakanoj	irak'an'o'j
irakanojn	irak'an'o'j'n
irakmilito	irak'milit'o
irana	iran'a
iranaj	iran'a'j
iranajn	iran'a'j'n
iranan	iran'a'n
irano	iran'o
iranon	iran'o'n
iranano	iran'an'o
irananoj	iran'an'o'j
irananojn	iran'an'o'j'n
irandevena	iran'de'ven'a
irena	iren'a
irene	iren'e
ireneo	irene'o
irido	irid'o
iridio	iridi'o
irigacia	irigaci'a
irigaciaj	irigaci'a'j
irigaciajn	irigaci'a'j'n
irigacian	irigaci'a'n
irigacias	irigaci'as
irigacii	irigaci'i
irigacio	irigaci'o
irigacion	irigaci'o'n
irigaciado	irigaci'ad'o
irigaciita	irigaci'it'a
irigaciitaj	irigaci'it'a'j
iriso	iris'o
irisoj	iris'o'j
irisojn	iris'o'j'n
irison	iris'o'n
irita	irit'a
iritaj	irit'a'j
iritan	irit'a'n
iritas	irit'as
iriti	irit'i
iritis	irit'is
irito	irit'o
iriton	irit'o'n
iritaĵo	irit'aĵ'o
iritiĝo	irit'iĝ'o
iritiĝon	irit'iĝ'o'n
iritiĝemo	irit'iĝ'em'o
iritita	irit'it'a
irititaj	irit'it'a'j
irizaj	iriz'a'j
irizeco	iriz'ec'o
irlanda	irland'a
irlandaj	irland'a'j
irlandajn	irland'a'j'n
irlandan	irland'a'n
irlande	irland'e
irlando	irland'o
irlandon	irland'o'n
irlandano	irland'an'o
irlandanoj	irland'an'o'j
irlandanon	irland'an'o'n
ironia	ironi'a
ironiaj	ironi'a'j
ironian	ironi'a'n
ironias	ironi'as
ironie	ironi'e
ironiis	ironi'is
ironio	ironi'o
ironion	ironi'o'n
isa	is'a
iso	is'o
ison	is'o'n
isformo	is'form'o
isidoro	isidor'o
iskarioto	iskariot'o
iskemia	iskemi'a
iskemio	iskemi'o
islama	islam'a
islamaj	islam'a'j
islamajn	islam'a'j'n
islaman	islam'a'n
islamo	islam'o
islamon	islam'o'n
islamana	islam'an'a
islamanaj	islam'an'a'j
islamano	islam'an'o
islamanoj	islam'an'o'j
islamanojn	islam'an'o'j'n
islamanon	islam'an'o'n
islamanino	islam'an'in'o
islamigo	islam'ig'o
islamisma	islam'ism'a
islamismaj	islam'ism'a'j
islamismo	islam'ism'o
islamisto	islam'ist'o
islamistoj	islam'ist'o'j
islamistojn	islam'ist'o'j'n
islamteoriuloj	islam'teori'ul'o'j
islanda	island'a
islandaj	island'a'j
islandan	island'a'n
islande	island'e
islando	island'o
islandon	island'o'n
islandano	island'an'o
islandanoj	island'an'o'j
ismo	ism'o
ismoj	ism'o'j
israela	israel'a
israelaj	israel'a'j
israelajn	israel'a'j'n
israelan	israel'a'n
israelo	israel'o
israelon	israel'o'n
israelapalestina	israel'a'palestin'a
israelano	israel'an'o
israelanoj	israel'an'o'j
israelanojn	israel'an'o'j'n
israelpalestina	israel'palestin'a
isto	ist'o
istoj	ist'o'j
istanbula	istanbul'a
istanbulo	istanbul'o
istmo	istm'o
ita	it'a
iti	it'i
ito	it'o
itoj	it'o'j
itojn	it'o'j'n
itu	it'u
itino	it'in'o
itala	ital'a
italaj	ital'a'j
italajn	ital'a'j'n
italan	ital'a'n
itale	ital'e
italo	ital'o
italoj	ital'o'j
italojn	ital'o'j'n
italon	ital'o'n
italdevena	ital'de'ven'a
italia	ital'i'a
italiaj	ital'i'a'j
italian	ital'i'a'n
italio	ital'i'o
italion	ital'i'o'n
italiana	ital'i'an'a
italino	ital'in'o
itallingva	ital'lingv'a
itallingvaj	ital'lingv'a'j
itallingve	ital'lingv'e
italujo	ital'uj'o
italujon	ital'uj'o'n
iteracio	iteraci'o
itinero	itiner'o
itineroj	itiner'o'j
itinerojn	itiner'o'j'n
itineron	itiner'o'n
iu	iu
iuj	iu'j
iun	iu'n
iufoje	iu'foj'e
iugrade	iu'grad'e
iujn	iu'j'n
iukaze	iu'kaz'e
iuloke	iu'lok'e
iumaniere	iu'manier'e
iumatene	iu'maten'e
iumomente	iu'moment'e
iusence	iu'senc'e
iuspeca	iu'spec'a
iuspecan	iu'spec'a'n
iutage	iu'tag'e
iutempe	iu'temp'e
ivano	ivan'o
ivanon	ivan'o'n
izisa	izis'a
iziso	izis'o
izola	izol'a
izolaj	izol'a'j
izolajn	izol'a'j'n
izolan	izol'a'n
izolas	izol'as
izole	izol'e
izoli	izol'i
izolis	izol'is
izolo	izol'o
izolado	izol'ad'o
izoladon	izol'ad'o'n
izolaĵo	izol'aĵ'o
izolaĵoj	izol'aĵ'o'j
izolanta	izol'ant'a
izolante	izol'ant'e
izolata	izol'at'a
izolataj	izol'at'a'j
izoleco	izol'ec'o
izolecon	izol'ec'o'n
izolejo	izol'ej'o
izoligas	izol'ig'as
izoligo	izol'ig'o
izoliĝis	izol'iĝ'is
izoliĝo	izol'iĝ'o
izolilo	izol'il'o
izoliloj	izol'il'o'j
izolita	izol'it'a
izolitaj	izol'it'a'j
izolitajn	izol'it'a'j'n
izolitan	izol'it'a'n
izolite	izol'it'e
izolitaĵo	izol'it'aĵ'o
izolitaĵoj	izol'it'aĵ'o'j
izoliteco	izol'it'ec'o
izolitecon	izol'it'ec'o'n
izolulo	izol'ul'o
izoluloj	izol'ul'o'j
izomero	izomer'o
izomeroj	izomer'o'j
izomerojn	izomer'o'j'n
izomorfaj	izomorf'a'j
izomorfio	izomorf'i'o
izoterma	izoterm'a
izotopa	izotop'a
izotopo	izotop'o
izotopoj	izotop'o'j
izotopojn	izotop'o'j'n
izotropa	izotrop'a
izotropaj	izotrop'a'j