ja	ja
jaas	ja'as
jalapa	ja'lap'a
jabano	jaban'o
jabiruo	jabiru'o
jacinto	jacint'o
jacinton	jacint'o'n
jaĉjo	jaĉj'o
jaĉjon	jaĉj'o'n
jada	jad'a
jadaj	jad'a'j
jadajn	jad'a'j'n
jadan	jad'a'n
jade	jad'e
jadi	jad'i
jadis	jad'is
jado	jad'o
jadoj	jad'o'j
jadojn	jad'o'j'n
jadon	jad'o'n
jadaĵo	jad'aĵ'o
jadaĵoj	jad'aĵ'o'j
jadaĵojn	jad'aĵ'o'j'n
jadaĵon	jad'aĵ'o'n
jadekranan	jad'ekran'a'n
jadisto	jad'ist'o
jadorivero	jad'o'river'o
jadpendaĵon	jad'pend'aĵ'o'n
jadspeco	jad'spec'o
jadzona	jad'zon'a
jaguara	jaguar'a
jaguaro	jaguar'o
jaguaroj	jaguar'o'j
jaguarojn	jaguar'o'j'n
jaguaron	jaguar'o'n
jaguarkapo	jaguar'kap'o
jaguarpiedulon	jaguar'pied'ul'o'n
jahuo	jahu'o
jahuojn	jahu'o'j'n
jahugrupo	jahu'grup'o
jahurta	jahurt'a
jahurto	jahurt'o
jahurton	jahurt'o'n
jaĥta	jaĥt'a
jaĥto	jaĥt'o
jaĥtoj	jaĥt'o'j
jaĥtojn	jaĥt'o'j'n
jaĥton	jaĥt'o'n
jaĥtejo	jaĥt'ej'o
jaĥtejoj	jaĥt'ej'o'j
jaĥthaveno	jaĥt'haven'o
jajurvedo	jajurved'o
jakan	jak'a'n
jake	jak'e
jako	jak'o
jakoj	jak'o'j
jakojn	jak'o'j'n
jakon	jak'o'n
jaketo	jak'et'o
jaketoj	jak'et'o'j
jaketojn	jak'et'o'j'n
jaketon	jak'et'o'n
jaketodiagramo	jak'et'o'diagram'o
jakmaterialo	jak'material'o
jakopoŝo	jak'o'poŝ'o
jakanao	jakana'o
jakanaoj	jakana'o'j
jakanaedoj	jakana'ed'o'j
jakarandoj	jakarand'o'j
jakelino	jakelin'o
jakoba	jakob'a
jakobaj	jakob'a'j
jakoban	jakob'a'n
jakobi	jakob'i
jakobo	jakob'o
jakobon	jakob'o'n
jakobina	jakob'in'a
jakobinaj	jakob'in'a'j
jakobinan	jakob'in'a'n
jakobinoj	jakob'in'o'j
jakobitoj	jakob'it'o'j
jakobitismo	jakob'it'ism'o
jakobitkialo	jakob'it'kial'o
jakoboisraelo	jakob'o'israel'o
jakobojakobo	jakob'o'jakob'o
jakoboversio	jakob'o'versi'o
jakobeo	jakobe'o
jakobena	jakoben'a
jakobenaj	jakoben'a'j
jakobeno	jakoben'o
jakobenoj	jakoben'o'j
jakobenojn	jakoben'o'j'n
jakobenismo	jakoben'ism'o
jakobia	jakobi'a
jakono	jakon'o
jakopono	jakopon'o
jakuo	jaku'o
jakuoj	jaku'o'j
jakuojn	jaku'o'j'n
jakutio	jakut'i'o
jakuza	jakuz'a
jakuzo	jakuz'o
jalioj	jali'o'j
jam	jam
jama	jam'a
jamaj	jam'a'j
jamajn	jam'a'j'n
jaman	jam'a'n
jamas	jam'as
jame	jam'e
jamo	jam'o
jamon	jam'o'n
jamekzistanta	jam'ekzist'ant'a
jamekzistantajn	jam'ekzist'ant'a'j'n
jamkonataj	jam'kon'at'a'j
jamajka	jamajk'a
jamajkaj	jamajk'a'j
jamajkan	jamajk'a'n
jamajko	jamajk'o
jamajkon	jamajk'o'n
jamajkakreola	jamajk'a'kreol'a
jamajkano	jamajk'an'o
jamajkanoj	jamajk'an'o'j
jamanoj	jaman'o'j
jamato	jamat'o
jamba	jamb'a
jambaj	jamb'a'j
jamban	jamb'a'n
jambe	jamb'e
jambi	jamb'i
jambo	jamb'o
jamboj	jamb'o'j
jambojn	jamb'o'j'n
jambon	jamb'o'n
jambua	jambu'a
jamburga	jamburg'a
jamburgaj	jamburg'a'j
jamendo	jamend'o
janiĉara	janiĉar'a
janiĉaro	janiĉar'o
janiĉaroj	janiĉar'o'j
janiĉarojn	janiĉar'o'j'n
janiĉartrupoj	janiĉar'trup'o'j
janjo	janj'o
jansenismo	jansen'ism'o
jansenistoj	jansen'ist'o'j
januara	januar'a
januaran	januar'a'n
januare	januar'e
januaro	januar'o
januaron	januar'o'n
januarofebruaro	januar'o'februar'o
japana	japan'a
japanaj	japan'a'j
japanajn	japan'a'j'n
japanan	japan'a'n
japane	japan'e
japanen	japan'e'n
japano	japan'o
japanoj	japan'o'j
japanojn	japan'o'j'n
japanon	japan'o'n
japanaanglan	japan'a'angl'a'n
japanaĉina	japan'a'ĉin'a
japanaesperanta	japan'a'esperant'a
japanakorea	japan'a'kore'a
japanalingvaj	japan'a'lingv'a'j
japanaokcidenta	japan'a'okcident'a
japanatajpiloj	japan'a'tajp'il'o'j
japanausona	japan'a'uson'a
japananoj	japan'an'o'j
japanananglan	japan'an'angl'a'n
japanĉina	japan'ĉin'a
japandevena	japan'de'ven'a
japandevenaj	japan'de'ven'a'j
japandevenan	japan'de'ven'a'n
japaneca	japan'ec'a
japanecan	japan'ec'a'n
japania	japan'i'a
japaniaj	japan'i'a'j
japaniajn	japan'i'a'j'n
japanio	japan'i'o
japanion	japan'i'o'n
japanida	japan'id'a
japanigis	japan'ig'is
japanino	japan'in'o
japaninoj	japan'in'o'j
japaninon	japan'in'o'n
japanismo	japan'ism'o
japankulturon	japan'kultur'o'n
japanlandon	japan'land'o'n
japanlingva	japan'lingv'a
japanlingvaj	japan'lingv'a'j
japanlingvajn	japan'lingv'a'j'n
japanlingvan	japan'lingv'a'n
japanlingve	japan'lingv'e
japanlingvanoj	japan'lingv'an'o'j
japanmara	japan'mar'a
japanparolanta	japan'parol'ant'a
japansponsorita	japan'sponsor'it'a
japanstila	japan'stil'a
japanstilaj	japan'stil'a'j
japanstilan	japan'stil'a'n
japanuja	japan'uj'a
japanujaj	japan'uj'a'j
japanujan	japan'uj'a'n
japanujo	japan'uj'o
japanujon	japan'uj'o'n
jara	jar'a
jaraj	jar'a'j
jarajn	jar'a'j'n
jaran	jar'a'n
jarcent	jar'cent
jare	jar'e
jaro	jar'o
jaroj	jar'o'j
jarojn	jar'o'j'n
jaron	jar'o'n
jarabonkartoj	jar'abon'kart'o'j
jaraĝa	jar'aĝ'a
jaraĝaj	jar'aĝ'a'j
jaraĝan	jar'aĝ'a'n
jaragho	jar'aĝ'o
jaraĝo	jar'aĝ'o
jaraĝon	jar'aĝ'o'n
jarasembleo	jar'asemble'o
jarbesto	jar'best'o
jarcenta	jar'cent'a
jarcentaj	jar'cent'a'j
jarcentajn	jar'cent'a'j'n
jarcentan	jar'cent'a'n
jarcente	jar'cent'e
jarcento	jar'cent'o
jarcentoj	jar'cent'o'j
jarcentojn	jar'cent'o'j'n
jarcenton	jar'cent'o'n
jarcentaĝa	jar'cent'aĝ'a
jarcentaĝaj	jar'cent'aĝ'a'j
jarcentaĝan	jar'cent'aĝ'a'n
jarcentaĵa	jar'cent'aĵ'a
jarcentaĵaj	jar'cent'aĵ'a'j
jarcentaĵan	jar'cent'aĵ'a'n
jarcentdaŭran	jar'cent'daŭr'a'n
jarcentduono	jar'cent'du'on'o
jarcentfina	jar'cent'fin'a
jarcentfino	jar'cent'fin'o
jarcenthalo	jar'cent'hal'o
jarcentkvarono	jar'cent'kvar'on'o
jarcentmiloj	jar'cent'mil'o'j
jarcentŝanĝo	jar'cent'ŝanĝ'o
jarcentŝanĝiĝo	jar'cent'ŝanĝ'iĝ'o
jarciklo	jar'cikl'o
jarciklon	jar'cikl'o'n
jarĉefkunveno	jar'ĉef'kun'ven'o
jardeka	jar'dek'a
jardekaj	jar'dek'a'j
jardeke	jar'dek'e
jardeko	jar'dek'o
jardekoj	jar'dek'o'j
jardekojn	jar'dek'o'j'n
jardekon	jar'dek'o'n
jardekaĝa	jar'dek'aĝ'a
jardeklonga	jar'dek'long'a
jardeklongan	jar'dek'long'a'n
jardekmiloj	jar'dek'mil'o'j
jardekmilojn	jar'dek'mil'o'j'n
jarduo	jar'du'o
jardudeko	jar'du'dek'o
jarduono	jar'du'on'o
jarduonon	jar'du'on'o'n
jaregoj	jar'eg'o'j
jarepoko	jar'epok'o
jarepokoj	jar'epok'o'j
jarfina	jar'fin'a
jarfinaj	jar'fin'a'j
jarfinajn	jar'fin'a'j'n
jarfinan	jar'fin'a'n
jarfine	jar'fin'e
jarfino	jar'fin'o
jarfinon	jar'fin'o'n
jargajno	jar'gajn'o
jarheroo	jar'hero'o
jariĝo	jar'iĝ'o
jarkalkulo	jar'kalkul'o
jarklaso	jar'klas'o
jarkolekto	jar'kolekt'o
jarkolektoj	jar'kolekt'o'j
jarkolektojn	jar'kolekt'o'j'n
jarkolekton	jar'kolekt'o'n
jarkomence	jar'komenc'e
jarkomenco	jar'komenc'o
jarkonferenco	jar'konferenc'o
jarkongreso	jar'kongres'o
jarkongresoj	jar'kongres'o'j
jarkotizo	jar'kotiz'o
jarkotizojn	jar'kotiz'o'j'n
jarkotizon	jar'kotiz'o'n
jarkresko	jar'kresk'o
jarkunsido	jar'kun'sid'o
jarkunsidon	jar'kun'sid'o'n
jarkunveno	jar'kun'ven'o
jarkunvenoj	jar'kun'ven'o'j
jarkunvenojn	jar'kun'ven'o'j'n
jarkunvenon	jar'kun'ven'o'n
jarkursoj	jar'kurs'o'j
jarkvarona	jar'kvar'on'a
jarkvarono	jar'kvar'on'o
jarkvino	jar'kvin'o
jarkvinoj	jar'kvin'o'j
jarlibra	jar'libr'a
jarlibraj	jar'libr'a'j
jarlibro	jar'libr'o
jarlibroj	jar'libr'o'j
jarlibrojn	jar'libr'o'j'n
jarlibron	jar'libr'o'n
jarlibristo	jar'libr'ist'o
jarlonga	jar'long'a
jarmila	jar'mil'a
jarmilaj	jar'mil'a'j
jarmilajn	jar'mil'a'j'n
jarmilan	jar'mil'a'n
jarmile	jar'mil'e
jarmilo	jar'mil'o
jarmiloj	jar'mil'o'j
jarmilojn	jar'mil'o'j'n
jarmilon	jar'mil'o'n
jarmilaĝa	jar'mil'aĝ'a
jarmilaĝaj	jar'mil'aĝ'a'j
jarmilmilo	jar'mil'mil'o
jarmilostadiono	jar'mil'o'stadion'o
jarmiloteknologiopremio	jar'mil'o'teknologi'o'premi'o
jarmilŝanĝo	jar'mil'ŝanĝ'o
jarmiliono	jar'milion'o
jarmilionoj	jar'milion'o'j
jarmilionojn	jar'milion'o'j'n
jarnomoj	jar'nom'o'j
jarnombro	jar'nombr'o
jaromaljuna	jar'o'mal'jun'a
jaropolko	jar'o'polk'o
jarorondo	jar'o'rond'o
jaroslavo	jar'o'slav'o
jarokazaĵo	jar'okaz'aĵ'o
jarokazaĵoj	jar'okaz'aĵ'o'j
jarokazaĵojn	jar'okaz'aĵ'o'j'n
jarokazaĵon	jar'okaz'aĵ'o'n
jarparo	jar'par'o
jarparoj	jar'par'o'j
jarpentraĵo	jar'pentr'aĵ'o
jarpentraĵoj	jar'pentr'aĵ'o'j
jarperiodo	jar'period'o
jarplena	jar'plen'a
jarpluvo	jar'pluv'o
jarpluvon	jar'pluv'o'n
jarpostjara	jar'post'jar'a
jarpostjaraj	jar'post'jar'a'j
jarpostjaran	jar'post'jar'a'n
jarpremio	jar'premi'o
jarpremioj	jar'premi'o'j
jarraporto	jar'raport'o
jarraportoj	jar'raport'o'j
jarraportojn	jar'raport'o'j'n
jarraporton	jar'raport'o'n
jarringoj	jar'ring'o'j
jarringojn	jar'ring'o'j'n
jarronda	jar'rond'a
jarrondaj	jar'rond'a'j
jarrondajn	jar'rond'a'j'n
jarrondan	jar'rond'a'n
jarseso	jar'ses'o
jarsezono	jar'sezon'o
jarsezonoj	jar'sezon'o'j
jarsezonojn	jar'sezon'o'j'n
jarsimbolaj	jar'simbol'a'j
jarsimboligaj	jar'simbol'ig'a'j
jarsperto	jar'spert'o
jarstudantoj	jar'stud'ant'o'j
jarstudentoj	jar'student'o'j
jarŝanĝa	jar'ŝanĝ'a
jarŝanĝaj	jar'ŝanĝ'a'j
jarŝanĝe	jar'ŝanĝ'e
jarŝanĝo	jar'ŝanĝ'o
jarŝanĝon	jar'ŝanĝ'o'n
jartempo	jar'temp'o
jartrio	jar'tri'o
jarvaloro	jar'valor'o
jarvico	jar'vic'o
jarvicon	jar'vic'o'n
jaranga	jarang'a
jarango	jarang'o
jarangon	jarang'o'n
jardo	jard'o
jardoj	jard'o'j
jardojn	jard'o'j'n
jardon	jard'o'n
jasenevo	jasenev'o
jasiro	jasir'o
jasmena	jasmen'a
jasmenaj	jasmen'a'j
jasmenan	jasmen'a'n
jasmeno	jasmen'o
jasmenoj	jasmen'o'j
jasmenon	jasmen'o'n
jaspa	jasp'a
jaspo	jasp'o
jaspoj	jasp'o'j
jaspotinamo	jasp'o'tinam'o
javana	javan'a
javanan	javan'a'n
javano	javan'o
javeo	jave'o
javeon	jave'o'n
jazona	jazon'a
jazono	jazon'o
jazonon	jazon'o'n
je	je
jehuda	jehud'a
jehudo	jehud'o
jekaterinburga	jekaterinburg'a
jekaterinburgaj	jekaterinburg'a'j
jekaterinburgo	jekaterinburg'o
jelpa	jelp'a
jelpas	jelp'as
jelpe	jelp'e
jelpi	jelp'i
jelpis	jelp'is
jelpo	jelp'o
jelpoj	jelp'o'j
jelpado	jelp'ad'o
jelpadon	jelp'ad'o'n
jelpante	jelp'ant'e
jelpanto	jelp'ant'o
jelpeti	jelp'et'i
jelpetis	jelp'et'is
jelpetante	jelp'et'ant'e
jemena	jemen'a
jemenaj	jemen'a'j
jemenan	jemen'a'n
jemeno	jemen'o
jemenon	jemen'o'n
jemenano	jemen'an'o
jemenanoj	jemen'an'o'j
jemenido	jemen'id'o
jen	jen
jena	jen'a
jenaj	jen'a'j
jenajn	jen'a'j'n
jenan	jen'a'n
jene	jen'e
jeno	jen'o
jenoj	jen'o'j
jenon	jen'o'n
jenamaniere	jen'a'manier'e
jenmaniere	jen'manier'e
jenisejo	jenisej'o
jerusalema	jerusalem'a
jerusalemaj	jerusalem'a'j
jerusalemajn	jerusalem'a'j'n
jerusaleman	jerusalem'a'n
jerusalemo	jerusalem'o
jerusalemon	jerusalem'o'n
jes	jes
jesa	jes'a
jesaj	jes'a'j
jesajn	jes'a'j'n
jesan	jes'a'n
jesas	jes'as
jese	jes'e
jesi	jes'i
jesis	jes'is
jesjes	jes'jes
jeso	jes'o
jesoj	jes'o'j
jeson	jes'o'n
jesos	jes'os
jesu	jes'u
jesus	jes'us
jesado	jes'ad'o
jesanta	jes'ant'a
jesantan	jes'ant'a'n
jesante	jes'ant'e
jesanto	jes'ant'o
jesejo	jes'ej'o
jesflanko	jes'flank'o
jesiga	jes'ig'a
jesigas	jes'ig'as
jesigi	jes'ig'i
jesita	jes'it'a
jesitaj	jes'it'a'j
jesulo	jes'ul'o
jesuloj	jes'ul'o'j
jesaja	jesaj'a
jesajo	jesaj'o
jesua	jesu'a
jesuan	jesu'a'n
jesuo	jesu'o
jesuoj	jesu'o'j
jesuon	jesu'o'n
jesueto	jesu'et'o
jesueton	jesu'et'o'n
jesuinfano	jesu'infan'o
jesuinfanon	jesu'infan'o'n
jesuinfaneto	jesu'infan'et'o
jesukristo	jesu'krist'o
jesuofilo	jesu'o'fil'o
jesuoinfano	jesu'o'infan'o
jesuokristo	jesu'o'krist'o
jesuomovado	jesu'o'mov'ad'o
jeŝua	jeŝu'a
jetis	jet'is
jeto	jet'o
jetoj	jet'o'j
jeton	jet'o'n
jetmotoro	jet'motor'o
jetmotoroj	jet'motor'o'j
jezuita	jezuit'a
jezuitaj	jezuit'a'j
jezuito	jezuit'o
jezuitoj	jezuit'o'j
jida	jid'a
jidan	jid'a'n
jide	jid'e
jido	jid'o
joakimo	joakim'o
joda	jod'a
jodo	jod'o
jodon	jod'o'n
jodato	jod'at'o
jodoacetata	jod'o'acet'at'a
jodoacetato	jod'o'acet'at'o
jodida	jodid'a
jodido	jodid'o
joga	jog'a
jogo	jog'o
jogon	jog'o'n
jogurto	jogurt'o
jogurton	jogurt'o'n
johana	johan'a
johano	johan'o
johanon	johan'o'n
johanino	johan'in'o
jona	jon'a
jonaj	jon'a'j
jonajn	jon'a'j'n
jonan	jon'a'n
jono	jon'o
jonoj	jon'o'j
jonojn	jon'o'j'n
jonon	jon'o'n
joniga	jon'ig'a
jonigaj	jon'ig'a'j
jonigan	jon'ig'a'n
jonigas	jon'ig'as
jonigi	jon'ig'i
jonigo	jon'ig'o
jonigon	jon'ig'o'n
jonigita	jon'ig'it'a
jonigitaj	jon'ig'it'a'j
jonosfero	jon'o'sfer'o
jonatano	jonatan'o
jonatanon	jonatan'o'n
jordana	jordan'a
jordano	jordan'o
jordania	jordan'i'a
jordaniaj	jordan'i'a'j
jordanio	jordan'i'o
jordanion	jordan'i'o'n
jordanlando	jordan'land'o
jozefo	jozef'o
jozefon	jozef'o'n
jozefino	jozef'in'o
ju	ju
juana	juan'a
juano	juan'o
juanoj	juan'o'j
juanojn	juan'o'j'n
juandinastio	juan'dinasti'o
jubila	jubil'a
jubilas	jubil'as
jubile	jubil'e
jubili	jubil'i
jubilis	jubil'is
jubilo	jubil'o
jubilado	jubil'ad'o
jubilante	jubil'ant'e
jubilea	jubile'a
jubileaj	jubile'a'j
jubilean	jubile'a'n
jubileo	jubile'o
jubileoj	jubile'o'j
jubileon	jubile'o'n
juda	jud'a
judaj	jud'a'j
judajn	jud'a'j'n
judan	jud'a'n
judo	jud'o
judoj	jud'o'j
judojn	jud'o'j'n
judon	jud'o'n
judakristana	jud'a'krist'an'a
judaro	jud'ar'o
juddevena	jud'de'ven'a
judekristana	jud'e'krist'an'a
judeco	jud'ec'o
judecon	jud'ec'o'n
judgermana	jud'german'a
judino	jud'in'o
judismo	jud'ism'o
judismon	jud'ism'o'n
judkristana	jud'krist'an'a
judujo	jud'uj'o
judaismo	judaism'o
judaso	judas'o
judea	jude'a
judeo	jude'o
jugo	jug'o
jugon	jug'o'n
juglando	jugland'o
juglandoj	jugland'o'j
juglandojn	jugland'o'j'n
juglandon	jugland'o'n
juglandarboj	jugland'arb'o'j
jugoslava	jugoslav'a
jugoslavaj	jugoslav'a'j
jugoslavoj	jugoslav'o'j
jugoslavia	jugoslav'i'a
jugoslavio	jugoslav'i'o
jugoslavion	jugoslav'i'o'n
jugoslavujo	jugoslav'uj'o
juĝa	juĝ'a
juĝaj	juĝ'a'j
juĝajn	juĝ'a'j'n
juĝan	juĝ'a'n
juĝas	juĝ'as
juĝe	juĝ'e
juĝi	juĝ'i
juĝis	juĝ'is
jugho	juĝ'o
juĝo	juĝ'o
juĝoj	juĝ'o'j
juĝojn	juĝ'o'j'n
juĝon	juĝ'o'n
juĝos	juĝ'os
juĝu	juĝ'u
juĝado	juĝ'ad'o
juĝadon	juĝ'ad'o'n
juĝafero	juĝ'afer'o
juĝante	juĝ'ant'e
juĝanto	juĝ'ant'o
juĝantoj	juĝ'ant'o'j
juĝantaro	juĝ'ant'ar'o
juĝata	juĝ'at'a
juĝataj	juĝ'at'a'j
juĝato	juĝ'at'o
juĝatoj	juĝ'at'o'j
juĝejo	juĝ'ej'o
juĝejoj	juĝ'ej'o'j
juĝejon	juĝ'ej'o'n
juĝista	juĝ'ist'a
jughisto	juĝ'ist'o
juĝisto	juĝ'ist'o
juĝistoj	juĝ'ist'o'j
juĝistojn	juĝ'ist'o'j'n
juĝiston	juĝ'ist'o'n
juĝistaro	juĝ'ist'ar'o
juĝistaron	juĝ'ist'ar'o'n
juĝita	juĝ'it'a
juĝitaj	juĝ'it'a'j
juĝkapablon	juĝ'kapabl'o'n
juĝkomisiono	juĝ'komision'o
juĝokapablo	juĝ'o'kapabl'o
juĝopovo	juĝ'o'pov'o
jujubo	jujub'o
jujuboj	jujub'o'j
jujubarboj	jujub'arb'o'j
juka	juk'a
jukas	juk'as
juko	juk'o
jukon	juk'o'n
jukos	juk'os
jukado	juk'ad'o
jukonio	jukon'i'o
jula	jul'a
julo	jul'o
julia	juli'a
juliaj	juli'a'j
julian	juli'a'n
julie	juli'e
julien	juli'e'n
julio	juli'o
julion	juli'o'n
juliino	juli'in'o
juliana	julian'a
juliano	julian'o
julieta	juliet'a
juna	jun'a
junaj	jun'a'j
junajn	jun'a'j'n
junan	jun'a'n
junas	jun'as
june	jun'e
junis	jun'is
juno	jun'o
junaĝa	jun'aĝ'a
junaĝaj	jun'aĝ'a'j
junaĝe	jun'aĝ'e
junagho	jun'aĝ'o
junaĝo	jun'aĝ'o
junaĝon	jun'aĝ'o'n
junano	jun'an'o
juneca	jun'ec'a
junecaj	jun'ec'a'j
junecan	jun'ec'a'n
junece	jun'ec'e
juneco	jun'ec'o
junecon	jun'ec'o'n
junega	jun'eg'a
junegaj	jun'eg'a'j
junpionira	jun'pionir'a
junplantoj	jun'plant'o'j
junula	jun'ul'a
junulaj	jun'ul'a'j
junulajn	jun'ul'a'j'n
junulan	jun'ul'a'n
junulo	jun'ul'o
junuloj	jun'ul'o'j
junulojn	jun'ul'o'j'n
junulon	jun'ul'o'n
junulara	jun'ul'ar'a
junularaj	jun'ul'ar'a'j
junularajn	jun'ul'ar'a'j'n
junularan	jun'ul'ar'a'n
junularo	jun'ul'ar'o
junularoj	jun'ul'ar'o'j
junularojn	jun'ul'ar'o'j'n
junularon	jun'ul'ar'o'n
junulargastejo	jun'ul'ar'gast'ej'o
junulargastejoj	jun'ul'ar'gast'ej'o'j
junuleto	jun'ul'et'o
junulina	jun'ul'in'a
junulino	jun'ul'in'o
junulinoj	jun'ul'in'o'j
junulinojn	jun'ul'in'o'j'n
junulinon	jun'ul'in'o'n
jungas	jung'as
jungi	jung'i
jungis	jung'is
jungu	jung'u
jungilaro	jung'il'ar'o
jungita	jung'it'a
jungitaj	jung'it'a'j
junia	juni'a
junie	juni'e
junio	juni'o
junion	juni'o'n
junipero	juniper'o
juniperoj	juniper'o'j
junko	junk'o
junkoj	junk'o'j
junono	junon'o
junta	junt'a
junto	junt'o
juntoj	junt'o'j
juntojn	junt'o'j'n
junton	junt'o'n
jupo	jup'o
jupoj	jup'o'j
jupojn	jup'o'j'n
jupon	jup'o'n
jupeto	jup'et'o
jupitera	jupiter'a
jupitero	jupiter'o
jupiteron	jupiter'o'n
jura	jur'a
juraj	jur'a'j
jurajn	jur'a'j'n
juran	jur'a'n
jure	jur'e
juri	jur'i
juris	jur'is
juro	jur'o
juroj	jur'o'j
jurojn	jur'o'j'n
juron	jur'o'n
jurista	jur'ist'a
juristo	jur'ist'o
juristoj	jur'ist'o'j
juristojn	jur'ist'o'j'n
juriston	jur'ist'o'n
jurmedicino	jur'medicin'o
jurpersekuti	jur'persekut'i
jurpersekutis	jur'persekut'is
jurpersekutita	jur'persekut'it'a
jurpersekutitaj	jur'persekut'it'a'j
jurscienca	jur'scienc'a
jursistemo	jur'sistem'o
jurstudo	jur'stud'o
jurstudoj	jur'stud'o'j
jurŝateco	jur'ŝat'ec'o
jurŝtato	jur'ŝtat'o
jurisdikcia	jurisdikci'a
jurisdikcio	jurisdikci'o
jurisdikcioj	jurisdikci'o'j
jurisdikcion	jurisdikci'o'n
jurisprudenco	jurisprudenc'o
jurto	jurt'o
jurtoj	jurt'o'j
jurtojn	jurt'o'j'n
jurton	jurt'o'n
justa	just'a
justaj	just'a'j
justajn	just'a'j'n
justan	just'a'n
justas	just'as
juste	just'e
justo	just'o
juston	just'o'n
justus	just'us
justakomercaj	just'a'komerc'a'j
justeca	just'ec'a
justeco	just'ec'o
justecon	just'ec'o'n
justema	just'em'a
justeme	just'em'e
justigi	just'ig'i
justulo	just'ul'o
justuloj	just'ul'o'j
justica	justic'a
justicaj	justic'a'j
justican	justic'a'n
justice	justic'e
justico	justic'o
justicon	justic'o'n
justicministerio	justic'ministeri'o
justicministro	justic'ministr'o
justiniano	justinian'o
jute	jut'e
juto	jut'o
jutoj	jut'o'j
jutlando	jut'land'o
jutubo	jutub'o
juvela	juvel'a
juvelo	juvel'o
juveloj	juvel'o'j
juvelojn	juvel'o'j'n
juvelon	juvel'o'n
juvelaĵo	juvel'aĵ'o
juvelaĵoj	juvel'aĵ'o'j
juvelaĵojn	juvel'aĵ'o'j'n
juvelaĵon	juvel'aĵ'o'n
juvelarto	juvel'art'o
juvelejo	juvel'ej'o
juvelisto	juvel'ist'o
juvelistoj	juvel'ist'o'j
juvelŝtonoj	juvel'ŝton'o'j