kaba	kab'a
kabaj	kab'a'j
kabe	kab'e
kabo	kab'o
kaboj	kab'o'j
kabon	kab'o'n
kablando	kab'land'o
kaboverdo	kab'o'verd'o
kabula	kab'ul'a
kabulo	kab'ul'o
kaburbo	kab'urb'o
kabalo	kabal'o
kabaloj	kabal'o'j
kabalojn	kabal'o'j'n
kabana	kaban'a
kabano	kaban'o
kabanoj	kaban'o'j
kabanojn	kaban'o'j'n
kabanon	kaban'o'n
kabaneto	kaban'et'o
kabareda	kabared'a
kabaredo	kabared'o
kabaredoj	kabared'o'j
kabareto	kabaret'o
kabeas	kabe'as
kabei	kabe'i
kabeis	kabe'is
kabeado	kabe'ad'o
kabiloj	kabil'o'j
kabilio	kabil'i'o
kabino	kabin'o
kabinaŭto	kabin'aŭt'o
kabinaŭtoj	kabin'aŭt'o'j
kabinda	kabind'a
kabindo	kabind'o
kabineta	kabinet'a
kabinetaj	kabinet'a'j
kabineto	kabinet'o
kabinetoj	kabinet'o'j
kabineton	kabinet'o'n
kabinetano	kabinet'an'o
kabinetanoj	kabinet'an'o'j
kabla	kabl'a
kablan	kabl'a'n
kablo	kabl'o
kabloj	kabl'o'j
kablojn	kabl'o'j'n
kablon	kabl'o'n
kabligaj	kabl'ig'a'j
kabligita	kabl'ig'it'a
kabloretoj	kabl'o'ret'o'j
kablotramo	kabl'o'tram'o
kabrioleto	kabriolet'o
kaco	kac'o
kacon	kac'o'n
kacho	kaĉ'o
kaĉo	kaĉ'o
kaĉon	kaĉ'o'n
kadavro	kadavr'o
kadavroj	kadavr'o'j
kadavrojn	kadavr'o'j'n
kadavron	kadavr'o'n
kadavraĵoj	kadavr'aĵ'o'j
kadavraĵojn	kadavr'aĵ'o'j'n
kadavrejo	kadavr'ej'o
kadavromanĝantoj	kadavr'o'manĝ'ant'o'j
kadenco	kadenc'o
kadencoj	kadenc'o'j
kadeto	kadet'o
kadetoj	kadet'o'j
kadio	kadi'o
kadmio	kadmi'o
kadra	kadr'a
kadraj	kadr'a'j
kadran	kadr'a'n
kadras	kadr'as
kadre	kadr'e
kadro	kadr'o
kadroj	kadr'o'j
kadrojn	kadr'o'j'n
kadron	kadr'o'n
kadrigita	kadr'ig'it'a
kadrita	kadr'it'a
kaduka	kaduk'a
kadukaj	kaduk'a'j
kadukajn	kaduk'a'j'n
kadukan	kaduk'a'n
kadukeco	kaduk'ec'o
kadukiĝa	kaduk'iĝ'a
kadukiĝas	kaduk'iĝ'as
kadukiĝi	kaduk'iĝ'i
kadukiĝis	kaduk'iĝ'is
kadukiĝo	kaduk'iĝ'o
kadukiĝon	kaduk'iĝ'o'n
kadukulo	kaduk'ul'o
kafa	kaf'a
kafo	kaf'o
kafoj	kaf'o'j
kafojn	kaf'o'j'n
kafon	kaf'o'n
kafbutikoj	kaf'butik'o'j
kafeja	kaf'ej'a
kafejo	kaf'ej'o
kafejoj	kaf'ej'o'j
kafejojn	kaf'ej'o'j'n
kafejon	kaf'ej'o'n
kafpaŭzo	kaf'paŭz'o
kafujo	kaf'uj'o
kafumi	kaf'um'i
kafumado	kaf'um'ad'o
kafeino	kafein'o
kafeinon	kafein'o'n
kafeterio	kafeteri'o
kaftano	kaftan'o
kaĝo	kaĝ'o
kaĝoj	kaĝ'o'j
kaĝojn	kaĝ'o'j'n
kaĝon	kaĝ'o'n
kahelo	kahel'o
kaheloj	kahel'o'j
kahelojn	kahel'o'j'n
kahelon	kahel'o'n
kahelaro	kahel'ar'o
kahelaroj	kahel'ar'o'j
kaj	kaj
kaja	kaj'a
kajaŭ	kaj'aŭ
kajo	kaj'o
kajoj	kaj'o'j
kajon	kaj'o'n
kajako	kajak'o
kajakoj	kajak'o'j
kajero	kajer'o
kajeroj	kajer'o'j
kajerojn	kajer'o'j'n
kajeron	kajer'o'n
kajereto	kajer'et'o
kajmana	kajman'a
kajta	kajt'a
kajtan	kajt'a'n
kajto	kajt'o
kajtoj	kajt'o'j
kajtojn	kajt'o'j'n
kajton	kajt'o'n
kajuto	kajut'o
kajutoj	kajut'o'j
kajuton	kajut'o'n
kaĵolas	kaĵol'as
kakao	kaka'o
kakaoj	kaka'o'j
kakatuo	kakatu'o
kakatuoj	kakatu'o'j
kakofonio	kakofoni'o
kakto	kakt'o
kaktoj	kakt'o'j
kaktojn	kakt'o'j'n
kala	kal'a
kalo	kal'o
kaloj	kal'o'j
kalabaso	kalabas'o
kalamo	kalam'o
kalcedono	kalcedon'o
kalcedonio	kalcedon'i'o
kalcia	kalci'a
kalciaj	kalci'a'j
kalcian	kalci'a'n
kalcio	kalci'o
kalcion	kalci'o'n
kalcikarbonato	kalci'karbon'at'o
kalciojonoj	kalci'ojon'o'j
kalcinado	kalcin'ad'o
kalcito	kalcit'o
kaldrono	kaldron'o
kaldronoj	kaldron'o'j
kaldronojn	kaldron'o'j'n
kaldronon	kaldron'o'n
kaldronego	kaldron'eg'o
kalejdoskopoj	kalejdoskop'o'j
kalendara	kalendar'a
kalendaran	kalendar'a'n
kalendaro	kalendar'o
kalendaroj	kalendar'o'j
kalendarojn	kalendar'o'j'n
kalendaron	kalendar'o'n
kaleŝo	kaleŝ'o
kaleŝoj	kaleŝ'o'j
kaleŝon	kaleŝ'o'n
kaleŝoĉevalo	kaleŝ'o'ĉeval'o
kalevala	kalevala
kalia	kali'a
kaliaj	kali'a'j
kalian	kali'a'n
kalio	kali'o
kalion	kali'o'n
kaliokanaloj	kali'o'kanal'o'j
kalibro	kalibr'o
kalibroj	kalibr'o'j
kalibrita	kalibr'it'a
kalibritaj	kalibr'it'a'j
kalidono	kalidon'o
kalifo	kalif'o
kalifoj	kalif'o'j
kalifon	kalif'o'n
kaliflando	kalif'land'o
kalifujo	kalif'uj'o
kalifujon	kalif'uj'o'n
kalifornia	kaliforni'a
kaliforniaj	kaliforni'a'j
kalifornian	kaliforni'a'n
kalifornio	kaliforni'o
kalifornion	kaliforni'o'n
kaligrafa	kaligraf'a
kaligrafado	kaligraf'ad'o
kaligrafaĵoj	kaligraf'aĵ'o'j
kaligrafaĵojn	kaligraf'aĵ'o'j'n
kaligrafio	kaligraf'i'o
kaligrafion	kaligraf'i'o'n
kaligulo	kaligul'o
kaliko	kalik'o
kalikoj	kalik'o'j
kalikojn	kalik'o'j'n
kalikon	kalik'o'n
kalikoto	kalikot'o
kalimantano	kalimantan'o
kaliningrada	kaliningrad'a
kaliningradaj	kaliningrad'a'j
kaliningrado	kaliningrad'o
kaliningradanoj	kaliningrad'an'o'j
kalka	kalk'a
kalkaj	kalk'a'j
kalkis	kalk'is
kalko	kalk'o
kalkon	kalk'o'n
kalkalpoj	kalk'alp'o'j
kalkeca	kalk'ec'a
kalkecaj	kalk'ec'a'j
kalkiĝo	kalk'iĝ'o
kalkoŝtona	kalk'o'ŝton'a
kalkoŝtonaj	kalk'o'ŝton'a'j
kalkoŝtono	kalk'o'ŝton'o
kalkoŝtonoj	kalk'o'ŝton'o'j
kalkŝtona	kalk'ŝton'a
kalkŝtono	kalk'ŝton'o
kalkŝtonoj	kalk'ŝton'o'j
kalkŝtonon	kalk'ŝton'o'n
kalkano	kalkan'o
kalkanoj	kalkan'o'j
kalkanojn	kalkan'o'j'n
kalkanon	kalkan'o'n
kalkanumo	kalkan'um'o
kalkanumoj	kalkan'um'o'j
kalkanumojn	kalkan'um'o'j'n
kalkula	kalkul'a
kalkulaj	kalkul'a'j
kalkulas	kalkul'as
kalkuli	kalkul'i
kalkulis	kalkul'is
kalkulo	kalkul'o
kalkuloj	kalkul'o'j
kalkulojn	kalkul'o'j'n
kalkulon	kalkul'o'n
kalkulos	kalkul'os
kalkulu	kalkul'u
kalkulus	kalkul'us
kalkulado	kalkul'ad'o
kalkuladoj	kalkul'ad'o'j
kalkuladon	kalkul'ad'o'n
kalkulanta	kalkul'ant'a
kalkulante	kalkul'ant'e
kalkulata	kalkul'at'a
kalkulataj	kalkul'at'a'j
kalkulebla	kalkul'ebl'a
kalkuleblaj	kalkul'ebl'a'j
kalkuleble	kalkul'ebl'e
kalkuliĝas	kalkul'iĝ'as
kalkulilo	kalkul'il'o
kalkuliloj	kalkul'il'o'j
kalkulilojn	kalkul'il'o'j'n
kalkulilon	kalkul'il'o'n
kalkulita	kalkul'it'a
kalkulitaj	kalkul'it'a'j
kalkulitan	kalkul'it'a'n
kalkulite	kalkul'it'e
kalkuloscio	kalkul'o'sci'o
kalkulsubstantivoj	kalkul'substantiv'o'j
kalkultabelo	kalkul'tabel'o
kalkultabeloj	kalkul'tabel'o'j
kalkultabelojn	kalkul'tabel'o'j'n
kalmaro	kalmar'o
kalmaroj	kalmar'o'j
kalmarojn	kalmar'o'j'n
kaloria	kalori'a
kalorio	kalori'o
kalorioj	kalori'o'j
kaloriojn	kalori'o'j'n
kalorimetro	kalori'metr'o
kalorimetrio	kalori'metr'i'o
kaloto	kalot'o
kalsono	kalson'o
kalsonoj	kalson'o'j
kalsonojn	kalson'o'j'n
kalsonon	kalson'o'n
kalsoneto	kalson'et'o
kalsoneton	kalson'et'o'n
kalumnia	kalumni'a
kalumniaj	kalumni'a'j
kalumnias	kalumni'as
kalumnii	kalumni'i
kalumniis	kalumni'is
kalumnio	kalumni'o
kalumnioj	kalumni'o'j
kalumniojn	kalumni'o'j'n
kalumnion	kalumni'o'n
kalumniado	kalumni'ad'o
kalumniante	kalumni'ant'e
kalumniita	kalumni'it'a
kalva	kalv'a
kalvaj	kalv'a'j
kalvan	kalv'a'n
kalveco	kalv'ec'o
kalviĝas	kalv'iĝ'as
kalvulo	kalv'ul'o
kalvaria	kalvari'a
kalvario	kalvari'o
kalvino	kalvin'o
kalvinana	kalvin'an'a
kalvinanoj	kalvin'an'o'j
kalvinisma	kalvin'ism'a
kalvinismo	kalvin'ism'o
kalvinista	kalvin'ist'a
kalvinistaj	kalvin'ist'a'j
kalvinisto	kalvin'ist'o
kalvinistoj	kalvin'ist'o'j
kamarada	kamarad'a
kamarado	kamarad'o
kamaradoj	kamarad'o'j
kamaradojn	kamarad'o'j'n
kamaradon	kamarad'o'n
kamaradeco	kamarad'ec'o
kamaradecon	kamarad'ec'o'n
kamaradino	kamarad'in'o
kamaradinoj	kamarad'in'o'j
kambio	kambi'o
kamboĝa	kamboĝ'a
kamboĝaj	kamboĝ'a'j
kamboĝo	kamboĝ'o
kamboĝon	kamboĝ'o'n
kamboĝanoj	kamboĝ'an'o'j
kambria	kambri'a
kambrio	kambri'o
kameo	kame'o
kameoj	kame'o'j
kamelaj	kamel'a'j
kamelo	kamel'o
kameloj	kamel'o'j
kamelojn	kamel'o'j'n
kamelon	kamel'o'n
kameleono	kameleon'o
kamelio	kameli'o
kamelioj	kameli'o'j
kamena	kamen'a
kameno	kamen'o
kamenoj	kamen'o'j
kamenon	kamen'o'n
kamenbreto	kamen'bret'o
kamentubo	kamen'tub'o
kamentuboj	kamen'tub'o'j
kamentubojn	kamen'tub'o'j'n
kamentubon	kamen'tub'o'n
kamera	kamer'a
kamero	kamer'o
kameroj	kamer'o'j
kamerojn	kamer'o'j'n
kameron	kamer'o'n
kamerai	kamera'i
kamerao	kamera'o
kameraoj	kamera'o'j
kameraojn	kamera'o'j'n
kameraon	kamera'o'n
kameraado	kamera'ad'o
kameraisto	kamera'ist'o
kameruna	kamerun'a
kameruno	kamerun'o
kamerunio	kameruni'o
kamforo	kamfor'o
kamilo	kamil'o
kamiono	kamion'o
kamionoj	kamion'o'j
kamionojn	kamion'o'j'n
kamionon	kamion'o'n
kamioneto	kamion'et'o
kamionetoj	kamion'et'o'j
kamioneton	kamion'et'o'n
kamionisto	kamion'ist'o
kamionistoj	kamion'ist'o'j
kamizolo	kamizol'o
kamizoloj	kamizol'o'j
kamizolon	kamizol'o'n
kamomilo	kamomil'o
kampa	kamp'a
kampaj	kamp'a'j
kampajn	kamp'a'j'n
kampan	kamp'a'n
kampe	kamp'e
kampo	kamp'o
kampoj	kamp'o'j
kampojn	kamp'o'j'n
kampon	kamp'o'n
kampadi	kamp'ad'i
kampadis	kamp'ad'is
kampado	kamp'ad'o
kampadejo	kamp'ad'ej'o
kampadejoj	kamp'ad'ej'o'j
kampadejon	kamp'ad'ej'o'n
kampara	kamp'ar'a
kamparaj	kamp'ar'a'j
kamparajn	kamp'ar'a'j'n
kamparan	kamp'ar'a'n
kampare	kamp'ar'e
kamparo	kamp'ar'o
kamparoj	kamp'ar'o'j
kamparon	kamp'ar'o'n
kamparana	kamp'ar'an'a
kamparanaj	kamp'ar'an'a'j
kamparanajn	kamp'ar'an'a'j'n
kamparanan	kamp'ar'an'a'n
kamparano	kamp'ar'an'o
kamparanoj	kamp'ar'an'o'j
kamparanojn	kamp'ar'an'o'j'n
kamparanon	kamp'ar'an'o'n
kamparanaro	kamp'ar'an'ar'o
kamparanino	kamp'ar'an'in'o
kamparaninoj	kamp'ar'an'in'o'j
kamparanolaboristoj	kamp'ar'an'o'labor'ist'o'j
kampardomo	kamp'ar'dom'o
kampefika	kamp'efik'a
kampefikaj	kamp'efik'a'j
kampeto	kamp'et'o
kampeton	kamp'et'o'n
kamplaboro	kamp'labor'o
kamploĝantoj	kamp'loĝ'ant'o'j
kampoekvacioj	kamp'o'ekvaci'o'j
kampoforto	kamp'o'fort'o
kampoforteco	kamp'o'fort'ec'o
kampokultivado	kamp'o'kultiv'ad'o
kampolaboro	kamp'o'labor'o
kampolinioj	kamp'o'lini'o'j
kampomusoj	kamp'o'mus'o'j
kampopasero	kamp'o'paser'o
kampula	kamp'ul'a
kampulo	kamp'ul'o
kampuloj	kamp'ul'o'j
kampulon	kamp'ul'o'n
kampurbo	kamp'urb'o
kampanilo	kampanil'o
kampanja	kampanj'a
kampanjaj	kampanj'a'j
kampanjas	kampanj'as
kampanji	kampanj'i
kampanjis	kampanj'is
kampanjo	kampanj'o
kampanjoj	kampanj'o'j
kampanjojn	kampanj'o'j'n
kampanjon	kampanj'o'n
kampanjado	kampanj'ad'o
kampanjadon	kampanj'ad'o'n
kampanjante	kampanj'ant'e
kampanjantoj	kampanj'ant'o'j
kampanulo	kampanul'o
kampusa	kampus'a
kampuso	kampus'o
kampusoj	kampus'o'j
kampusojn	kampus'o'j'n
kampuson	kampus'o'n
kamufla	kamufl'a
kamuflas	kamufl'as
kamufli	kamufl'i
kamuflo	kamufl'o
kamuflon	kamufl'o'n
kamuflado	kamufl'ad'o
kamuflaĵo	kamufl'aĵ'o
kamuflaĵon	kamufl'aĵ'o'n
kamuflita	kamufl'it'a
kana	kan'a
kanaj	kan'a'j
kane	kan'e
kano	kan'o
kanoj	kan'o'j
kanojn	kan'o'j'n
kanon	kan'o'n
kanara	kan'ar'a
kanaraj	kan'ar'a'j
kanbirdo	kan'bird'o
kanejoj	kan'ej'o'j
kansukero	kan'suker'o
kanao	kana'o
kanaoj	kana'o'j
kanaana	kanaan'a
kanaanan	kanaan'a'n
kanaano	kanaan'o
kanaananoj	kanaan'an'o'j
kanaanidoj	kanaan'id'o'j
kanaba	kanab'a
kanabo	kanab'o
kanabon	kanab'o'n
kanada	kanad'a
kanadaj	kanad'a'j
kanadajn	kanad'a'j'n
kanadan	kanad'a'n
kanado	kanad'o
kanadon	kanad'o'n
kanadano	kanad'an'o
kanadanoj	kanad'an'o'j
kanadanojn	kanad'an'o'j'n
kanadanino	kanad'an'in'o
kanajla	kanajl'a
kanajlaj	kanajl'a'j
kanajlo	kanajl'o
kanajloj	kanajl'o'j
kanajlojn	kanajl'o'j'n
kanajlon	kanajl'o'n
kanajlaro	kanajl'ar'o
kanala	kanal'a
kanalan	kanal'a'n
kanalo	kanal'o
kanaloj	kanal'o'j
kanalojn	kanal'o'j'n
kanalon	kanal'o'n
kanaleto	kanal'et'o
kanaletoj	kanal'et'o'j
kanaligo	kanal'ig'o
kanaligita	kanal'ig'it'a
kanalinsuloj	kanal'insul'o'j
kanapo	kanap'o
kanapoj	kanap'o'j
kanapon	kanap'o'n
kanaria	kanari'a
kanariaj	kanari'a'j
kanario	kanari'o
kanarioj	kanari'o'j
kanarion	kanari'o'n
kanbero	kanber'o
kancelaria	kancelari'a
kancelario	kancelari'o
kancelarioj	kancelari'o'j
kancelarion	kancelari'o'n
kanceliero	kancelier'o
kancelieroj	kancelier'o'j
kancelieron	kancelier'o'n
kancelierino	kancelier'in'o
kancera	kancer'a
kanceraj	kancer'a'j
kancerajn	kancer'a'j'n
kancero	kancer'o
kanceroj	kancer'o'j
kancerojn	kancer'o'j'n
kanceron	kancer'o'n
kancerĉeloj	kancer'ĉel'o'j
kanceresplorado	kancer'esplor'ad'o
kanceriga	kancer'ig'a
kancerigaj	kancer'ig'a'j
kancerkliniko	kancer'klinik'o
kancerogena	kancer'o'gen'a
kancerogenaj	kancer'o'gen'a'j
kancerogenaĵo	kancer'o'gen'aĵ'o
kancerogenaĵoj	kancer'o'gen'aĵ'o'j
kanceruloj	kancer'ul'o'j
kanda	kand'a
kando	kand'o
kandon	kand'o'n
kandela	kandel'a
kandelo	kandel'o
kandeloj	kandel'o'j
kandelojn	kandel'o'j'n
kandelon	kandel'o'n
kandelingo	kandel'ing'o
kandelingoj	kandel'ing'o'j
kandelingon	kandel'ing'o'n
kandelisto	kandel'ist'o
kandellumo	kandel'lum'o
kandelabro	kandelabr'o
kandelabroj	kandelabr'o'j
kandelabron	kandelabr'o'n
kandidata	kandidat'a
kandidataj	kandidat'a'j
kandidatas	kandidat'as
kandidati	kandidat'i
kandidatis	kandidat'is
kandidato	kandidat'o
kandidatoj	kandidat'o'j
kandidatojn	kandidat'o'j'n
kandidaton	kandidat'o'n
kandidatos	kandidat'os
kandidateco	kandidat'ec'o
kandidatecon	kandidat'ec'o'n
kandidatigi	kandidat'ig'i
kandidatigis	kandidat'ig'is
kandidatigo	kandidat'ig'o
kandidatigon	kandidat'ig'o'n
kandidatigita	kandidat'ig'it'a
kandidatiĝas	kandidat'iĝ'as
kandidatiĝi	kandidat'iĝ'i
kandidatiĝis	kandidat'iĝ'is
kandidatiĝo	kandidat'iĝ'o
kandidatiĝoj	kandidat'iĝ'o'j
kandidatiĝojn	kandidat'iĝ'o'j'n
kandidatiĝon	kandidat'iĝ'o'n
kandidatiĝos	kandidat'iĝ'os
kandidatino	kandidat'in'o
kandidatita	kandidat'it'a
kandidatitaj	kandidat'it'a'j
kandidatlisto	kandidat'list'o
kandidatlistoj	kandidat'list'o'j
kandombleo	kandomble'o
kanelo	kanel'o
kaneloj	kanel'o'j
kanelojn	kanel'o'j'n
kanelon	kanel'o'n
kanelita	kanel'it'a
kanelitaj	kanel'it'a'j
kanguruo	kanguru'o
kanguruoj	kanguru'o'j
kanguruojn	kanguru'o'j'n
kanguruon	kanguru'o'n
kanibalo	kanibal'o
kanibaloj	kanibal'o'j
kanibalismo	kanibal'ism'o
kaninoj	kanin'o'j
kanisedoj	kanis'ed'o'j
kanjono	kanjon'o
kanjonoj	kanjon'o'j
kanjonon	kanjon'o'n
kankro	kankr'o
kankroj	kankr'o'j
kankrojn	kankr'o'j'n
kanona	kanon'a
kanonaj	kanon'a'j
kanonan	kanon'a'n
kanono	kanon'o
kanonoj	kanon'o'j
kanonojn	kanon'o'j'n
kanonon	kanon'o'n
kanonado	kanon'ad'o
kanonigo	kanon'ig'o
kanonistoj	kanon'ist'o'j
kanonpafado	kanon'paf'ad'o
kanonika	kanonik'a
kanonikaj	kanonik'a'j
kanonikan	kanonik'a'n
kanoniko	kanonik'o
kanonikoj	kanonik'o'j
kanonizo	kanoniz'o
kanopeo	kanope'o
kanopeon	kanope'o'n
kanoto	kanot'o
kanotoj	kanot'o'j
kanta	kant'a
kantaj	kant'a'j
kantan	kant'a'n
kantas	kant'as
kante	kant'e
kanti	kant'i
kantis	kant'is
kanto	kant'o
kantoj	kant'o'j
kantojn	kant'o'j'n
kanton	kant'o'n
kantos	kant'os
kantu	kant'u
kantus	kant'us
kantadas	kant'ad'as
kantadis	kant'ad'is
kantado	kant'ad'o
kantadoj	kant'ad'o'j
kantadon	kant'ad'o'n
kantaĵojn	kant'aĵ'o'j'n
kantanta	kant'ant'a
kantantaj	kant'ant'a'j
kantantajn	kant'ant'a'j'n
kantantan	kant'ant'a'n
kantante	kant'ant'e
kantanto	kant'ant'o
kantantoj	kant'ant'o'j
kantaro	kant'ar'o
kantaroj	kant'ar'o'j
kantata	kant'at'a
kantataj	kant'at'a'j
kantatan	kant'at'a'n
kantate	kant'at'e
kantato	kant'at'o
kantatoj	kant'at'o'j
kantatojn	kant'at'o'j'n
kantaŭtoro	kant'aŭtor'o
kantdanca	kant'danc'a
kantebla	kant'ebl'a
kanteblaj	kant'ebl'a'j
kantejo	kant'ej'o
kantema	kant'em'a
kantetas	kant'et'as
kantetis	kant'et'is
kanteto	kant'et'o
kantetoj	kant'et'o'j
kantetojn	kant'et'o'j'n
kanteton	kant'et'o'n
kantgrupo	kant'grup'o
kantisto	kant'ist'o
kantistoj	kant'ist'o'j
kantistojn	kant'ist'o'j'n
kantiston	kant'ist'o'n
kantistino	kant'ist'in'o
kantistinoj	kant'ist'in'o'j
kantistinon	kant'ist'in'o'n
kantita	kant'it'a
kantitaj	kant'it'a'j
kantitajn	kant'it'a'j'n
kantkonkurso	kant'konkurs'o
kantmaniero	kant'manier'o
kantobirdoj	kant'o'bird'o'j
kantokonkurso	kant'o'konkurs'o
kantoteksto	kant'o'tekst'o
kantotekstoj	kant'o'tekst'o'j
kantotekstojn	kant'o'tekst'o'j'n
kantotekston	kant'o'tekst'o'n
kantverkisto	kant'verk'ist'o
kantverkistoj	kant'verk'ist'o'j
kantvoĉo	kant'voĉ'o
kantvoĉoj	kant'voĉ'o'j
kantata	kantat'a
kantataj	kantat'a'j
kantatan	kantat'a'n
kantate	kantat'e
kantato	kantat'o
kantatoj	kantat'o'j
kantatojn	kantat'o'j'n
kantio	kanti'o
kantiana	kanti'an'a
kantiko	kantik'o
kantikoj	kantik'o'j
kantino	kantin'o
kantona	kanton'a
kantonaj	kanton'a'j
kantonan	kanton'a'n
kantono	kanton'o
kantonoj	kanton'o'j
kantonojn	kanton'o'j'n
kantonon	kanton'o'n
kantonanoj	kanton'an'o'j
kantoro	kantor'o
kantoroj	kantor'o'j
kanuo	kanu'o
kanuoj	kanu'o'j
kanuon	kanu'o'n
kanuado	kanu'ad'o
kanulo	kanul'o
kanvaso	kanvas'o
kanvasoj	kanvas'o'j
kanvason	kanvas'o'n
kanzono	kanzon'o
kanzonoj	kanzon'o'j
kanzonojn	kanzon'o'j'n
kanzonon	kanzon'o'n
kanzonisto	kanzon'ist'o
kanzonistoj	kanzon'ist'o'j
kanzonistino	kanzon'ist'in'o
kaolino	kaolin'o
kaosa	kaos'a
kaosaj	kaos'a'j
kaosan	kaos'a'n
kaose	kaos'e
kaoso	kaos'o
kaoson	kaos'o'n
kapa	kap'a
kapaj	kap'a'j
kapan	kap'a'n
kape	kap'e
kapo	kap'o
kapoj	kap'o'j
kapojn	kap'o'j'n
kapon	kap'o'n
kapalkapa	kap'al'kap'a
kapantaŭe	kap'antaŭ'e
kapantaŭen	kap'antaŭ'e'n
kapaŭskultilo	kap'aŭskult'il'o
kapaŭskultiloj	kap'aŭskult'il'o'j
kapbalancis	kap'balanc'is
kapdoloro	kap'dolor'o
kapdoloroj	kap'dolor'o'j
kapdolorojn	kap'dolor'o'j'n
kapdoloron	kap'dolor'o'n
kapeto	kap'et'o
kapetoj	kap'et'o'j
kapeton	kap'et'o'n
kapjesas	kap'jes'as
kapjesis	kap'jes'is
kapjeso	kap'jes'o
kapjesante	kap'jes'ant'e
kapklinis	kap'klin'is
kapkuseno	kap'kusen'o
kapkusenoj	kap'kusen'o'j
kapkusenojn	kap'kusen'o'j'n
kapkusenon	kap'kusen'o'n
kaploko	kap'lok'o
kapmovo	kap'mov'o
kapneis	kap'ne'is
kapneante	kap'ne'ant'e
kapobildo	kap'o'bild'o
kapobildon	kap'o'bild'o'n
kapopieduloj	kap'o'pied'ul'o'j
kapornamaĵoj	kap'ornam'aĵ'o'j
kapornamaĵojn	kap'ornam'aĵ'o'j'n
kaprilato	kap'rilat'o
kapsalutis	kap'salut'is
kapsignis	kap'sign'is
kapskuis	kap'sku'is
kaptuko	kap'tuk'o
kaptukoj	kap'tuk'o'j
kaptukon	kap'tuk'o'n
kapturne	kap'turn'e
kapturno	kap'turn'o
kapturnon	kap'turn'o'n
kapturniĝo	kap'turn'iĝ'o
kapturniĝon	kap'turn'iĝ'o'n
kapvesto	kap'vest'o
kapvestoj	kap'vest'o'j
kapveston	kap'vest'o'n
kapvestaĵo	kap'vest'aĵ'o
kapvorto	kap'vort'o
kapvortoj	kap'vort'o'j
kapvortojn	kap'vort'o'j'n
kapvundo	kap'vund'o
kapabla	kapabl'a
kapablaj	kapabl'a'j
kapablajn	kapabl'a'j'n
kapablan	kapabl'a'n
kapablas	kapabl'as
kapable	kapabl'e
kapabli	kapabl'i
kapablis	kapabl'is
kapablo	kapabl'o
kapabloj	kapabl'o'j
kapablojn	kapabl'o'j'n
kapablon	kapabl'o'n
kapablos	kapabl'os
kapablu	kapabl'u
kapablus	kapabl'us
kapablante	kapabl'ant'e
kapableco	kapabl'ec'o
kapablecoj	kapabl'ec'o'j
kapablecojn	kapabl'ec'o'j'n
kapablecon	kapabl'ec'o'n
kapabligas	kapabl'ig'as
kapabligi	kapabl'ig'i
kapablismo	kapabl'ism'o
kapabluloj	kapabl'ul'o'j
kapacita	kapacit'a
kapacitaj	kapacit'a'j
kapacito	kapacit'o
kapacitoj	kapacit'o'j
kapacitojn	kapacit'o'j'n
kapaciton	kapacit'o'n
kapacitanco	kapacitanc'o
kapacitancon	kapacitanc'o'n
kapelo	kapel'o
kapeloj	kapel'o'j
kapelojn	kapel'o'j'n
kapelon	kapel'o'n
kapelano	kapel'an'o
kapelanoj	kapel'an'o'j
kapelestro	kapel'estr'o
kapeleto	kapel'et'o
kapelmajstro	kapel'majstr'o
kapilara	kapilar'a
kapilaraj	kapilar'a'j
kapilaro	kapilar'o
kapilaroj	kapilar'o'j
kapilarojn	kapilar'o'j'n
kapitala	kapital'a
kapitalaj	kapital'a'j
kapitalan	kapital'a'n
kapitalo	kapital'o
kapitaloj	kapital'o'j
kapitalojn	kapital'o'j'n
kapitalon	kapital'o'n
kapitaligas	kapital'ig'as
kapitaligi	kapital'ig'i
kapitaligis	kapital'ig'is
kapitaligo	kapital'ig'o
kapitaligita	kapital'ig'it'a
kapitaligitaj	kapital'ig'it'a'j
kapitalinvesto	kapital'invest'o
kapitalisma	kapital'ism'a
kapitalismaj	kapital'ism'a'j
kapitalisman	kapital'ism'a'n
kapitalismo	kapital'ism'o
kapitalismon	kapital'ism'o'n
kapitalista	kapital'ist'a
kapitalistaj	kapital'ist'a'j
kapitalisto	kapital'ist'o
kapitalistoj	kapital'ist'o'j
kapitalistojn	kapital'ist'o'j'n
kapitalkostoj	kapital'kost'o'j
kapitalmerkatoj	kapital'merkat'o'j
kapitalurbo	kapital'urb'o
kapitana	kapitan'a
kapitano	kapitan'o
kapitanoj	kapitan'o'j
kapitanon	kapitan'o'n
kapitelo	kapitel'o
kapiteloj	kapitel'o'j
kapitola	kapitol'a
kapitolo	kapitol'o
kapitula	kapitul'a
kapitulo	kapitul'o
kapitulacas	kapitulac'as
kapitulaci	kapitulac'i
kapitulacis	kapitulac'is
kapitulaco	kapitulac'o
kapitulacoj	kapitulac'o'j
kapitulacon	kapitulac'o'n
kapitulacos	kapitulac'os
kapitulacu	kapitulac'u
kapitulacado	kapitulac'ad'o
kapitulacigi	kapitulac'ig'i
kapitulacio	kapitulaci'o
kaporalo	kaporal'o
kapoto	kapot'o
kapoton	kapot'o'n
kapra	kapr'a
kapro	kapr'o
kaproj	kapr'o'j
kaprojn	kapr'o'j'n
kapron	kapr'o'n
kaprido	kapr'id'o
kapridoj	kapr'id'o'j
kapridojn	kapr'id'o'j'n
kaprina	kapr'in'a
kaprinan	kapr'in'a'n
kaprino	kapr'in'o
kaprinoj	kapr'in'o'j
kaprinojn	kapr'in'o'j'n
kaprinon	kapr'in'o'n
kapreolo	kapreol'o
kapreoloj	kapreol'o'j
kapreolineto	kapreol'in'et'o
kaprica	kapric'a
kapricaj	kapric'a'j
kaprican	kapric'a'n
kapricas	kapric'as
kaprice	kapric'e
kaprico	kapric'o
kapricoj	kapric'o'j
kapricojn	kapric'o'j'n
kapricon	kapric'o'n
kaprikorno	kaprikorn'o
kaprimulgo	kaprimulg'o
kapsika	kapsik'a
kapsiko	kapsik'o
kapsikoj	kapsik'o'j
kapsikojn	kapsik'o'j'n
kapsiketo	kapsik'et'o
kapsiketoj	kapsik'et'o'j
kapsulo	kapsul'o
kapsuloj	kapsul'o'j
kapsulojn	kapsul'o'j'n
kapsulon	kapsul'o'n
kapsulfruktoj	kapsul'frukt'o'j
kapta	kapt'a
kaptas	kapt'as
kapti	kapt'i
kaptis	kapt'is
kapto	kapt'o
kaptoj	kapt'o'j
kapton	kapt'o'n
kaptos	kapt'os
kaptu	kapt'u
kaptus	kapt'us
kaptadi	kapt'ad'i
kaptadis	kapt'ad'is
kaptado	kapt'ad'o
kaptadon	kapt'ad'o'n
kaptaĵo	kapt'aĵ'o
kaptaĵoj	kapt'aĵ'o'j
kaptaĵojn	kapt'aĵ'o'j'n
kaptaĵon	kapt'aĵ'o'n
kaptano	kapt'an'o
kaptanon	kapt'an'o'n
kaptanta	kapt'ant'a
kaptante	kapt'ant'e
kaptanto	kapt'ant'o
kaptantoj	kapt'ant'o'j
kaptata	kapt'at'a
kaptataj	kapt'at'a'j
kaptebla	kapt'ebl'a
kapteblaj	kapt'ebl'a'j
kapteco	kapt'ec'o
kaptiĝas	kapt'iĝ'as
kaptiĝi	kapt'iĝ'i
kaptiĝis	kapt'iĝ'is
kaptiĝo	kapt'iĝ'o
kaptiĝos	kapt'iĝ'os
kaptilo	kapt'il'o
kaptiloj	kapt'il'o'j
kaptilojn	kapt'il'o'j'n
kaptilon	kapt'il'o'n
kaptinta	kapt'int'a
kaptintaj	kapt'int'a'j
kaptinte	kapt'int'e
kaptinto	kapt'int'o
kaptintoj	kapt'int'o'j
kaptisto	kapt'ist'o
kaptistoj	kapt'ist'o'j
kaptita	kapt'it'a
kaptitaj	kapt'it'a'j
kaptitajn	kapt'it'a'j'n
kaptitan	kapt'it'a'n
kaptite	kapt'it'e
kaptito	kapt'it'o
kaptitoj	kapt'it'o'j
kaptitojn	kapt'it'o'j'n
kaptiton	kapt'it'o'n
kaptiteco	kapt'it'ec'o
kaptitecon	kapt'it'ec'o'n
kaptujo	kapt'uj'o
kapucena	kapucen'a
kapuceno	kapucen'o
kapucenoj	kapucen'o'j
kapuĉa	kapuĉ'a
kapuĉo	kapuĉ'o
kapuĉoj	kapuĉ'o'j
kapuĉojn	kapuĉ'o'j'n
kapuĉon	kapuĉ'o'n
kara	kar'a
karaj	kar'a'j
karajn	kar'a'j'n
karan	kar'a'n
kare	kar'e
karo	kar'o
karega	kar'eg'a
karegaj	kar'eg'a'j
karmemora	kar'memor'a
karulo	kar'ul'o
karuloj	kar'ul'o'j
karulon	kar'ul'o'n
karulino	kar'ul'in'o
karulinon	kar'ul'in'o'n
karabeno	karaben'o
karabenoj	karaben'o'j
karabenon	karaben'o'n
karabenistoj	karaben'ist'o'j
karafo	karaf'o
karafon	karaf'o'n
karaĝo	karaĝ'o
karakalo	karakal'o
karakaso	karakas'o
karaktera	karakter'a
karakteraj	karakter'a'j
karakterajn	karakter'a'j'n
karakteran	karakter'a'n
karakteras	karakter'as
karaktere	karakter'e
karaktero	karakter'o
karakteroj	karakter'o'j
karakterojn	karakter'o'j'n
karakteron	karakter'o'n
karakteraĵoj	karakter'aĵ'o'j
karakterevoluo	karakter'evolu'o
karakteriĝas	karakter'iĝ'as
karakteriza	karakteriz'a
karakterizaj	karakteriz'a'j
karakterizajn	karakteriz'a'j'n
karakterizan	karakteriz'a'n
karakterizas	karakteriz'as
karakterize	karakteriz'e
karakterizi	karakteriz'i
karakterizis	karakteriz'is
karakterizo	karakteriz'o
karakterizoj	karakteriz'o'j
karakterizojn	karakteriz'o'j'n
karakterizon	karakteriz'o'n
karakterizado	karakteriz'ad'o
karakterizadoj	karakteriz'ad'o'j
karakterizadon	karakteriz'ad'o'n
karakterizaĵo	karakteriz'aĵ'o
karakterizaĵoj	karakteriz'aĵ'o'j
karakterizaĵojn	karakteriz'aĵ'o'j'n
karakterizaĵon	karakteriz'aĵ'o'n
karakterizanta	karakteriz'ant'a
karakterizante	karakteriz'ant'e
karakterizata	karakteriz'at'a
karakterizataj	karakteriz'at'a'j
karakteriziĝas	karakteriz'iĝ'as
karakteriziĝis	karakteriz'iĝ'is
karakterizita	karakteriz'it'a
karakterizitaj	karakteriz'it'a'j
karakterizitajn	karakteriz'it'a'j'n
karakterizitan	karakteriz'it'a'n
karakterizite	karakteriz'it'e
karaktraro	karaktr'ar'o
karaktraroj	karaktr'ar'o'j
karaktraron	karaktr'ar'o'n
karambolas	karambol'as
karambolis	karambol'is
karamelo	karamel'o
karaokea	karaoke'a
karaokeo	karaoke'o
karaokeon	karaoke'o'n
karapaco	karapac'o
karateo	karate'o
karavana	karavan'a
karavano	karavan'o
karavanoj	karavan'o'j
karavanon	karavan'o'n
karavelo	karavel'o
karba	karb'a
karbaj	karb'a'j
karbe	karb'e
karbo	karb'o
karboj	karb'o'j
karbojn	karb'o'j'n
karbon	karb'o'n
karbido	karb'id'o
karbidoj	karb'id'o'j
karbigita	karb'ig'it'a
karbminado	karb'min'ad'o
karbogado	karb'o'gad'o
karbominejo	karb'o'min'ej'o
karbominejoj	karb'o'min'ej'o'j
karbopolvo	karb'o'polv'o
karbamato	karbam'at'o
karbinolo	karbinol'o
karboksila	karboksil'a
karboksilacidoj	karboksil'acid'o'j
karboksilata	karboksil'at'a
karboksilataj	karboksil'at'a'j
karbona	karbon'a
karbonaj	karbon'a'j
karbonan	karbon'a'n
karbono	karbon'o
karbonoj	karbon'o'j
karbonon	karbon'o'n
karbonasimilado	karbon'asimil'ad'o
karbonata	karbon'at'a
karbonataj	karbon'at'a'j
karbonato	karbon'at'o
karbonatoj	karbon'at'o'j
karbonatomo	karbon'atom'o
karbonatomoj	karbon'atom'o'j
karbonciklo	karbon'cikl'o
karbondioksido	karbon'di'oksid'o
karbondioksidon	karbon'di'oksid'o'n
karbondioksidemisioj	karbon'di'oksid'emisi'o'j
karbonemisioj	karbon'emisi'o'j
karbonemisiojn	karbon'emisi'o'j'n
karbonenhavo	karbon'en'hav'o
karbonfibro	karbon'fibr'o
karbonhidrato	karbon'hidrat'o
karbonhidratoj	karbon'hidrat'o'j
karbonhidratojn	karbon'hidrat'o'j'n
karbonimposto	karbon'impost'o
karbonnanotubo	karbon'nano'tub'o
karbonnanotuboj	karbon'nano'tub'o'j
karbonpiedsigno	karbon'pied'sign'o
karbonpiedsignon	karbon'pied'sign'o'n
karbonŝtalo	karbon'ŝtal'o
karbonia	karboni'a
karbonio	karboni'o
karbonila	karbonil'a
karburilo	karbur'il'o
karcero	karcer'o
karceroj	karcer'o'j
karceron	karcer'o'n
karcinomo	karcinom'o
karcinomogena	karcinom'o'gen'a
kardis	kard'is
kardo	kard'o
kardoj	kard'o'j
kardamomo	kardamom'o
kardelo	kardel'o
kardiovaskula	kardi'o'vaskul'a
kardiovaskulaj	kardi'o'vaskul'a'j
kardiovaskulan	kardi'o'vaskul'a'n
kardiologo	kardi'olog'o
kardinala	kardinal'a
kardinalaj	kardinal'a'j
kardinalo	kardinal'o
kardinaloj	kardinal'o'j
kardinalojn	kardinal'o'j'n
kardinalon	kardinal'o'n
kardinalaro	kardinal'ar'o
kareo	kare'o
kareksejoj	kareks'ej'o'j
kareno	karen'o
karenoj	karen'o'j
karenon	karen'o'n
karesa	kares'a
karesaj	kares'a'j
karesajn	kares'a'j'n
karesan	kares'a'n
karesas	kares'as
karese	kares'e
karesi	kares'i
karesis	kares'is
kareso	kares'o
karesoj	kares'o'j
karesojn	kares'o'j'n
kareson	kares'o'n
karesos	kares'os
karesu	kares'u
karesadis	kares'ad'is
karesado	kares'ad'o
karesante	kares'ant'e
karesata	kares'at'a
karesema	kares'em'a
karesnomo	kares'nom'o
karesmo	karesm'o
kargo	karg'o
kargoj	karg'o'j
kargon	karg'o'n
kargado	karg'ad'o
kargadon	karg'ad'o'n
kargokompanioj	karg'o'kompani'o'j
kargoŝipo	karg'o'ŝip'o
kargoŝipoj	karg'o'ŝip'o'j
karibuo	karibu'o
kariero	karier'o
karieroj	karier'o'j
karierojn	karier'o'j'n
karieron	karier'o'n
kariertabelo	karier'tabel'o
kariertabeloj	karier'tabel'o'j
kariertabelon	karier'tabel'o'n
karikatura	karikatur'a
karikaturaj	karikatur'a'j
karikaturo	karikatur'o
karikaturoj	karikatur'o'j
karikaturojn	karikatur'o'j'n
karikaturon	karikatur'o'n
karikaturisto	karikatur'ist'o
karikaturistoj	karikatur'ist'o'j
kariljono	kariljon'o
karina	karin'a
karintio	karinti'o
kariofilo	kariofil'o
kariolo	kariol'o
karisma	karism'a
karismaj	karism'a'j
karismo	karism'o
karismoj	karism'o'j
karismon	karism'o'n
karitata	karitat'a
karitataj	karitat'a'j
karitatan	karitat'a'n
karitato	karitat'o
karitaton	karitat'o'n
karla	karl'a
karlo	karl'o
karlon	karl'o'n
karlovo	karlov'o
karma	karm'a
karman	karm'a'n
karmo	karm'o
karmon	karm'o'n
karmanoro	karmanor'o
karmelo	karmel'o
karmelana	karmel'an'a
karmelanoj	karmel'an'o'j
karmezina	karmezin'a
karmezinaj	karmezin'a'j
karna	karn'a
karnaj	karn'a'j
karnajn	karn'a'j'n
karno	karn'o
karnoj	karn'o'j
karnon	karn'o'n
karneca	karn'ec'a
karnecaj	karn'ec'a'j
karnomanĝulo	karn'o'manĝ'ul'o
karnomanĝuloj	karn'o'manĝ'ul'o'j
karnoplena	karn'o'plen'a
karnovora	karn'o'vor'a
karnovoraj	karn'o'vor'a'j
karnovoruloj	karn'o'vor'ul'o'j
karnataka	karnatak'a
karnatako	karnatak'o
karnavala	karnaval'a
karnavalaj	karnaval'a'j
karnavalo	karnaval'o
karnavaloj	karnaval'o'j
karnavalon	karnaval'o'n
karoo	karo'o
karola	karol'a
karolo	karol'o
karolon	karol'o'n
karolida	karol'id'a
karolidaj	karol'id'a'j
karolidoj	karol'id'o'j
karolina	karol'in'a
karolino	karol'in'o
karolina	karolin'a
karolino	karolin'o
karono	karon'o
karoserio	karoseri'o
karoto	karot'o
karotoj	karot'o'j
karotojn	karot'o'j'n
karoton	karot'o'n
karotenoido	karoten'oid'o
karotenoidoj	karoten'oid'o'j
karotida	karotid'a
karotidaj	karotid'a'j
karpo	karp'o
karpoj	karp'o'j
karpojn	karp'o'j'n
karpon	karp'o'n
karpata	karpat'a
karpatoj	karpat'o'j
karpelo	karpel'o
karpeloj	karpel'o'j
karsta	karst'a
karstaj	karst'a'j
karsto	karst'o
karta	kart'a
karto	kart'o
kartoj	kart'o'j
kartojn	kart'o'j'n
karton	kart'o'n
kartaro	kart'ar'o
kartetoj	kart'et'o'j
karteton	kart'et'o'n
kartludi	kart'lud'i
kartludis	kart'lud'is
kartludo	kart'lud'o
kartludoj	kart'lud'o'j
kartludado	kart'lud'ad'o
kartaga	kartag'a
kartagaj	kartag'a'j
kartagan	kartag'a'n
kartago	kartag'o
kartagon	kartag'o'n
kartaganoj	kartag'an'o'j
kartelo	kartel'o
karteloj	kartel'o'j
kartezia	kartezi'a
kartezio	kartezi'o
kartilago	kartilag'o
kartilagon	kartilag'o'n
kartoĉo	kartoĉ'o
kartoĉoj	kartoĉ'o'j
kartoĉojn	kartoĉ'o'j'n
kartoĉon	kartoĉ'o'n
kartografo	kartograf'o
kartografoj	kartograf'o'j
kartografio	kartograf'i'o
kartona	karton'a
kartonaj	karton'a'j
kartonajn	karton'a'j'n
kartonan	karton'a'n
kartono	karton'o
kartonon	karton'o'n
kartuŝo	kartuŝ'o
kartuzio	kartuzi'o
kartuzianoj	kartuzi'an'o'j
kartvela	kartvel'a
kartvelaj	kartvel'a'j
kartvelan	kartvel'a'n
kartvelo	kartvel'o
kartveloj	kartvel'o'j
kartvelia	kartvel'i'a
kartvelio	kartvel'i'o
kartvelion	kartvel'i'o'n
kartvelujo	kartvel'uj'o
karuselo	karusel'o
kaso	kas'o
kasoj	kas'o'j
kason	kas'o'n
kasisto	kas'ist'o
kasistoj	kas'ist'o'j
kasiston	kas'ist'o'n
kasistino	kas'ist'in'o
kasacia	kasaci'a
kasedo	kased'o
kasedoj	kased'o'j
kasedojn	kased'o'j'n
kasedon	kased'o'n
kaserolo	kaserol'o
kaseroloj	kaserol'o'j
kaserolon	kaserol'o'n
kaseto	kaset'o
kasiodoro	kasiodor'o
kasko	kask'o
kaskoj	kask'o'j
kaskojn	kask'o'j'n
kaskon	kask'o'n
kaskada	kaskad'a
kaskado	kaskad'o
kaskadoj	kaskad'o'j
kaskadojn	kaskad'o'j'n
kaskadon	kaskad'o'n
kaskedo	kasked'o
kaskedon	kasked'o'n
kaspia	kaspi'a
kaspian	kaspi'a'n
kaspio	kaspi'o
kasta	kast'a
kasto	kast'o
kastoj	kast'o'j
kaston	kast'o'n
kastismo	kast'ism'o
kastanjetoj	kastanjet'o'j
kastela	kastel'a
kastelaj	kastel'a'j
kastelan	kastel'a'n
kastelo	kastel'o
kasteloj	kastel'o'j
kastelojn	kastel'o'j'n
kastelon	kastel'o'n
kasteleto	kastel'et'o
kastilia	kastili'a
kastiliaj	kastili'a'j
kastilian	kastili'a'n
kastilio	kastili'o
kastora	kastor'a
kastoro	kastor'o
kastoroj	kastor'o'j
kastoron	kastor'o'n
kastras	kastr'as
kastris	kastr'is
kastro	kastr'o
kastrado	kastr'ad'o
kastrita	kastr'it'a
kastritaj	kastr'it'a'j
kaŝa	kaŝ'a
kaŝaj	kaŝ'a'j
kaŝajn	kaŝ'a'j'n
kaŝan	kaŝ'a'n
kaŝas	kaŝ'as
kaŝe	kaŝ'e
kaŝi	kaŝ'i
kaŝis	kaŝ'is
kaŝo	kaŝ'o
kaŝos	kaŝ'os
kaŝu	kaŝ'u
kaŝus	kaŝ'us
kaŝadis	kaŝ'ad'is
kaŝado	kaŝ'ad'o
kaŝadoj	kaŝ'ad'o'j
kaŝadon	kaŝ'ad'o'n
kaŝanta	kaŝ'ant'a
kaŝantaj	kaŝ'ant'a'j
kaŝante	kaŝ'ant'e
kaŝata	kaŝ'at'a
kaŝataj	kaŝ'at'a'j
kaŝejo	kaŝ'ej'o
kaŝejoj	kaŝ'ej'o'j
kaŝejojn	kaŝ'ej'o'j'n
kaŝejon	kaŝ'ej'o'n
kaŝema	kaŝ'em'a
kaŝenmigrinto	kaŝ'en'migr'int'o
kaŝiĝas	kaŝ'iĝ'as
kaŝiĝi	kaŝ'iĝ'i
kaŝiĝis	kaŝ'iĝ'is
kaŝiĝu	kaŝ'iĝ'u
kaŝinta	kaŝ'int'a
kaŝinte	kaŝ'int'e
kaŝita	kaŝ'it'a
kaŝitaj	kaŝ'it'a'j
kaŝitajn	kaŝ'it'a'j'n
kaŝitan	kaŝ'it'a'n
kaŝite	kaŝ'it'e
kaŝludon	kaŝ'lud'o'n
kaŝmemoro	kaŝ'memor'o
kaŝnomo	kaŝ'nom'o
kaŝnomoj	kaŝ'nom'o'j
kaŝnomojn	kaŝ'nom'o'j'n
kaŝnomon	kaŝ'nom'o'n
kaŝobservi	kaŝ'observ'i
kaŝpafisto	kaŝ'paf'ist'o
kaŝpafistoj	kaŝ'paf'ist'o'j
kaŝrigardis	kaŝ'rigard'is
kaŝtrezoro	kaŝ'trezor'o
kaŝvesti	kaŝ'vest'i
kaŝvestiĝis	kaŝ'vest'iĝ'is
kaŝvestita	kaŝ'vest'it'a
kaŝmira	kaŝmir'a
kaŝmiraj	kaŝmir'a'j
kaŝmiro	kaŝmir'o
kaŝmiron	kaŝmir'o'n
kaŝmirano	kaŝmir'an'o
kaŝtano	kaŝtan'o
kaŝtanoj	kaŝtan'o'j
kaŝtanojn	kaŝtan'o'j'n
kaŝtanarbo	kaŝtan'arb'o
kaŝtanarboj	kaŝtan'arb'o'j
kaŝtanbruna	kaŝtan'brun'a
kaŝtanbrunaj	kaŝtan'brun'a'j
kaŝtankoloraj	kaŝtan'kolor'a'j
kaŝtanujoj	kaŝtan'uj'o'j
kaŝuba	kaŝub'a
kata	kat'a
katan	kat'a'n
kate	kat'e
kato	kat'o
katoj	kat'o'j
katojn	kat'o'j'n
katon	kat'o'n
katido	kat'id'o
katidoj	kat'id'o'j
katidojn	kat'id'o'j'n
katidon	kat'id'o'n
katino	kat'in'o
katinoj	kat'in'o'j
katinon	kat'in'o'n
kataklismaj	kataklism'a'j
kataklismo	kataklism'o
kataklismoj	kataklism'o'j
katakomboj	katakomb'o'j
kataliza	kataliz'a
katalizaj	kataliz'a'j
katalizan	kataliz'a'n
katalizas	kataliz'as
katalize	kataliz'e
katalizi	kataliz'i
katalizo	kataliz'o
katalizilo	kataliz'il'o
kataliziloj	kataliz'il'o'j
katalizilojn	kataliz'il'o'j'n
katalizilon	kataliz'il'o'n
katalizita	kataliz'it'a
katalogas	katalog'as
katalogi	katalog'i
katalogis	katalog'is
katalogo	katalog'o
katalogoj	katalog'o'j
katalogojn	katalog'o'j'n
katalogon	katalog'o'n
katalogado	katalog'ad'o
katalogitaj	katalog'it'a'j
kataluna	katalun'a
katalunaj	katalun'a'j
katalunan	katalun'a'n
katalune	katalun'e
kataluno	katalun'o
katalunoj	katalun'o'j
katalunio	katalun'i'o
katalunion	katalun'i'o'n
katalunisma	katalun'ism'a
katalunlingva	katalun'lingv'a
katalunujo	katalun'uj'o
katapulto	katapult'o
katapultoj	katapult'o'j
katara	katar'a
kataro	katar'o
kataroj	katar'o'j
kataron	katar'o'n
katarakto	katarakt'o
katastro	katastr'o
katastrofa	katastrof'a
katastrofaj	katastrof'a'j
katastrofajn	katastrof'a'j'n
katastrofan	katastrof'a'n
katastrofe	katastrof'e
katastrofo	katastrof'o
katastrofoj	katastrof'o'j
katastrofojn	katastrof'o'j'n
katastrofon	katastrof'o'n
katastrofejo	katastrof'ej'o
katastrofhelpo	katastrof'help'o
katastrofitaj	katastrof'it'a'j
katedro	katedr'o
katedroj	katedr'o'j
katedron	katedr'o'n
katedrala	katedral'a
katedralaj	katedral'a'j
katedralo	katedral'o
katedraloj	katedral'o'j
katedralojn	katedral'o'j'n
katedralon	katedral'o'n
kategoria	kategori'a
kategoriaj	kategori'a'j
kategoriajn	kategori'a'j'n
kategorian	kategori'a'n
kategorie	kategori'e
kategorio	kategori'o
kategorioj	kategori'o'j
kategoriojn	kategori'o'j'n
kategorion	kategori'o'n
kategoriado	kategori'ad'o
kategoriadon	kategori'ad'o'n
kategoriigas	kategori'ig'as
kategoriigi	kategori'ig'i
kategoriigo	kategori'ig'o
kategoriigita	kategori'ig'it'a
kategoriigitaj	kategori'ig'it'a'j
kategoriiĝas	kategori'iĝ'as
kategoriiĝi	kategori'iĝ'i
kategoriiĝis	kategori'iĝ'is
kategoriokomunumo	kategori'o'komun'um'o
kateĥismo	kateĥism'o
katekismo	katekism'o
katekismon	katekism'o'n
katekizo	katekiz'o
katekizado	katekiz'ad'o
katenas	katen'as
kateni	katen'i
katenis	katen'is
kateno	katen'o
katenoj	katen'o'j
katenojn	katen'o'j'n
katenon	katen'o'n
katenado	katen'ad'o
katenita	katen'it'a
katenitaj	katen'it'a'j
katensekso	katen'seks'o
kateto	katet'o
katetoj	katet'o'j
kateton	katet'o'n
katetero	kateter'o
katilina	katilin'a
katilino	katilin'o
katjona	katjon'a
katjonaj	katjon'a'j
katjono	katjon'o
katjonoj	katjon'o'j
katjonojn	katjon'o'j'n
katmanduo	katmandu'o
katoda	katod'a
katodaj	katod'a'j
katodo	katod'o
katodoj	katod'o'j
katodon	katod'o'n
katolika	katolik'a
katolikaj	katolik'a'j
katolikajn	katolik'a'j'n
katolikan	katolik'a'n
katolike	katolik'e
katoliko	katolik'o
katolikoj	katolik'o'j
katolikojn	katolik'o'j'n
katolikon	katolik'o'n
katolikaro	katolik'ar'o
katolikeco	katolik'ec'o
katolikino	katolik'in'o
katolikismo	katolik'ism'o
katolikismon	katolik'ism'o'n
katono	katon'o
katulo	katul'o
katuna	katun'a
katuno	katun'o
kaŭcio	kaŭci'o
kaŭĉuka	kaŭĉuk'a
kaŭĉukaj	kaŭĉuk'a'j
kaŭĉukajn	kaŭĉuk'a'j'n
kaŭĉukan	kaŭĉuk'a'n
kaŭĉuko	kaŭĉuk'o
kaŭĉukoj	kaŭĉuk'o'j
kaŭĉukon	kaŭĉuk'o'n
kaŭkaza	kaŭkaz'a
kaŭkazaj	kaŭkaz'a'j
kaŭkazan	kaŭkaz'a'n
kaŭkazo	kaŭkaz'o
kaŭkazia	kaŭkaz'i'a
kaŭkazio	kaŭkaz'i'o
kaŭkazianoj	kaŭkaz'i'an'o'j
kaŭras	kaŭr'as
kaŭre	kaŭr'e
kaŭri	kaŭr'i
kaŭris	kaŭr'is
kaŭranta	kaŭr'ant'a
kaŭrante	kaŭr'ant'e
kaŭriĝis	kaŭr'iĝ'is
kaŭstika	kaŭstik'a
kaŭstikaj	kaŭstik'a'j
kaŭza	kaŭz'a
kaŭzaj	kaŭz'a'j
kaŭzajn	kaŭz'a'j'n
kaŭzan	kaŭz'a'n
kaŭzas	kaŭz'as
kaŭze	kaŭz'e
kaŭzi	kaŭz'i
kaŭzis	kaŭz'is
kaŭzo	kaŭz'o
kaŭzoj	kaŭz'o'j
kaŭzojn	kaŭz'o'j'n
kaŭzon	kaŭz'o'n
kaŭzos	kaŭz'os
kaŭzu	kaŭz'u
kaŭzus	kaŭz'us
kaŭzadis	kaŭz'ad'is
kaŭzado	kaŭz'ad'o
kaŭzadon	kaŭz'ad'o'n
kaŭzanta	kaŭz'ant'a
kaŭzantaj	kaŭz'ant'a'j
kaŭzantajn	kaŭz'ant'a'j'n
kaŭzantan	kaŭz'ant'a'n
kaŭzante	kaŭz'ant'e
kaŭzanto	kaŭz'ant'o
kaŭzata	kaŭz'at'a
kaŭzataj	kaŭz'at'a'j
kaŭzeco	kaŭz'ec'o
kaŭzecon	kaŭz'ec'o'n
kaŭzinta	kaŭz'int'a
kaŭzinte	kaŭz'int'e
kaŭzintus	kaŭz'int'us
kaŭzita	kaŭz'it'a
kaŭzitaj	kaŭz'it'a'j
kaŭzitajn	kaŭz'it'a'j'n
kaŭzitan	kaŭz'it'a'n
kaŭzite	kaŭz'it'e
kava	kav'a
kavaj	kav'a'j
kavajn	kav'a'j'n
kavan	kav'a'n
kavi	kav'i
kavo	kav'o
kavoj	kav'o'j
kavojn	kav'o'j'n
kavon	kav'o'n
kavaĵo	kav'aĵ'o
kavaĵoj	kav'aĵ'o'j
kavaĵojn	kav'aĵ'o'j'n
kavaĵon	kav'aĵ'o'n
kaveto	kav'et'o
kavetoj	kav'et'o'j
kavetojn	kav'et'o'j'n
kaveton	kav'et'o'n
kavigita	kav'ig'it'a
kavaleria	kavaleri'a
kavalerio	kavaleri'o
kavalerion	kavaleri'o'n
kavalerianoj	kavaleri'an'o'j
kavaleritrupo	kavaleri'trup'o
kavalira	kavalir'a
kavaliraj	kavalir'a'j
kavaliran	kavalir'a'n
kavaliro	kavalir'o
kavaliroj	kavalir'o'j
kavalirojn	kavalir'o'j'n
kavaliron	kavalir'o'n
kavaliraro	kavalir'ar'o
kavalireca	kavalir'ec'a
kavalireco	kavalir'ec'o
kavalkado	kavalkad'o
kaverna	kavern'a
kavernaj	kavern'a'j
kaverno	kavern'o
kavernoj	kavern'o'j
kavernojn	kavern'o'j'n
kavernon	kavern'o'n
kavernaro	kavern'ar'o
kaverndomo	kavern'dom'o
kavernuloj	kavern'ul'o'j
kaviaro	kaviar'o
kaviaron	kaviar'o'n
kaza	kaz'a
kazan	kaz'a'n
kaze	kaz'e
kazo	kaz'o
kazoj	kaz'o'j
kazojn	kaz'o'j'n
kazon	kaz'o'n
kazablanko	kazablank'o
kazaĥa	kazaĥ'a
kazaĥoj	kazaĥ'o'j
kazaĥio	kazaĥ'i'o
kazaĥujo	kazaĥ'uj'o
kazaĥstano	kazaĥstan'o
kazanlako	kazanlak'o
kazeo	kaze'o
kazeon	kaze'o'n
kazerno	kazern'o
kazernoj	kazern'o'j
kazernon	kazern'o'n
kazimiro	kazimir'o
kazino	kazin'o
kazinoj	kazin'o'j
kazuo	kazu'o
kazuaroj	kazuar'o'j
ke	ke
kefrazo	ke'fraz'o
kefrazoj	ke'fraz'o'j
kefrazon	ke'fraz'o'n
kebabo	kebab'o
kebabon	kebab'o'n
kebeko	kebek'o
kebekia	kebek'i'a
kebekio	kebek'i'o
kebekifranca	kebek'i'franc'a
kebekurbo	kebek'urb'o
keĉua	keĉu'a
keĉuan	keĉu'a'n
keĉupo	keĉup'o
keglojn	kegl'o'j'n
kejlo	kejl'o
kejloj	kejl'o'j
kejlon	kejl'o'n
kekso	keks'o
keksoj	keks'o'j
keksojn	keks'o'j'n
kekson	keks'o'n
kela	kel'a
kelo	kel'o
keloj	kel'o'j
kelojn	kel'o'j'n
kelon	kel'o'n
keletaĝo	kel'etaĝ'o
kelantano	kelantan'o
kelka	kelk'a
kelkaj	kelk'a'j
kelkajn	kelk'a'j'n
kelkan	kelk'a'n
kelkcent	kelk'cent
kelkdek	kelk'dek
kelke	kelk'e
kelkiam	kelk'iam
kelkiu	kelk'iu
kelkmil	kelk'mil
kelko	kelk'o
kelkon	kelk'o'n
kelkafoje	kelk'a'foj'e
kelkatempe	kelk'a'temp'e
kelkcentoj	kelk'cent'o'j
kelkdeko	kelk'dek'o
kelkdekoj	kelk'dek'o'j
kelkdekjara	kelk'dek'jar'a
kelketaj	kelk'et'a'j
kelkfoja	kelk'foj'a
kelkfoje	kelk'foj'e
kelkhora	kelk'hor'a
kelkiuj	kelk'iu'j
kelkjara	kelk'jar'a
kelkloke	kelk'lok'e
kelkmaniere	kelk'manier'e
kelkmiloj	kelk'mil'o'j
kelkmiljara	kelk'mil'jar'a
kelkminuta	kelk'minut'a
kelkmonata	kelk'monat'a
kelkoble	kelk'obl'e
kelkokaze	kelk'okaz'e
kelkrilate	kelk'rilat'e
kelktaga	kelk'tag'a
kelktempa	kelk'temp'a
kelktempe	kelk'temp'e
kelkvorte	kelk'vort'e
kelnero	kelner'o
kelneroj	kelner'o'j
kelneron	kelner'o'n
kelnerino	kelner'in'o
kelta	kelt'a
keltaj	kelt'a'j
keltajn	kelt'a'j'n
keltan	kelt'a'n
kelto	kelt'o
keltoj	kelt'o'j
keltdevena	kelt'de'ven'a
keltiberoj	kelt'iber'o'j
kelvino	kelvin'o
kemia	kemi'a
kemiaj	kemi'a'j
kemiajn	kemi'a'j'n
kemian	kemi'a'n
kemie	kemi'e
kemio	kemi'o
kemion	kemi'o'n
kemiaĵo	kemi'aĵ'o
kemiaĵoj	kemi'aĵ'o'j
kemiaĵojn	kemi'aĵ'o'j'n
kemiaĵon	kemi'aĵ'o'n
kemiindustria	kemi'industri'a
kemiisto	kemi'ist'o
kemiistoj	kemi'ist'o'j
kemioterapio	kemi'o'terapi'o
keno	ken'o
kenja	kenj'a
kenjaj	kenj'a'j
kenjo	kenj'o
kenjon	kenj'o'n
kenjanoj	kenj'an'o'j
kenozoiko	kenozoik'o
kentukio	kentuki'o
kepo	kep'o
kera	ker'a
kero	ker'o
kerekzamenoj	ker'ekzamen'o'j
kerala	keral'a
keratino	keratin'o
kermeso	kermes'o
kermesoj	kermes'o'j
kerna	kern'a
kernaj	kern'a'j
kernajn	kern'a'j'n
kernan	kern'a'n
kerne	kern'e
kerno	kern'o
kernoj	kern'o'j
kernojn	kern'o'j'n
kernon	kern'o'n
kernarmiloj	kern'arm'il'o'j
kernproblemo	kern'problem'o
kernregiono	kern'region'o
keroseno	kerosen'o
kerosenon	kerosen'o'n
keruboj	kerub'o'j
kesto	kest'o
kestoj	kest'o'j
kestojn	kest'o'j'n
keston	kest'o'n
kestego	kest'eg'o
kestegon	kest'eg'o'n
kesteron	kest'er'o'n
kesteto	kest'et'o
kestetoj	kest'et'o'j
kesteton	kest'et'o'n
ketono	keton'o
ketonoj	keton'o'j
kevlaro	kevlar'o
kia	ki'a
kiaj	ki'a'j
kiajn	ki'a'j'n
kian	ki'a'n
kio	ki'o
kion	ki'o'n
kiacele	ki'a'cel'e
kiagrade	ki'a'grad'e
kiamaniere	ki'a'manier'e
kiaspeca	ki'a'spec'a
kial	kial
kiala	kial'a
kialas	kial'as
kialo	kial'o
kialoj	kial'o'j
kialojn	kial'o'j'n
kialon	kial'o'n
kialigo	kial'ig'o
kialigita	kial'ig'it'a
kialigitaj	kial'ig'it'a'j
kialigitan	kial'ig'it'a'n
kiam	kiam
kiamfrazo	kiam'fraz'o
kibernetiko	kibernetik'o
kibuca	kibuc'a
kibuco	kibuc'o
kibucoj	kibuc'o'j
kiĉenero	kiĉener'o
kidnapas	kidnap'as
kidnapi	kidnap'i
kidnapis	kidnap'is
kidnapo	kidnap'o
kidnapoj	kidnap'o'j
kidnapita	kidnap'it'a
kidnapitaj	kidnap'it'a'j
kie	kie
kien	kie'n
kiel	kiel
kiele	kiel'e
kielo	kiel'o
kielon	kiel'o'n
kielfrazo	kiel'fraz'o
kies	kies
kieva	kiev'a
kievan	kiev'a'n
kievo	kiev'o
kikeroj	kiker'o'j
kilo	kil'o
kilimanĝaro	kilimanĝar'o
kilogramo	kilo'gram'o
kilogramoj	kilo'gram'o'j
kilogramojn	kilo'gram'o'j'n
kilogramon	kilo'gram'o'n
kilometra	kilo'metr'a
kilometre	kilo'metr'e
kilometro	kilo'metr'o
kilometroj	kilo'metr'o'j
kilometrojn	kilo'metr'o'j'n
kilometron	kilo'metr'o'n
kilto	kilt'o
kimono	kimon'o
kimonon	kimon'o'n
kina	kin'a
kinaj	kin'a'j
kino	kin'o
kinoj	kin'o'j
kinon	kin'o'n
kinarto	kin'art'o
kineja	kin'ej'a
kinejaj	kin'ej'a'j
kinejen	kin'ej'e'n
kinejo	kin'ej'o
kinejoj	kin'ej'o'j
kinejojn	kin'ej'o'j'n
kinejon	kin'ej'o'n
kinfilmo	kin'film'o
kinfilmoj	kin'film'o'j
kinindustrio	kin'industri'o
kinoarto	kin'o'art'o
kinoartisto	kin'o'art'ist'o
kinofestivalo	kin'o'festival'o
kinofilmoj	kin'o'film'o'j
kinofilmon	kin'o'film'o'n
kinoindustrio	kin'o'industri'o
kinoreĝisoro	kin'o'reĝisor'o
kinematiko	kinematik'o
kinematografia	kinematograf'i'a
kinematografio	kinematograf'i'o
kineta	kinet'a
kinetaj	kinet'a'j
kinetajn	kinet'a'j'n
kinetan	kinet'a'n
kinetenergia	kinet'energi'a
kinetika	kinet'ik'a
kinetiko	kinet'ik'o
kinetikon	kinet'ik'o'n
kiom	kiom
kioma	kiom'a
kioman	kiom'a'n
kiomo	kiom'o
kiomaĝa	kiom'aĝ'a
kiomfoje	kiom'foj'e
kiomgrade	kiom'grad'e
kiomjara	kiom'jar'a
kiomofte	kiom'oft'e
kiosko	kiosk'o
kioskoj	kiosk'o'j
kioskojn	kiosk'o'j'n
kioskon	kiosk'o'n
kipra	kipr'a
kipraj	kipr'a'j
kipran	kipr'a'n
kipro	kipr'o
kipron	kipr'o'n
kipranoj	kipr'an'o'j
kirasa	kiras'a
kirasaj	kiras'a'j
kirasajn	kiras'a'j'n
kirasan	kiras'a'n
kiraso	kiras'o
kirasoj	kiras'o'j
kirason	kiras'o'n
kirasita	kiras'it'a
kirasitaj	kiras'it'a'j
kirasŝipo	kiras'ŝip'o
kiribato	kiribat'o
kirka	kirk'a
kirke	kirk'e
kirko	kirk'o
kirkoj	kirk'o'j
kirkojn	kirk'o'j'n
kirkon	kirk'o'n
kirla	kirl'a
kirlas	kirl'as
kirle	kirl'e
kirli	kirl'i
kirlis	kirl'is
kirlo	kirl'o
kirloj	kirl'o'j
kirlon	kirl'o'n
kirlu	kirl'u
kirlado	kirl'ad'o
kirlakvo	kirl'akv'o
kirlante	kirl'ant'e
kirliĝas	kirl'iĝ'as
kirliĝis	kirl'iĝ'is
kirliĝanta	kirl'iĝ'ant'a
kirlita	kirl'it'a
kirlofluoj	kirl'o'flu'o'j
kirurgo	kirurg'o
kirurgoj	kirurg'o'j
kirurgia	kirurg'i'a
kirurgiaj	kirurg'i'a'j
kirurgiajn	kirurg'i'a'j'n
kirurgian	kirurg'i'a'n
kirurgie	kirurg'i'e
kirurgio	kirurg'i'o
kirurgioj	kirurg'i'o'j
kirurgiojn	kirurg'i'o'j'n
kirurgion	kirurg'i'o'n
kisa	kis'a
kisas	kis'as
kisi	kis'i
kisis	kis'is
kiso	kis'o
kisoj	kis'o'j
kisojn	kis'o'j'n
kison	kis'o'n
kisos	kis'os
kisu	kis'u
kisus	kis'us
kisadis	kis'ad'is
kisado	kis'ad'o
kisanta	kis'ant'a
kisante	kis'ant'e
kisata	kis'at'a
kisinta	kis'int'a
kisinte	kis'int'e
kisita	kis'it'a
kitelo	kitel'o
kiteloj	kitel'o'j
kitelon	kitel'o'n
kiu	kiu
kiuj	kiu'j
kiun	kiu'n
kiucele	kiu'cel'e
kiudirekten	kiu'direkt'e'n
kiufrazo	kiu'fraz'o
kiufrazoj	kiu'fraz'o'j
kiugrade	kiu'grad'e
kiujn	kiu'j'n
kiukolora	kiu'kolor'a
kiumaniere	kiu'manier'e
kiva	kiv'a
kivon	kiv'o'n
kivio	kivi'o
kivioj	kivi'o'j
klabo	klab'o
klaboj	klab'o'j
klabon	klab'o'n
klaĉas	klaĉ'as
klaĉi	klaĉ'i
klaĉis	klaĉ'is
klaĉo	klaĉ'o
klaĉoj	klaĉ'o'j
klaĉojn	klaĉ'o'j'n
klaĉon	klaĉ'o'n
klaĉado	klaĉ'ad'o
klado	klad'o
kladoj	klad'o'j
kladon	klad'o'n
klakas	klak'as
klake	klak'e
klaki	klak'i
klakis	klak'is
klako	klak'o
klakoj	klak'o'j
klakojn	klak'o'j'n
klakon	klak'o'n
klaku	klak'u
klakadis	klak'ad'is
klakado	klak'ad'o
klakadon	klak'ad'o'n
klakanta	klak'ant'a
klakante	klak'ant'e
klaketo	klak'et'o
klaketoj	klak'et'o'j
klakfermis	klak'ferm'is
klana	klan'a
klanaj	klan'a'j
klano	klan'o
klanoj	klan'o'j
klanojn	klan'o'j'n
klanon	klan'o'n
klapo	klap'o
klapoj	klap'o'j
klapojn	klap'o'j'n
klapon	klap'o'n
klapeto	klap'et'o
klapetoj	klap'et'o'j
klapetojn	klap'et'o'j'n
klara	klar'a
klaraj	klar'a'j
klarajn	klar'a'j'n
klaran	klar'a'n
klaras	klar'as
klare	klar'e
klaris	klar'is
klaro	klar'o
klaros	klar'os
klareco	klar'ec'o
klarecon	klar'ec'o'n
klarega	klar'eg'a
klarege	klar'eg'e
klarejoj	klar'ej'o'j
klariga	klar'ig'a
klarigaj	klar'ig'a'j
klarigajn	klar'ig'a'j'n
klarigan	klar'ig'a'n
klarigas	klar'ig'as
klarige	klar'ig'e
klarigi	klar'ig'i
klarigis	klar'ig'is
klarigo	klar'ig'o
klarigoj	klar'ig'o'j
klarigojn	klar'ig'o'j'n
klarigon	klar'ig'o'n
klarigos	klar'ig'os
klarigu	klar'ig'u
klarigus	klar'ig'us
klarigado	klar'ig'ad'o
klariganta	klar'ig'ant'a
klarigantaj	klar'ig'ant'a'j
klarigantajn	klar'ig'ant'a'j'n
klarigantan	klar'ig'ant'a'n
klarigante	klar'ig'ant'e
klarigata	klar'ig'at'a
klarigebla	klar'ig'ebl'a
klarigeblaj	klar'ig'ebl'a'j
klarigeblas	klar'ig'ebl'as
klarigita	klar'ig'it'a
klarigitaj	klar'ig'it'a'j
klarigitajn	klar'ig'it'a'j'n
klarigite	klar'ig'it'e
klariĝas	klar'iĝ'as
klariĝis	klar'iĝ'is
klariĝos	klar'iĝ'os
klarlingvo	klar'lingv'o
klarteksto	klar'tekst'o
klarvida	klar'vid'a
klarvidaj	klar'vid'a'j
klarvide	klar'vid'e
klarvideco	klar'vid'ec'o
klariono	klarion'o
klarneto	klarnet'o
klarnetoj	klarnet'o'j
klarneton	klarnet'o'n
klasa	klas'a
klasaj	klas'a'j
klasajn	klas'a'j'n
klasan	klas'a'n
klasas	klas'as
klasi	klas'i
klaso	klas'o
klasoj	klas'o'j
klasojn	klas'o'j'n
klason	klas'o'n
klasado	klas'ad'o
klasadon	klas'ad'o'n
klasanoj	klas'an'o'j
klasata	klas'at'a
klasbatala	klas'batal'a
klasbatalo	klas'batal'o
klasbatalon	klas'batal'o'n
klasĉambro	klas'ĉambr'o
klasĉambroj	klas'ĉambr'o'j
klasĉambrojn	klas'ĉambr'o'j'n
klasĉambron	klas'ĉambr'o'n
klasigas	klas'ig'as
klasigi	klas'ig'i
klasigo	klas'ig'o
klasigoj	klas'ig'o'j
klasigilo	klas'ig'il'o
klasigiloj	klas'ig'il'o'j
klasigilon	klas'ig'il'o'n
klasigita	klas'ig'it'a
klasigitaj	klas'ig'it'a'j
klasiĝas	klas'iĝ'as
klasita	klas'it'a
klasitaj	klas'it'a'j
klasitajn	klas'it'a'j'n
klaskonflikto	klas'konflikt'o
klaskonscia	klas'konsci'a
klaskonsciaj	klas'konsci'a'j
klaskonscion	klas'konsci'o'n
klasoĉambro	klas'o'ĉambr'o
klasifika	klasifik'a
klasifikaj	klasifik'a'j
klasifikas	klasifik'as
klasifiki	klasifik'i
klasifikis	klasifik'is
klasifiko	klasifik'o
klasifikoj	klasifik'o'j
klasifikojn	klasifik'o'j'n
klasifikon	klasifik'o'n
klasifiku	klasifik'u
klasifikado	klasifik'ad'o
klasifikante	klasifik'ant'e
klasifikata	klasifik'at'a
klasifikataj	klasifik'at'a'j
klasifikgrupoj	klasifik'grup'o'j
klasifikiĝas	klasifik'iĝ'as
klasifikita	klasifik'it'a
klasifikitaj	klasifik'it'a'j
klasifikite	klasifik'it'e
klasifiksistemo	klasifik'sistem'o
klasifiksistemoj	klasifik'sistem'o'j
klasika	klasik'a
klasikaj	klasik'a'j
klasikajn	klasik'a'j'n
klasikan	klasik'a'n
klasike	klasik'e
klasiko	klasik'o
klasikaĵo	klasik'aĵ'o
klasikaĵoj	klasik'aĵ'o'j
klasikaĵojn	klasik'aĵ'o'j'n
klasikaĵon	klasik'aĵ'o'n
klasikisma	klasik'ism'a
klasikismo	klasik'ism'o
klasikistoj	klasik'ist'o'j
klasikmuzika	klasik'muzik'a
klasikmuzikaj	klasik'muzik'a'j
klasikulo	klasik'ul'o
klasikuloj	klasik'ul'o'j
klasikulojn	klasik'ul'o'j'n
klaŭdio	klaŭdi'o
klaŭno	klaŭn'o
klaŭnoj	klaŭn'o'j
klaŭnojn	klaŭn'o'j'n
klaŭnon	klaŭn'o'n
klaŭzo	klaŭz'o
klaŭzoj	klaŭz'o'j
klavas	klav'as
klavis	klav'is
klavo	klav'o
klavoj	klav'o'j
klavojn	klav'o'j'n
klavon	klav'o'n
klavara	klav'ar'a
klavaro	klav'ar'o
klavaroj	klav'ar'o'j
klavarojn	klav'ar'o'j'n
klavaron	klav'ar'o'n
klavararanĝo	klav'ar'aranĝ'o
klavarenpaĝigoj	klav'ar'en'paĝ'ig'o'j
klavarfasonon	klav'ar'fason'o'n
klavarinstrumento	klav'ar'instrument'o
klavarinstrumentoj	klav'ar'instrument'o'j
klavarskribo	klav'ar'skrib'o
klaviceno	klavicen'o
klaviklo	klavikl'o
klavikordo	klavikord'o
klemento	klement'o
klementino	klement'in'o
klementino	klementin'o
kleopatra	kleopatr'a
kleopatro	kleopatr'o
klepsidro	klepsidr'o
klera	kler'a
kleraj	kler'a'j
klerajn	kler'a'j'n
kleran	kler'a'n
klere	kler'e
klero	kler'o
kleron	kler'o'n
klereco	kler'ec'o
klerecon	kler'ec'o'n
kleriga	kler'ig'a
klerigaj	kler'ig'a'j
klerigajn	kler'ig'a'j'n
klerigan	kler'ig'a'n
klerigas	kler'ig'as
klerigi	kler'ig'i
klerigo	kler'ig'o
klerigon	kler'ig'o'n
klerigado	kler'ig'ad'o
klerigadon	kler'ig'ad'o'n
klerigejo	kler'ig'ej'o
klerigejoj	kler'ig'ej'o'j
klerigita	kler'ig'it'a
klerigitaj	kler'ig'it'a'j
kleriĝi	kler'iĝ'i
kleriĝo	kler'iĝ'o
klerisma	kler'ism'a
klerismo	kler'ism'o
klerismon	kler'ism'o'n
klerulo	kler'ul'o
kleruloj	kler'ul'o'j
klerulojn	kler'ul'o'j'n
klerulon	kler'ul'o'n
klerularo	kler'ul'ar'o
klerika	klerik'a
klerikaj	klerik'a'j
kleriko	klerik'o
klerikoj	klerik'o'j
klerikojn	klerik'o'j'n
klerikaro	klerik'ar'o
klerikuloj	klerik'ul'o'j
klerikala	klerikal'a
klerikalaj	klerikal'a'j
klienta	klient'a
klientaj	klient'a'j
klientajn	klient'a'j'n
klientan	klient'a'n
kliento	klient'o
klientoj	klient'o'j
klientojn	klient'o'j'n
klienton	klient'o'n
klientaro	klient'ar'o
klientaron	klient'ar'o'n
klientbazo	klient'baz'o
klientino	klient'in'o
klientserva	klient'serv'a
klientservado	klient'serv'ad'o
klientservadon	klient'serv'ad'o'n
klientservila	klient'serv'il'a
klientservila	klient'servil'a
klifa	klif'a
klifo	klif'o
klifoj	klif'o'j
klifojn	klif'o'j'n
klifon	klif'o'n
kliko	klik'o
klikoj	klik'o'j
klikon	klik'o'n
klimakso	klimaks'o
klimata	klimat'a
klimataj	klimat'a'j
klimatajn	klimat'a'j'n
klimatan	klimat'a'n
klimate	klimat'e
klimato	klimat'o
klimatoj	klimat'o'j
klimatojn	klimat'o'j'n
klimaton	klimat'o'n
klimatcirkonstancoj	klimat'cirkonstanc'o'j
klimatinĝenieristiko	klimat'inĝenier'ist'ik'o
klimatizilo	klimat'iz'il'o
klimatiziloj	klimat'iz'il'o'j
klimatizilojn	klimat'iz'il'o'j'n
klimatizilon	klimat'iz'il'o'n
klimatizita	klimat'iz'it'a
klimatmodeloj	klimat'model'o'j
klimatologoj	klimat'olog'o'j
klimatologio	klimat'olog'i'o
klimatscienco	klimat'scienc'o
klimatsistemo	klimat'sistem'o
klimatŝanĝa	klimat'ŝanĝ'a
klimatŝanĝaj	klimat'ŝanĝ'a'j
klimatŝanĝo	klimat'ŝanĝ'o
klimatŝanĝiĝo	klimat'ŝanĝ'iĝ'o
klimatzono	klimat'zon'o
klimatzonoj	klimat'zon'o'j
klina	klin'a
klinas	klin'as
kline	klin'e
klini	klin'i
klinis	klin'is
klino	klin'o
klinon	klin'o'n
klinos	klin'os
klinu	klin'u
klinado	klin'ad'o
klinadoj	klin'ad'o'j
klinadon	klin'ad'o'n
klinangulo	klin'angul'o
klinante	klin'ant'e
klinata	klin'at'a
klineco	klin'ec'o
kliniĝas	klin'iĝ'as
kliniĝi	klin'iĝ'i
kliniĝis	klin'iĝ'is
kliniĝo	klin'iĝ'o
kliniĝon	klin'iĝ'o'n
kliniĝu	klin'iĝ'u
kliniĝadis	klin'iĝ'ad'is
kliniĝanta	klin'iĝ'ant'a
kliniĝante	klin'iĝ'ant'e
kliniĝinta	klin'iĝ'int'a
kliniĝintaj	klin'iĝ'int'a'j
kliniĝinte	klin'iĝ'int'e
klininte	klin'int'e
klinita	klin'it'a
klinitaj	klin'it'a'j
klinitan	klin'it'a'n
klinite	klin'it'e
kliniteco	klin'it'ec'o
klingo	kling'o
klingoj	kling'o'j
klingojn	kling'o'j'n
klingon	kling'o'n
klingona	klingon'a
klingonan	klingon'a'n
klingono	klingon'o
klingonoj	klingon'o'j
klinika	klinik'a
klinikaj	klinik'a'j
klinikajn	klinik'a'j'n
klinikan	klinik'a'n
klinike	klinik'e
kliniko	klinik'o
klinikoj	klinik'o'j
klinikojn	klinik'o'j'n
klinikon	klinik'o'n
klinikisto	klinik'ist'o
klinikistoj	klinik'ist'o'j
klinko	klink'o
klinkon	klink'o'n
kliŝa	kliŝ'a
kliŝaj	kliŝ'a'j
kliŝo	kliŝ'o
kliŝoj	kliŝ'o'j
kliŝojn	kliŝ'o'j'n
klitora	klitor'a
klitoro	klitor'o
klitoron	klitor'o'n
kloaka	kloak'a
kloako	kloak'o
kloakoj	kloak'o'j
kloakojn	kloak'o'j'n
kloakon	kloak'o'n
kloakaĵo	kloak'aĵ'o
kloakaĵon	kloak'aĵ'o'n
kloakigo	kloak'ig'o
kloakigon	kloak'ig'o'n
klona	klon'a
kloni	klon'i
klono	klon'o
klonoj	klon'o'j
klonojn	klon'o'j'n
klonon	klon'o'n
klonado	klon'ad'o
klonadon	klon'ad'o'n
klonita	klon'it'a
klonitaj	klon'it'a'j
klopoda	klopod'a
klopodas	klopod'as
klopode	klopod'e
klopodi	klopod'i
klopodis	klopod'is
klopodo	klopod'o
klopodoj	klopod'o'j
klopodojn	klopod'o'j'n
klopodon	klopod'o'n
klopodos	klopod'os
klopodu	klopod'u
klopodus	klopod'us
klopodadas	klopod'ad'as
klopodadi	klopod'ad'i
klopodadis	klopod'ad'is
klopodado	klopod'ad'o
klopodadon	klopod'ad'o'n
klopodanta	klopod'ant'a
klopodantaj	klopod'ant'a'j
klopodante	klopod'ant'e
klopodegis	klopod'eg'is
klopodita	klopod'it'a
klora	klor'a
kloro	klor'o
kloron	klor'o'n
klorato	klor'at'o
kloratomoj	klor'atom'o'j
klorida	klor'id'a
kloridan	klor'id'a'n
klorido	klor'id'o
kloridoj	klor'id'o'j
kloridon	klor'id'o'n
klorito	klor'it'o
kloroacetata	klor'o'acet'at'a
kloroacetato	klor'o'acet'at'o
kloroplasto	klor'o'plast'o
kloroplastoj	klor'o'plast'o'j
kloroplastojn	klor'o'plast'o'j'n
klorofilo	klorofil'o
klorofilon	klorofil'o'n
kloroformo	kloroform'o
klostra	klostr'a
klostro	klostr'o
klostroj	klostr'o'j
klostron	klostr'o'n
kloŝo	kloŝ'o
kloŝoj	kloŝ'o'j
kloŝon	kloŝ'o'n
kluba	klub'a
klubaj	klub'a'j
kluban	klub'a'n
klubo	klub'o
kluboj	klub'o'j
klubojn	klub'o'j'n
klubon	klub'o'n
klubano	klub'an'o
klubanoj	klub'an'o'j
klubanojn	klub'an'o'j'n
klubejo	klub'ej'o
klubkunvenoj	klub'kun'ven'o'j
kluĉilo	kluĉ'il'o
kluĉilon	kluĉ'il'o'n
klukado	kluk'ad'o
kluzo	kluz'o
kluzoj	kluz'o'j
kluzon	kluz'o'n
kluzinstalaĵo	kluz'instal'aĵ'o
kluzinstalaĵon	kluz'instal'aĵ'o'n
knaba	knab'a
knabaj	knab'a'j
knaban	knab'a'n
knabo	knab'o
knaboj	knab'o'j
knabojn	knab'o'j'n
knabon	knab'o'n
knabaĉo	knab'aĉ'o
knabaĝo	knab'aĝ'o
knabeca	knab'ec'a
knabeco	knab'ec'o
knabego	knab'eg'o
knabeto	knab'et'o
knabetoj	knab'et'o'j
knabeton	knab'et'o'n
knabina	knab'in'a
knabinaj	knab'in'a'j
knabinajn	knab'in'a'j'n
knabinan	knab'in'a'n
knabino	knab'in'o
knabinoj	knab'in'o'j
knabinojn	knab'in'o'j'n
knabinon	knab'in'o'n
knabinaĉo	knab'in'aĉ'o
knabineco	knab'in'ec'o
knabineto	knab'in'et'o
knabinetoj	knab'in'et'o'j
knabineton	knab'in'et'o'n
knalado	knal'ad'o
knaras	knar'as
knaris	knar'is
knaro	knar'o
knarado	knar'ad'o
knaranta	knar'ant'a
knartamburo	knar'tambur'o
knedas	kned'as
knedi	kned'i
knedis	kned'is
knedu	kned'u
knedado	kned'ad'o
knedita	kned'it'a
koaguliĝo	koagul'iĝ'o
koaguliĝon	koagul'iĝ'o'n
koalicia	koalici'a
koaliciaj	koalici'a'j
koalician	koalici'a'n
koalicio	koalici'o
koalicioj	koalici'o'j
koaliciojn	koalici'o'j'n
koalicion	koalici'o'n
kobajo	kobaj'o
kobajoj	kobaj'o'j
kobajojn	kobaj'o'j'n
kobajon	kobaj'o'n
kobalta	kobalt'a
kobalto	kobalt'o
koboldo	kobold'o
koboldoj	kobold'o'j
koboldeto	kobold'et'o
kobro	kobr'o
koĉero	koĉer'o
koda	kod'a
kodas	kod'as
kodo	kod'o
kodoj	kod'o'j
kodojn	kod'o'j'n
kodon	kod'o'n
kodigas	kod'ig'as
kodigi	kod'ig'i
kodigis	kod'ig'is
kodigo	kod'ig'o
kodigado	kod'ig'ad'o
kodigadoj	kod'ig'ad'o'j
kodigadon	kod'ig'ad'o'n
kodiganta	kod'ig'ant'a
kodigante	kod'ig'ant'e
kodigilo	kod'ig'il'o
kodigiloj	kod'ig'il'o'j
kodigita	kod'ig'it'a
kodigitaj	kod'ig'it'a'j
kodigitan	kod'ig'it'a'n
kodilo	kod'il'o
kodita	kod'it'a
koditaj	kod'it'a'j
kodnomo	kod'nom'o
kodrompado	kod'romp'ad'o
kodvorto	kod'vort'o
kodvortoj	kod'vort'o'j
kodekso	kodeks'o
kodeksoj	kodeks'o'j
kodeksojn	kodeks'o'j'n
kodekson	kodeks'o'n
kodono	kodon'o
kodonoj	kodon'o'j
koeficiento	koeficient'o
koeficientoj	koeficient'o'j
koeficienton	koeficient'o'n
kofro	kofr'o
kofroj	kofr'o'j
kofrojn	kofr'o'j'n
kofron	kofr'o'n
kofreton	kofr'et'o'n
kofrujo	kofr'uj'o
kohera	koher'a
koheraj	koher'a'j
koherajn	koher'a'j'n
koheran	koher'a'n
koheras	koher'as
kohere	koher'e
kohero	koher'o
koheron	koher'o'n
kohereco	koher'ec'o
koherecon	koher'ec'o'n
kohorto	kohort'o
kohortoj	kohort'o'j
koincida	koincid'a
koincidaj	koincid'a'j
koincidas	koincid'as
koincide	koincid'e
koincidi	koincid'i
koincidis	koincid'is
koincido	koincid'o
koincidoj	koincid'o'j
koincidon	koincid'o'n
koincidos	koincid'os
koincidu	koincid'u
koincidus	koincid'us
koincidanta	koincid'ant'a
koincidantaj	koincid'ant'a'j
koincidante	koincid'ant'e
koiti	koit'i
koito	koit'o
kojlo	kojl'o
kojna	kojn'a
kojno	kojn'o
kojnoj	kojn'o'j
kojnon	kojn'o'n
kojnforma	kojn'form'a
kojnodentoj	kojn'o'dent'o'j
kojnoforma	kojn'o'form'a
kojnoformaj	kojn'o'form'a'j
kojnoskribo	kojn'o'skrib'o
kojnea	kojne'a
kojneo	kojne'o
kojoto	kojot'o
kojotoj	kojot'o'j
koka	kok'a
koko	kok'o
kokoj	kok'o'j
kokojn	kok'o'j'n
kokon	kok'o'n
kokaĵo	kok'aĵ'o
kokaĵon	kok'aĵ'o'n
kokeca	kok'ec'a
kokejo	kok'ej'o
koketa	kok'et'a
kokido	kok'id'o
kokidoj	kok'id'o'j
kokidojn	kok'id'o'j'n
kokidon	kok'id'o'n
kokidaĵo	kok'id'aĵ'o
kokidaĵon	kok'id'aĵ'o'n
kokina	kok'in'a
kokino	kok'in'o
kokinoj	kok'in'o'j
kokinojn	kok'in'o'j'n
kokinon	kok'in'o'n
kokinejo	kok'in'ej'o
kokoformaj	kok'o'form'a'j
kokao	koka'o
kokaino	kokain'o
kokainon	kokain'o'n
kokcinelo	kokcinel'o
kokcineloj	kokcinel'o'j
kokeriko	kokerik'o
koketa	koket'a
koketas	koket'as
kokete	koket'e
koketi	koket'i
koketeco	koket'ec'o
kokono	kokon'o
kokonon	kokon'o'n
kokosa	kokos'a
kokosaj	kokos'a'j
kokosan	kokos'a'n
kokoso	kokos'o
kokosoj	kokos'o'j
kokosarboj	kokos'arb'o'j
kokosinsuloj	kokos'insul'o'j
kokosnuksojn	kokos'nuks'o'j'n
kokosoleo	kokos'ole'o
kokospalmoj	kokos'palm'o'j
kokosujoj	kokos'uj'o'j
kokosujojn	kokos'uj'o'j'n
kokrita	kokr'it'a
kokso	koks'o
koksoj	koks'o'j
koksojn	koks'o'j'n
koksoartiko	koks'o'artik'o
koktelo	koktel'o
koktelon	koktel'o'n
kola	kol'a
kolo	kol'o
koloj	kol'o'j
kolojn	kol'o'j'n
kolon	kol'o'n
kolĉeno	kol'ĉen'o
kolĉenoj	kol'ĉen'o'j
kolĉenojn	kol'ĉen'o'j'n
kolĉenon	kol'ĉen'o'n
kolflankoj	kol'flank'o'j
kolharaj	kol'har'a'j
kolhararo	kol'har'ar'o
kolhararoj	kol'har'ar'o'j
kolhararon	kol'har'ar'o'n
kolringo	kol'ring'o
kolringon	kol'ring'o'n
koltuko	kol'tuk'o
koltukoj	kol'tuk'o'j
koltukojn	kol'tuk'o'j'n
koltukon	kol'tuk'o'n
kolumo	kol'um'o
kolumoj	kol'um'o'j
kolumojn	kol'um'o'j'n
kolumon	kol'um'o'n
kolao	kola'o
kolaon	kola'o'n
kolageno	kolagen'o
kolapsa	kolaps'a
kolapsas	kolaps'as
kolapsi	kolaps'i
kolapsis	kolaps'is
kolapso	kolaps'o
kolapsoj	kolaps'o'j
kolapson	kolaps'o'n
kolapsos	kolaps'os
kolapsus	kolaps'us
kolapsado	kolaps'ad'o
kolapsigas	kolaps'ig'as
kolapsigi	kolaps'ig'i
kolapsigis	kolaps'ig'is
kolbe	kolb'e
kolbo	kolb'o
kolbaso	kolbas'o
kolbasoj	kolbas'o'j
kolbasojn	kolbas'o'j'n
kolbason	kolbas'o'n
kolbasetoj	kolbas'et'o'j
kolĉido	kolĉid'o
kolĉidon	kolĉid'o'n
kolega	koleg'a
kolegaj	koleg'a'j
kolegajn	koleg'a'j'n
kolego	koleg'o
kolegoj	koleg'o'j
kolegojn	koleg'o'j'n
kolegon	koleg'o'n
kolegaro	koleg'ar'o
kolegaroreviziita	koleg'ar'o'revizi'it'a
kolegaroreviziitaj	koleg'ar'o'revizi'it'a'j
kolegeco	koleg'ec'o
kolegino	koleg'in'o
koleginoj	koleg'in'o'j
kolegia	kolegi'a
kolegiaj	kolegi'a'j
kolegio	kolegi'o
kolegioj	kolegi'o'j
kolegiojn	kolegi'o'j'n
kolegion	kolegi'o'n
kolegiata	kolegi'at'a
kolegiato	kolegi'at'o
kolegiostudantoj	kolegi'o'stud'ant'o'j
kolekta	kolekt'a
kolektaj	kolekt'a'j
kolektas	kolekt'as
kolekti	kolekt'i
kolektis	kolekt'is
kolekto	kolekt'o
kolektoj	kolekt'o'j
kolektojn	kolekt'o'j'n
kolekton	kolekt'o'n
kolektos	kolekt'os
kolektu	kolekt'u
kolektus	kolekt'us
kolektadis	kolekt'ad'is
kolektado	kolekt'ad'o
kolektadon	kolekt'ad'o'n
kolektaĵo	kolekt'aĵ'o
kolektaĵoj	kolekt'aĵ'o'j
kolektanta	kolekt'ant'a
kolektantaj	kolekt'ant'a'j
kolektante	kolekt'ant'e
kolektanto	kolekt'ant'o
kolektantoj	kolekt'ant'o'j
kolektantojn	kolekt'ant'o'j'n
kolektanton	kolekt'ant'o'n
kolektata	kolekt'at'a
kolektataj	kolekt'at'a'j
kolektebla	kolekt'ebl'a
kolekteblaj	kolekt'ebl'a'j
kolektejo	kolekt'ej'o
kolektiĝas	kolekt'iĝ'as
kolektiĝi	kolekt'iĝ'i
kolektiĝis	kolekt'iĝ'is
kolektiĝo	kolekt'iĝ'o
kolektiĝos	kolekt'iĝ'os
kolektiĝu	kolekt'iĝ'u
kolektindaĵoj	kolekt'ind'aĵ'o'j
kolektinta	kolekt'int'a
kolektinte	kolekt'int'e
kolektisto	kolekt'ist'o
kolektistoj	kolekt'ist'o'j
kolektita	kolekt'it'a
kolektitaj	kolekt'it'a'j
kolektitajn	kolekt'it'a'j'n
kolektitan	kolekt'it'a'n
kolektite	kolekt'it'e
kolektujo	kolekt'uj'o
kolektujoj	kolekt'uj'o'j
kolektiva	kolektiv'a
kolektivaj	kolektiv'a'j
kolektivajn	kolektiv'a'j'n
kolektivan	kolektiv'a'n
kolektive	kolektiv'e
kolektivo	kolektiv'o
kolektivoj	kolektiv'o'j
kolektivon	kolektiv'o'n
kolektiveco	kolektiv'ec'o
kolektivigo	kolektiv'ig'o
kolektivismo	kolektiv'ism'o
kolektivismon	kolektiv'ism'o'n
kolektivumo	kolektiv'um'o
kolektivumoj	kolektiv'um'o'j
kolektoro	kolektor'o
koleopteroj	koleopter'o'j
kolera	koler'a
koleraj	koler'a'j
kolerajn	koler'a'j'n
koleran	koler'a'n
koleras	koler'as
kolere	koler'e
koleri	koler'i
koleris	koler'is
kolero	koler'o
koleron	koler'o'n
koleros	koler'os
koleru	koler'u
kolerus	koler'us
kolerante	koler'ant'e
kolerega	koler'eg'a
koleregaj	koler'eg'a'j
koleregas	koler'eg'as
kolerege	koler'eg'e
koleregis	koler'eg'is
kolerego	koler'eg'o
koleregon	koler'eg'o'n
kolereksplodo	koler'eksplod'o
kolerema	koler'em'a
koleremo	koler'em'o
kolereta	koler'et'a
koleretas	koler'et'as
kolerigas	koler'ig'as
kolerigi	koler'ig'i
kolerigis	koler'ig'is
kolerigos	koler'ig'os
kolerigu	koler'ig'u
kolerigus	koler'ig'us
kolerigita	koler'ig'it'a
kolerigitaj	koler'ig'it'a'j
koleriĝas	koler'iĝ'as
koleriĝi	koler'iĝ'i
koleriĝis	koler'iĝ'is
koleriĝo	koler'iĝ'o
koleriĝos	koler'iĝ'os
koleriĝu	koler'iĝ'u
koleriĝema	koler'iĝ'em'a
koleriĝinta	koler'iĝ'int'a
kolesterolo	kolesterol'o
kolesterolon	kolesterol'o'n
kolĥozo	kolĥoz'o
kolĥozoj	kolĥoz'o'j
kolibro	kolibr'o
kolibroj	kolibr'o'j
koliero	kolier'o
kolieron	kolier'o'n
kolimbo	kolimb'o
kolimboj	kolimb'o'j
kolino	kolin'o
kolizia	kolizi'a
koliziaj	kolizi'a'j
kolizias	kolizi'as
kolizii	kolizi'i
koliziis	kolizi'is
kolizio	kolizi'o
kolizioj	kolizi'o'j
koliziojn	kolizi'o'j'n
kolizion	kolizi'o'n
koliziado	kolizi'ad'o
kolizianta	kolizi'ant'a
koliziante	kolizi'ant'e
kolkato	kolkat'o
kolofono	kolofon'o
koloida	koloid'a
koloidaj	koloid'a'j
kolokvo	kolokv'o
kolomba	kolomb'a
kolombo	kolomb'o
kolomboj	kolomb'o'j
kolombojn	kolomb'o'j'n
kolombon	kolomb'o'n
kolombano	kolomb'an'o
kolombeto	kolomb'et'o
kolombetoj	kolomb'et'o'j
kolombino	kolomb'in'o
kolombia	kolombi'a
kolombiaj	kolombi'a'j
kolombian	kolombi'a'n
kolombio	kolombi'o
kolombion	kolombi'o'n
kolombianoj	kolombi'an'o'j
kolona	kolon'a
kolonaj	kolon'a'j
kolono	kolon'o
kolonoj	kolon'o'j
kolonojn	kolon'o'j'n
kolonon	kolon'o'n
kolonaro	kolon'ar'o
kolonetoj	kolon'et'o'j
kolonelo	kolonel'o
koloneloj	kolonel'o'j
kolonelon	kolonel'o'n
kolonia	koloni'a
koloniaj	koloni'a'j
koloniajn	koloni'a'j'n
kolonian	koloni'a'n
kolonie	koloni'e
kolonii	koloni'i
kolonio	koloni'o
kolonioj	koloni'o'j
koloniojn	koloni'o'j'n
kolonion	koloni'o'n
koloniado	koloni'ad'o
koloniadon	koloni'ad'o'n
koloniano	koloni'an'o
kolonianoj	koloni'an'o'j
kolonianojn	koloni'an'o'j'n
koloniantoj	koloni'ant'o'j
koloniigas	koloni'ig'as
koloniigi	koloni'ig'i
koloniigis	koloni'ig'is
koloniigo	koloni'ig'o
koloniigon	koloni'ig'o'n
koloniigado	koloni'ig'ad'o
koloniigistoj	koloni'ig'ist'o'j
koloniigita	koloni'ig'it'a
koloniigitaj	koloni'ig'it'a'j
koloniisma	koloni'ism'a
koloniismaj	koloni'ism'a'j
koloniisman	koloni'ism'a'n
koloniismo	koloni'ism'o
koloniismon	koloni'ism'o'n
koloniistoj	koloni'ist'o'j
koloniita	koloni'it'a
kolonja	kolonj'a
kolonjo	kolonj'o
kolora	kolor'a
koloraj	kolor'a'j
kolorajn	kolor'a'j'n
koloran	kolor'a'n
koloras	kolor'as
kolore	kolor'e
kolori	kolor'i
koloro	kolor'o
koloroj	kolor'o'j
kolorojn	kolor'o'j'n
koloron	kolor'o'n
kolorado	kolor'ad'o
koloraro	kolor'ar'o
kolorbildo	kolor'bild'o
kolorbildoj	kolor'bild'o'j
kolorblinda	kolor'blind'a
kolorblindeco	kolor'blind'ec'o
koloreco	kolor'ec'o
kolorecon	kolor'ec'o'n
kolorfilmo	kolor'film'o
kolorigas	kolor'ig'as
kolorigi	kolor'ig'i
kolorigis	kolor'ig'is
kolorigo	kolor'ig'o
kolorigon	kolor'ig'o'n
kolorigado	kolor'ig'ad'o
kolorigaĵo	kolor'ig'aĵ'o
kolorigaĵoj	kolor'ig'aĵ'o'j
kolorigiloj	kolor'ig'il'o'j
kolorigita	kolor'ig'it'a
kolorigitaj	kolor'ig'it'a'j
kolorigitajn	kolor'ig'it'a'j'n
kolorigitan	kolor'ig'it'a'n
koloriĝas	kolor'iĝ'as
kolorilo	kolor'il'o
kolorita	kolor'it'a
koloritaj	kolor'it'a'j
kolorkombino	kolor'kombin'o
kolorkrajonoj	kolor'krajon'o'j
kolornuanco	kolor'nuanc'o
kolornuancoj	kolor'nuanc'o'j
kolorriĉa	kolor'riĉ'a
kolorriĉaj	kolor'riĉ'a'j
kolorruĝeco	kolor'ruĝ'ec'o
kolorskemo	kolor'skem'o
kolorsona	kolor'son'a
kolorspacoj	kolor'spac'o'j
kolorŝanĝo	kolor'ŝanĝ'o
kolorvido	kolor'vid'o
kolorvidado	kolor'vid'ad'o
kolorado	kolorad'o
koloradio	kolorad'i'o
kolosa	kolos'a
kolosaj	kolos'a'j
kolosajn	kolos'a'j'n
kolosan	kolos'a'n
kolose	kolos'e
koloso	kolos'o
koloseo	kolose'o
koloseon	kolose'o'n
kolportas	kolport'as
kolporti	kolport'i
kolportado	kolport'ad'o
kolportisto	kolport'ist'o
kolportistoj	kolport'ist'o'j
kolumna	kolumn'a
kolumno	kolumn'o
kolumnoj	kolumn'o'j
kolumnojn	kolumn'o'j'n
kolumnon	kolumn'o'n
kolumnisto	kolumn'ist'o
kolumnistoj	kolumn'ist'o'j
kolzo	kolz'o
komo	kom'o
komoj	kom'o'j
komojn	kom'o'j'n
komon	kom'o'n
komanda	komand'a
komandan	komand'a'n
komandas	komand'as
komandi	komand'i
komandis	komand'is
komando	komand'o
komandoj	komand'o'j
komandojn	komand'o'j'n
komandon	komand'o'n
komandado	komand'ad'o
komandanta	komand'ant'a
komandante	komand'ant'e
komandanto	komand'ant'o
komandantoj	komand'ant'o'j
komandantojn	komand'ant'o'j'n
komandanton	komand'ant'o'n
komandantaro	komand'ant'ar'o
komandejo	komand'ej'o
komandita	komand'it'a
komandlinio	komand'lini'o
komandita	komandit'a
komandoro	komandor'o
komarko	komark'o
komarkoj	komark'o'j
komato	komat'o
komaton	komat'o'n
kombas	komb'as
kombi	komb'i
kombis	komb'is
kombu	komb'u
kombado	komb'ad'o
kombilo	komb'il'o
kombiloj	komb'il'o'j
kombilon	komb'il'o'n
kombita	komb'it'a
kombitaj	komb'it'a'j
kombina	kombin'a
kombinaj	kombin'a'j
kombinan	kombin'a'n
kombinas	kombin'as
kombine	kombin'e
kombini	kombin'i
kombinis	kombin'is
kombino	kombin'o
kombinoj	kombin'o'j
kombinojn	kombin'o'j'n
kombinon	kombin'o'n
kombinu	kombin'u
kombinus	kombin'us
kombinado	kombin'ad'o
kombinaĵo	kombin'aĵ'o
kombinaĵoj	kombin'aĵ'o'j
kombinaĵojn	kombin'aĵ'o'j'n
kombinaĵon	kombin'aĵ'o'n
kombinanta	kombin'ant'a
kombinantaj	kombin'ant'a'j
kombinantan	kombin'ant'a'n
kombinante	kombin'ant'e
kombinata	kombin'at'a
kombinataj	kombin'at'a'j
kombineca	kombin'ec'a
kombinecaj	kombin'ec'a'j
kombiniĝas	kombin'iĝ'as
kombiniĝis	kombin'iĝ'is
kombiniĝo	kombin'iĝ'o
kombinita	kombin'it'a
kombinitaj	kombin'it'a'j
kombinitajn	kombin'it'a'j'n
kombinitan	kombin'it'a'n
kombinite	kombin'it'e
kombinatoriko	kombinatorik'o
kombineo	kombine'o
komedia	komedi'a
komediaj	komedi'a'j
komedian	komedi'a'n
komedio	komedi'o
komedioj	komedi'o'j
komediojn	komedi'o'j'n
komedion	komedi'o'n
komediisto	komedi'ist'o
komenca	komenc'a
komencaj	komenc'a'j
komencajn	komenc'a'j'n
komencan	komenc'a'n
komencas	komenc'as
komence	komenc'e
komenci	komenc'i
komencis	komenc'is
komenco	komenc'o
komencoj	komenc'o'j
komencojn	komenc'o'j'n
komencon	komenc'o'n
komencos	komenc'os
komencu	komenc'u
komencus	komenc'us
komencadis	komenc'ad'is
komencado	komenc'ad'o
komencanta	komenc'ant'a
komencantaj	komenc'ant'a'j
komencantajn	komenc'ant'a'j'n
komencantan	komenc'ant'a'n
komencante	komenc'ant'e
komencanto	komenc'ant'o
komencantoj	komenc'ant'o'j
komencantojn	komenc'ant'o'j'n
komencantino	komenc'ant'in'o
komencigi	komenc'ig'i
komencigis	komenc'ig'is
komenciĝas	komenc'iĝ'as
komenciĝi	komenc'iĝ'i
komenciĝis	komenc'iĝ'is
komenciĝo	komenc'iĝ'o
komenciĝon	komenc'iĝ'o'n
komenciĝos	komenc'iĝ'os
komenciĝu	komenc'iĝ'u
komenciĝus	komenc'iĝ'us
komenciĝanta	komenc'iĝ'ant'a
komenciĝantaj	komenc'iĝ'ant'a'j
komenciĝantan	komenc'iĝ'ant'a'n
komenciĝante	komenc'iĝ'ant'e
komenciĝinta	komenc'iĝ'int'a
komenciĝonta	komenc'iĝ'ont'a
komencinta	komenc'int'a
komencinte	komenc'int'e
komencintoj	komenc'int'o'j
komencita	komenc'it'a
komencitaj	komenc'it'a'j
komencitan	komenc'it'a'n
komencite	komenc'it'e
komencliteroj	komenc'liter'o'j
komenio	komeni'o
komentas	koment'as
komenti	koment'i
komentis	koment'is
komento	koment'o
komentoj	koment'o'j
komentojn	koment'o'j'n
komenton	koment'o'n
komentos	koment'os
komentu	koment'u
komentado	koment'ad'o
komentadoj	koment'ad'o'j
komentadon	koment'ad'o'n
komentaĵo	koment'aĵ'o
komentaĵoj	koment'aĵ'o'j
komentaĵojn	koment'aĵ'o'j'n
komentaĵon	koment'aĵ'o'n
komentante	koment'ant'e
komentanto	koment'ant'o
komentantoj	koment'ant'o'j
komentaro	koment'ar'o
komentaroj	koment'ar'o'j
komentisto	koment'ist'o
komentistoj	koment'ist'o'j
komentistojn	koment'ist'o'j'n
komentita	koment'it'a
komentitaj	koment'it'a'j
komentarias	komentari'as
komentarii	komentari'i
komentariis	komentari'is
komentario	komentari'o
komentarioj	komentari'o'j
komentariojn	komentari'o'j'n
komentarion	komentari'o'n
komentariistoj	komentari'ist'o'j
komerca	komerc'a
komercaj	komerc'a'j
komercajn	komerc'a'j'n
komercan	komerc'a'n
komercas	komerc'as
komerce	komerc'e
komerci	komerc'i
komercis	komerc'is
komerco	komerc'o
komercoj	komerc'o'j
komercojn	komerc'o'j'n
komercon	komerc'o'n
komercado	komerc'ad'o
komercadon	komerc'ad'o'n
komercadministracio	komerc'administraci'o
komercaĵo	komerc'aĵ'o
komercaĵoj	komerc'aĵ'o'j
komercaĵojn	komerc'aĵ'o'j'n
komercaĵon	komerc'aĵ'o'n
komercaktivecoj	komerc'aktiv'ec'o'j
komercanta	komerc'ant'a
komercante	komerc'ant'e
komercanto	komerc'ant'o
komercantoj	komerc'ant'o'j
komercbilanco	komerc'bilanc'o
komerccentro	komerc'centr'o
komercdistrikto	komerc'distrikt'o
komerceblaj	komerc'ebl'a'j
komercejo	komerc'ej'o
komercejoj	komerc'ej'o'j
komercentrepreno	komerc'entrepren'o
komercentreprenoj	komerc'entrepren'o'j
komercfoiroj	komerc'foir'o'j
komercigi	komerc'ig'i
komercigo	komerc'ig'o
komercigon	komerc'ig'o'n
komercigita	komerc'ig'it'a
komercigitaj	komerc'ig'it'a'j
komercilo	komerc'il'o
komercimposto	komerc'impost'o
komercimpostoj	komerc'impost'o'j
komercimpostojn	komerc'impost'o'j'n
komercinterkonsentoj	komerc'inter'konsent'o'j
komercinteresoj	komerc'interes'o'j
komercista	komerc'ist'a
komercisto	komerc'ist'o
komercistoj	komerc'ist'o'j
komercistojn	komerc'ist'o'j'n
komerciston	komerc'ist'o'n
komercistaro	komerc'ist'ar'o
komercita	komerc'it'a
komercitaj	komerc'it'a'j
komercklientoj	komerc'klient'o'j
komerclerteco	komerc'lert'ec'o
komercligoj	komerc'lig'o'j
komercmodelo	komerc'model'o
komercmodeloj	komerc'model'o'j
komercmodelon	komerc'model'o'n
komercpartnero	komerc'partner'o
komercpartneroj	komerc'partner'o'j
komercplano	komerc'plan'o
komercpraktikoj	komerc'praktik'o'j
komercprocezo	komerc'procez'o
komercprocezoj	komerc'procez'o'j
komercprocezojn	komerc'procez'o'j'n
komercreto	komerc'ret'o
komercrilatoj	komerc'rilat'o'j
komercsektoro	komerc'sektor'o
komercstacioj	komerc'staci'o'j
komerctransakcioj	komerc'transakci'o'j
komercvojo	komerc'voj'o
komercvojoj	komerc'voj'o'j
komercvojojn	komerc'voj'o'j'n
kometa	komet'a
kometaj	komet'a'j
kometo	komet'o
kometoj	komet'o'j
kometojn	komet'o'j'n
kometon	komet'o'n
komforta	komfort'a
komfortaj	komfort'a'j
komfortajn	komfort'a'j'n
komfortan	komfort'a'n
komfortas	komfort'as
komforte	komfort'e
komforto	komfort'o
komfortoj	komfort'o'j
komforton	komfort'o'n
komforteco	komfort'ec'o
komfortecon	komfort'ec'o'n
komfortigi	komfort'ig'i
komfortigis	komfort'ig'is
komika	komik'a
komikaj	komik'a'j
komikajn	komik'a'j'n
komikan	komik'a'n
komike	komik'e
komikisto	komik'ist'o
komikulo	komik'ul'o
komikuloj	komik'ul'o'j
komikso	komiks'o
komiksoj	komiks'o'j
komiksojn	komiks'o'j'n
komikson	komiks'o'n
kominterno	komintern'o
komisaro	komisar'o
komisaroj	komisar'o'j
komisaron	komisar'o'n
komisarejo	komisar'ej'o
komisariato	komisariat'o
komisias	komisi'as
komisii	komisi'i
komisiis	komisi'is
komisio	komisi'o
komisioj	komisi'o'j
komisiojn	komisi'o'j'n
komision	komisi'o'n
komisios	komisi'os
komisiado	komisi'ad'o
komisiita	komisi'it'a
komisiitaj	komisi'it'a'j
komisiite	komisi'it'e
komisiito	komisi'it'o
komisiitoj	komisi'it'o'j
komisiiton	komisi'it'o'n
komisiona	komision'a
komisionaj	komision'a'j
komisiono	komision'o
komisionoj	komision'o'j
komisionojn	komision'o'j'n
komisionon	komision'o'n
komisionano	komision'an'o
komisionanoj	komision'an'o'j
komisionestro	komision'estr'o
komitata	komitat'a
komitataj	komitat'a'j
komitatan	komitat'a'n
komitato	komitat'o
komitatoj	komitat'o'j
komitatojn	komitat'o'j'n
komitaton	komitat'o'n
komitatano	komitat'an'o
komitatanoj	komitat'an'o'j
komitatanojn	komitat'an'o'j'n
komitatanon	komitat'an'o'n
komitatkunsido	komitat'kun'sid'o
komitatkunsidoj	komitat'kun'sid'o'j
komizo	komiz'o
komizoj	komiz'o'j
komizon	komiz'o'n
komizino	komiz'in'o
komodo	komod'o
komodoro	komodor'o
komoroj	komor'o'j
kompakta	kompakt'a
kompaktaj	kompakt'a'j
kompaktajn	kompakt'a'j'n
kompaktan	kompakt'a'n
kompakte	kompakt'e
kompaktdisko	kompakt'disk'o
kompaktdiskoj	kompakt'disk'o'j
kompaktdiskon	kompakt'disk'o'n
kompakteco	kompakt'ec'o
kompaktigita	kompakt'ig'it'a
kompaktujo	kompakt'uj'o
kompano	kompan'o
kompanoj	kompan'o'j
kompanojn	kompan'o'j'n
kompania	kompani'a
kompanio	kompani'o
kompanioj	kompani'o'j
kompaniojn	kompani'o'j'n
kompanion	kompani'o'n
kompaniano	kompani'an'o
kompanianoj	kompani'an'o'j
kompara	kompar'a
komparaj	kompar'a'j
komparan	kompar'a'n
komparas	kompar'as
kompare	kompar'e
kompari	kompar'i
komparis	kompar'is
komparo	kompar'o
komparoj	kompar'o'j
komparojn	kompar'o'j'n
komparon	kompar'o'n
komparos	kompar'os
komparu	kompar'u
komparus	kompar'us
komparado	kompar'ad'o
komparanta	kompar'ant'a
komparante	kompar'ant'e
komparata	kompar'at'a
komparataj	kompar'at'a'j
komparebla	kompar'ebl'a
kompareblaj	kompar'ebl'a'j
kompareblajn	kompar'ebl'a'j'n
kompareblan	kompar'ebl'a'n
kompareblas	kompar'ebl'as
kompareble	kompar'ebl'e
komparilo	kompar'il'o
komparita	kompar'it'a
komparitaj	kompar'it'a'j
komparite	kompar'it'e
komparnormo	kompar'norm'o
komparnormoj	kompar'norm'o'j
komparativo	komparativ'o
kompartio	komparti'o
kompartianoj	komparti'an'o'j
kompaso	kompas'o
kompasoj	kompas'o'j
kompason	kompas'o'n
kompasdirektoj	kompas'direkt'o'j
kompata	kompat'a
kompataj	kompat'a'j
kompatan	kompat'a'n
kompatas	kompat'as
kompate	kompat'e
kompati	kompat'i
kompatis	kompat'is
kompato	kompat'o
kompaton	kompat'o'n
kompatos	kompat'os
kompatu	kompat'u
kompatante	kompat'ant'e
kompatema	kompat'em'a
kompatemaj	kompat'em'a'j
kompateman	kompat'em'a'n
kompateme	kompat'em'e
kompatemo	kompat'em'o
kompatemon	kompat'em'o'n
kompatinda	kompat'ind'a
kompatindaj	kompat'ind'a'j
kompatindajn	kompat'ind'a'j'n
kompatindan	kompat'ind'a'n
kompatinde	kompat'ind'e
kompatindulo	kompat'ind'ul'o
kompatinduloj	kompat'ind'ul'o'j
kompatindulino	kompat'ind'ul'in'o
kompendio	kompendi'o
kompensa	kompens'a
kompensaj	kompens'a'j
kompensan	kompens'a'n
kompensas	kompens'as
kompense	kompens'e
kompensi	kompens'i
kompensis	kompens'is
kompenso	kompens'o
kompensoj	kompens'o'j
kompensojn	kompens'o'j'n
kompenson	kompens'o'n
kompensos	kompens'os
kompensu	kompens'u
kompensus	kompens'us
kompensado	kompens'ad'o
kompensante	kompens'ant'e
kompensdevo	kompens'dev'o
kompensdevoj	kompens'dev'o'j
kompensdevojn	kompens'dev'o'j'n
kompensdevon	kompens'dev'o'n
kompensdevolimigo	kompens'dev'o'lim'ig'o
kompensita	kompens'it'a
kompensitaj	kompens'it'a'j
kompetenta	kompetent'a
kompetentaj	kompetent'a'j
kompetentajn	kompetent'a'j'n
kompetentan	kompetent'a'n
kompetentas	kompetent'as
kompetente	kompetent'e
kompetento	kompetent'o
kompetentoj	kompetent'o'j
kompetentojn	kompetent'o'j'n
kompetenton	kompetent'o'n
kompetenteco	kompetent'ec'o
kompetentecoj	kompetent'ec'o'j
kompetentecojn	kompetent'ec'o'j'n
kompetentecon	kompetent'ec'o'n
kompetentiga	kompetent'ig'a
kompetentigaj	kompetent'ig'a'j
kompetentulo	kompetent'ul'o
kompetentuloj	kompetent'ul'o'j
kompilas	kompil'as
kompili	kompil'i
kompilis	kompil'is
kompilo	kompil'o
kompiloj	kompil'o'j
kompilon	kompil'o'n
kompilu	kompil'u
kompilado	kompil'ad'o
kompilaĵo	kompil'aĵ'o
kompilaĵoj	kompil'aĵ'o'j
kompilante	kompil'ant'e
kompilanto	kompil'ant'o
kompililo	kompil'il'o
kompililoj	kompil'il'o'j
kompililojn	kompil'il'o'j'n
kompililon	kompil'il'o'n
kompilinto	kompil'int'o
kompilintoj	kompil'int'o'j
kompilita	kompil'it'a
kompilitaj	kompil'it'a'j
kompilitan	kompil'it'a'n
kompleksa	kompleks'a
kompleksaj	kompleks'a'j
kompleksajn	kompleks'a'j'n
kompleksan	kompleks'a'n
komplekse	kompleks'e
komplekso	kompleks'o
kompleksoj	kompleks'o'j
kompleksojn	kompleks'o'j'n
komplekson	kompleks'o'n
komplekseco	kompleks'ec'o
kompleksecoj	kompleks'ec'o'j
kompleksecojn	kompleks'ec'o'j'n
kompleksecon	kompleks'ec'o'n
kompleksecklasoj	kompleks'ec'klas'o'j
komplementa	komplement'a
komplementaj	komplement'a'j
komplementajn	komplement'a'j'n
komplementan	komplement'a'n
komplemente	komplement'e
komplemento	komplement'o
komplementoj	komplement'o'j
komplementojn	komplement'o'j'n
komplementon	komplement'o'n
komplementeco	komplement'ec'o
kompleta	komplet'a
kompletaj	komplet'a'j
kompletajn	komplet'a'j'n
kompletan	komplet'a'n
kompletas	komplet'as
komplete	komplet'e
kompleti	komplet'i
kompleto	komplet'o
kompletoj	komplet'o'j
kompletojn	komplet'o'j'n
kompleton	komplet'o'n
kompleteco	komplet'ec'o
kompletiga	komplet'ig'a
kompletigaj	komplet'ig'a'j
kompletigan	komplet'ig'a'n
kompletigas	komplet'ig'as
kompletige	komplet'ig'e
kompletigi	komplet'ig'i
kompletigis	komplet'ig'is
kompletigo	komplet'ig'o
kompletigoj	komplet'ig'o'j
kompletigon	komplet'ig'o'n
kompletigos	komplet'ig'os
kompletigu	komplet'ig'u
kompletigus	komplet'ig'us
kompletigado	komplet'ig'ad'o
kompletiganta	komplet'ig'ant'a
kompletigantaj	komplet'ig'ant'a'j
kompletigante	komplet'ig'ant'e
kompletigita	komplet'ig'it'a
kompletigitaj	komplet'ig'it'a'j
kompletigite	komplet'ig'it'e
kompletigota	komplet'ig'ot'a
kompletiĝas	komplet'iĝ'as
kompletiĝis	komplet'iĝ'is
kompletiĝo	komplet'iĝ'o
kompletiĝos	komplet'iĝ'os
kompleza	komplez'a
komplezaj	komplez'a'j
komplezan	komplez'a'n
kompleze	komplez'e
komplezi	komplez'i
komplezis	komplez'is
komplezo	komplez'o
komplezon	komplez'o'n
komplezos	komplez'os
komplezu	komplez'u
komplezema	komplez'em'a
komplezemo	komplez'em'o
komplico	komplic'o
komplicoj	komplic'o'j
kompliceco	komplic'ec'o
komplika	komplik'a
komplikaj	komplik'a'j
komplikajn	komplik'a'j'n
komplikan	komplik'a'n
komplikas	komplik'as
komplike	komplik'e
kompliki	komplik'i
komplikis	komplik'is
kompliko	komplik'o
kompliku	komplik'u
komplikaĵo	komplik'aĵ'o
komplikaĵoj	komplik'aĵ'o'j
komplikaĵojn	komplik'aĵ'o'j'n
komplikeco	komplik'ec'o
komplikecon	komplik'ec'o'n
komplikega	komplik'eg'a
komplikigas	komplik'ig'as
komplikiĝas	komplik'iĝ'as
komplikita	komplik'it'a
komplikitaj	komplik'it'a'j
komplikitan	komplik'it'a'n
komplimenti	kompliment'i
komplimentis	kompliment'is
komplimento	kompliment'o
komplimentoj	kompliment'o'j
komplimentojn	kompliment'o'j'n
komplimenton	kompliment'o'n
komplotas	komplot'as
komplotis	komplot'is
komploto	komplot'o
komplotoj	komplot'o'j
komplotojn	komplot'o'j'n
komploton	komplot'o'n
komplotantoj	komplot'ant'o'j
kompona	kompon'a
komponaj	kompon'a'j
komponan	kompon'a'n
komponas	kompon'as
komponi	kompon'i
komponis	kompon'is
kompono	kompon'o
komponado	kompon'ad'o
komponadon	kompon'ad'o'n
komponaĵo	kompon'aĵ'o
komponaĵoj	kompon'aĵ'o'j
komponaĵojn	kompon'aĵ'o'j'n
komponaĵon	kompon'aĵ'o'n
komponanto	kompon'ant'o
komponantoj	kompon'ant'o'j
komponantojn	kompon'ant'o'j'n
komponanton	kompon'ant'o'n
komponata	kompon'at'a
komponiĝas	kompon'iĝ'as
komponiĝo	kompon'iĝ'o
komponisto	kompon'ist'o
komponistoj	kompon'ist'o'j
komponistojn	kompon'ist'o'j'n
komponiston	kompon'ist'o'n
komponistino	kompon'ist'in'o
komponita	kompon'it'a
komponitaj	kompon'it'a'j
komponitajn	kompon'it'a'j'n
komponitan	kompon'it'a'n
komponanto	komponent'o
komponantoj	komponent'o'j
kompostado	kompost'ad'o
kompostadon	kompost'ad'o'n
komposteraroj	kompost'erar'o'j
kompostisto	kompost'ist'o
kompostita	kompost'it'a
kompoŝto	kompoŝt'o
kompoŝtado	kompoŝt'ad'o
kompoto	kompot'o
kompoton	kompot'o'n
kompozicia	kompozici'a
kompoziciaj	kompozici'a'j
kompozicio	kompozici'o
kompozicion	kompozici'o'n
kompozita	kompozit'a
kompozitaj	kompozit'a'j
komprena	kompren'a
komprenas	kompren'as
kompreni	kompren'i
komprenis	kompren'is
kompreno	kompren'o
komprenoj	kompren'o'j
komprenojn	kompren'o'j'n
komprenon	kompren'o'n
komprenos	kompren'os
komprenu	kompren'u
komprenus	kompren'us
komprenado	kompren'ad'o
komprenadon	kompren'ad'o'n
komprenanta	kompren'ant'a
komprenantaj	kompren'ant'a'j
komprenantan	kompren'ant'a'n
komprenante	kompren'ant'e
komprenata	kompren'at'a
komprenataj	kompren'at'a'j
komprenebla	kompren'ebl'a
kompreneblaj	kompren'ebl'a'j
kompreneblajn	kompren'ebl'a'j'n
kompreneblan	kompren'ebl'a'n
kompreneblas	kompren'ebl'as
kompreneble	kompren'ebl'e
kompreneblo	kompren'ebl'o
kompreneblon	kompren'ebl'o'n
komprenebleco	kompren'ebl'ec'o
komprenema	kompren'em'a
komprenemaj	kompren'em'a'j
kompreneman	kompren'em'a'n
kompreneme	kompren'em'e
komprenemo	kompren'em'o
komprenemon	kompren'em'o'n
komprenigas	kompren'ig'as
komprenigi	kompren'ig'i
komprenigis	kompren'ig'is
komprenigu	kompren'ig'u
kompreniĝas	kompren'iĝ'as
kompreniĝi	kompren'iĝ'i
kompreniĝo	kompren'iĝ'o
kompreniĝon	kompren'iĝ'o'n
kompreniĝado	kompren'iĝ'ad'o
kompreninta	kompren'int'a
kompreninte	kompren'int'e
komprenita	kompren'it'a
komprenitaj	kompren'it'a'j
komprenite	kompren'it'e
komprenkapablo	kompren'kapabl'o
komprenkapablon	kompren'kapabl'o'n
komprenpovon	kompren'pov'o'n
kompresoro	kompresor'o
kompresoroj	kompresor'o'j
kompresoron	kompresor'o'n
kompromisa	kompromis'a
kompromisan	kompromis'a'n
kompromise	kompromis'e
kompromisi	kompromis'i
kompromisis	kompromis'is
kompromiso	kompromis'o
kompromisoj	kompromis'o'j
kompromisojn	kompromis'o'j'n
kompromison	kompromis'o'n
kompromitas	kompromit'as
kompromiti	kompromit'i
kompromitis	kompromit'is
kompromitita	kompromit'it'a
kompundaĵoj	kompund'aĵ'o'j
komputa	komput'a
komputaj	komput'a'j
komputas	komput'as
komputi	komput'i
komputis	komput'is
komputada	komput'ad'a
komputado	komput'ad'o
komputadoj	komput'ad'o'j
komputadojn	komput'ad'o'j'n
komputadon	komput'ad'o'n
komputadokomplekseco	komput'ad'o'kompleks'ec'o
komputante	komput'ant'e
komputatoro	komput'ator'o
komputebla	komput'ebl'a
komputeblaj	komput'ebl'a'j
komputeblo	komput'ebl'o
komputforto	komput'fort'o
komputika	komput'ik'a
komputikaj	komput'ik'a'j
komputiko	komput'ik'o
komputikon	komput'ik'o'n
komputikistoj	komput'ik'ist'o'j
komputila	komput'il'a
komputilaj	komput'il'a'j
komputilajn	komput'il'a'j'n
komputilan	komput'il'a'n
komputile	komput'il'e
komputilo	komput'il'o
komputiloj	komput'il'o'j
komputilojn	komput'il'o'j'n
komputilon	komput'il'o'n
komputilanimacio	komput'il'animaci'o
komputilegoj	komput'il'eg'o'j
komputilgeneritfiguraĵo	komput'il'gener'it'figur'aĵ'o
komputilhelpata	komput'il'help'at'a
komputiligita	komput'il'ig'it'a
komputilindustrio	komput'il'industri'o
komputilisto	komput'il'ist'o
komputilistoj	komput'il'ist'o'j
komputilkontrolita	komput'il'kontrol'it'a
komputilkontrolitaj	komput'il'kontrol'it'a'j
komputillingvoj	komput'il'lingv'o'j
komputilludo	komput'il'lud'o
komputilludoj	komput'il'lud'o'j
komputilludojn	komput'il'lud'o'j'n
komputilmodeloj	komput'il'model'o'j
komputilprogramado	komput'il'program'ad'o
komputilscienco	komput'il'scienc'o
komputilsimulado	komput'il'simul'ad'o
komputilsimuladoj	komput'il'simul'ad'o'j
komputilsistemo	komput'il'sistem'o
komputilsistemoj	komput'il'sistem'o'j
komputilsistemojn	komput'il'sistem'o'j'n
komputilsistemon	komput'il'sistem'o'n
komputiluzantoj	komput'il'uz'ant'o'j
komputita	komput'it'a
komputitaj	komput'it'a'j
komputoscienco	komput'o'scienc'o
komputera	komputer'a
komputero	komputer'o
komputoro	komputor'o
komputoroj	komputor'o'j
komputoron	komputor'o'n
komuna	komun'a
komunaj	komun'a'j
komunajn	komun'a'j'n
komunan	komun'a'n
komunas	komun'as
komune	komun'e
komuno	komun'o
komunaĵo	komun'aĵ'o
komunaĵoj	komun'aĵ'o'j
komunaĵojn	komun'aĵ'o'j'n
komunaĵon	komun'aĵ'o'n
komuneco	komun'ec'o
komunecoj	komun'ec'o'j
komunecojn	komun'ec'o'j'n
komunecon	komun'ec'o'n
komunejo	komun'ej'o
komunentrepreno	komun'entrepren'o
komunisma	komun'ism'a
komunismaj	komun'ism'a'j
komunisman	komun'ism'a'n
komunismo	komun'ism'o
komunismon	komun'ism'o'n
komunista	komun'ist'a
komunistaj	komun'ist'a'j
komunistajn	komun'ist'a'j'n
komunistan	komun'ist'a'n
komunisto	komun'ist'o
komunistoj	komun'ist'o'j
komunistojn	komun'ist'o'j'n
komuniston	komun'ist'o'n
komunistpartio	komun'ist'parti'o
komunistregistaro	komun'ist'reg'ist'ar'o
komunkaso	komun'kas'o
komunkason	komun'kas'o'n
komunloĝejo	komun'loĝ'ej'o
komunnomo	komun'nom'o
komunnomoj	komun'nom'o'j
komunpaŝtejo	komun'paŝt'ej'o
komunpaŝtejon	komun'paŝt'ej'o'n
komunregnolandoj	komun'regn'o'land'o'j
komunuma	komun'um'a
komunumaj	komun'um'a'j
komunumajn	komun'um'a'j'n
komunuman	komun'um'a'n
komunume	komun'um'e
komunumo	komun'um'o
komunumoj	komun'um'o'j
komunumojn	komun'um'o'j'n
komunumon	komun'um'o'n
komunumanoj	komun'um'an'o'j
komunumaro	komun'um'ar'o
komunumaroj	komun'um'ar'o'j
komunumbazita	komun'um'baz'it'a
komunumbazitaj	komun'um'baz'it'a'j
komunumeco	komun'um'ec'o
komunumestro	komun'um'estr'o
komunumestroj	komun'um'estr'o'j
komunuza	komun'uz'a
komunuzaj	komun'uz'a'j
komunio	komuni'o
komunion	komuni'o'n
komunika	komunik'a
komunikaj	komunik'a'j
komunikajn	komunik'a'j'n
komunikan	komunik'a'n
komunikas	komunik'as
komuniki	komunik'i
komunikis	komunik'is
komuniko	komunik'o
komunikoj	komunik'o'j
komunikojn	komunik'o'j'n
komunikon	komunik'o'n
komunikos	komunik'os
komuniku	komunik'u
komunikus	komunik'us
komunikada	komunik'ad'a
komunikadaj	komunik'ad'a'j
komunikadan	komunik'ad'a'n
komunikadi	komunik'ad'i
komunikado	komunik'ad'o
komunikadoj	komunik'ad'o'j
komunikadojn	komunik'ad'o'j'n
komunikadon	komunik'ad'o'n
komunikadamaskomunikilaro	komunik'ad'amas'komunik'il'ar'o
komunikadaparatoj	komunik'ad'aparat'o'j
komunikadcentro	komunik'ad'centr'o
komunikadokapablecojn	komunik'ad'o'kapabl'ec'o'j'n
komunikadoteknologio	komunik'ad'o'teknologi'o
komunikadoteknologioj	komunik'ad'o'teknologi'o'j
komunikaĵo	komunik'aĵ'o
komunikaĵoj	komunik'aĵ'o'j
komunikaĵojn	komunik'aĵ'o'j'n
komunikaĵon	komunik'aĵ'o'n
komunikantaj	komunik'ant'a'j
komunikante	komunik'ant'e
komunikata	komunik'at'a
komunikema	komunik'em'a
komunikemaj	komunik'em'a'j
komunikiĝas	komunik'iĝ'as
komunikiĝi	komunik'iĝ'i
komunikiĝis	komunik'iĝ'is
komunikiĝo	komunik'iĝ'o
komunikilo	komunik'il'o
komunikiloj	komunik'il'o'j
komunikilojn	komunik'il'o'j'n
komunikilon	komunik'il'o'n
komunikisto	komunik'ist'o
komunikita	komunik'it'a
komunikitaj	komunik'it'a'j
komunikkanalo	komunik'kanal'o
komunikkanaloj	komunik'kanal'o'j
komuniklingvo	komunik'lingv'o
komuniksistemo	komunik'sistem'o
komuniksistemoj	komunik'sistem'o'j
komuta	komut'a
komutilo	komut'il'o
konan	kon'a'n
konas	kon'as
koni	kon'i
konis	kon'is
kono	kon'o
konoj	kon'o'j
konojn	kon'o'j'n
konon	kon'o'n
konos	kon'os
konu	kon'u
konus	kon'us
konado	kon'ad'o
konadon	kon'ad'o'n
konanta	kon'ant'a
konantaj	kon'ant'a'j
konante	kon'ant'e
konanto	kon'ant'o
konantoj	kon'ant'o'j
konaro	kon'ar'o
konata	kon'at'a
konataj	kon'at'a'j
konatajn	kon'at'a'j'n
konatan	kon'at'a'n
konatas	kon'at'as
konate	kon'at'e
konato	kon'at'o
konatoj	kon'at'o'j
konatojn	kon'at'o'j'n
konaton	kon'at'o'n
konataro	kon'at'ar'o
konateco	kon'at'ec'o
konatecon	kon'at'ec'o'n
konatigas	kon'at'ig'as
konatigi	kon'at'ig'i
konatigis	kon'at'ig'is
konatigos	kon'at'ig'os
konatigu	kon'at'ig'u
konatiĝas	kon'at'iĝ'as
konatiĝi	kon'at'iĝ'i
konatiĝis	kon'at'iĝ'is
konatiĝo	kon'at'iĝ'o
konatiĝon	kon'at'iĝ'o'n
konatiĝos	kon'at'iĝ'os
konatiĝu	kon'at'iĝ'u
konatino	kon'at'in'o
konatulo	kon'at'ul'o
konatuloj	kon'at'ul'o'j
konatulojn	kon'at'ul'o'j'n
konebla	kon'ebl'a
konebleco	kon'ebl'ec'o
konigas	kon'ig'as
konigi	kon'ig'i
konigis	kon'ig'is
konigo	kon'ig'o
konigon	kon'ig'o'n
konigos	kon'ig'os
konigu	kon'ig'u
konigante	kon'ig'ant'e
koniĝas	kon'iĝ'as
koniĝis	kon'iĝ'is
koninta	kon'int'a
koninte	kon'int'e
konita	kon'it'a
konitaj	kon'it'a'j
koncedas	konced'as
koncedi	konced'i
koncedis	konced'is
koncedo	konced'o
koncedoj	konced'o'j
koncedojn	konced'o'j'n
koncedos	konced'os
koncedu	konced'u
koncedus	konced'us
koncedante	konced'ant'e
koncedita	konced'it'a
konceditaj	konced'it'a'j
konceditan	konced'it'a'n
koncedite	konced'it'e
koncentra	koncentr'a
koncentraj	koncentr'a'j
koncentras	koncentr'as
koncentre	koncentr'e
koncentri	koncentr'i
koncentris	koncentr'is
koncentro	koncentr'o
koncentroj	koncentr'o'j
koncentru	koncentr'u
koncentrado	koncentr'ad'o
koncentraĵo	koncentr'aĵ'o
koncentraĵoj	koncentr'aĵ'o'j
koncentraĵon	koncentr'aĵ'o'n
koncentrante	koncentr'ant'e
koncentreco	koncentr'ec'o
koncentrejo	koncentr'ej'o
koncentrejoj	koncentr'ej'o'j
koncentrejojn	koncentr'ej'o'j'n
koncentrejon	koncentr'ej'o'n
koncentrigas	koncentr'ig'as
koncentrigi	koncentr'ig'i
koncentriĝas	koncentr'iĝ'as
koncentriĝi	koncentr'iĝ'i
koncentriĝis	koncentr'iĝ'is
koncentrigho	koncentr'iĝ'o
koncentriĝo	koncentr'iĝ'o
koncentriĝoj	koncentr'iĝ'o'j
koncentriĝojn	koncentr'iĝ'o'j'n
koncentriĝon	koncentr'iĝ'o'n
koncentriĝos	koncentr'iĝ'os
koncentriĝu	koncentr'iĝ'u
koncentriĝante	koncentr'iĝ'ant'e
koncentrita	koncentr'it'a
koncentritaj	koncentr'it'a'j
koncentritan	koncentr'it'a'n
koncentrite	koncentr'it'e
koncentriteco	koncentr'it'ec'o
koncepta	koncept'a
konceptaj	koncept'a'j
konceptan	koncept'a'n
konceptas	koncept'as
koncepte	koncept'e
koncepti	koncept'i
konceptis	koncept'is
koncepto	koncept'o
konceptoj	koncept'o'j
konceptojn	koncept'o'j'n
koncepton	koncept'o'n
konceptado	koncept'ad'o
konceptaro	koncept'ar'o
konceptarto	koncept'art'o
konceptata	koncept'at'a
konceptigo	koncept'ig'o
konceptigita	koncept'ig'it'a
konceptita	koncept'it'a
konceptitaj	koncept'it'a'j
koncerna	koncern'a
koncernaj	koncern'a'j
koncernajn	koncern'a'j'n
koncernan	koncern'a'n
koncernas	koncern'as
koncerne	koncern'e
koncerni	koncern'i
koncernis	koncern'is
koncerno	koncern'o
koncernoj	koncern'o'j
koncernos	koncern'os
koncernu	koncern'u
koncernus	koncern'us
koncernanta	koncern'ant'a
koncernantaj	koncern'ant'a'j
koncernantajn	koncern'ant'a'j'n
koncernantan	koncern'ant'a'n
koncernante	koncern'ant'e
koncernata	koncern'at'a
koncernataj	koncern'at'a'j
koncernato	koncern'at'o
koncernatoj	koncern'at'o'j
koncernatojn	koncern'at'o'j'n
koncernita	koncern'it'a
koncernitaj	koncern'it'a'j
koncernitajn	koncern'it'a'j'n
koncernitan	koncern'it'a'n
koncernite	koncern'it'e
koncerta	koncert'a
koncertaj	koncert'a'j
koncertajn	koncert'a'j'n
koncertan	koncert'a'n
koncertas	koncert'as
koncerti	koncert'i
koncertis	koncert'is
koncerto	koncert'o
koncertoj	koncert'o'j
koncertojn	koncert'o'j'n
koncerton	koncert'o'n
koncertos	koncert'os
koncertado	koncert'ad'o
koncertejo	koncert'ej'o
koncertejoj	koncert'ej'o'j
koncesia	koncesi'a
koncesio	koncesi'o
koncesioj	koncesi'o'j
koncesiojn	koncesi'o'j'n
koncesion	koncesi'o'n
koncesiulo	koncesi'ul'o
koncesiuloj	koncesi'ul'o'j
koncilia	koncili'a
konciliaj	koncili'a'j
koncilio	koncili'o
koncilioj	koncili'o'j
koncilion	koncili'o'n
koncilianoj	koncili'an'o'j
koncipa	koncip'a
koncipaj	koncip'a'j
koncipajn	koncip'a'j'n
koncipan	koncip'a'n
koncipas	koncip'as
koncipe	koncip'e
koncipi	koncip'i
koncipis	koncip'is
koncipo	koncip'o
koncipiĝo	koncip'iĝ'o
koncipita	koncip'it'a
koncipitaj	koncip'it'a'j
koncipoprevento	koncip'o'prevent'o
konciza	konciz'a
koncizaj	konciz'a'j
koncizajn	konciz'a'j'n
koncizan	konciz'a'n
koncize	konciz'e
koncizo	konciz'o
koncizeco	konciz'ec'o
koncizecon	konciz'ec'o'n
koncizigita	konciz'ig'it'a
konĉerto	konĉert'o
konĉertoj	konĉert'o'j
konĉertojn	konĉert'o'j'n
konĉerton	konĉert'o'n
kondamna	kondamn'a
kondamnas	kondamn'as
kondamni	kondamn'i
kondamnis	kondamn'is
kondamno	kondamn'o
kondamnoj	kondamn'o'j
kondamnojn	kondamn'o'j'n
kondamnon	kondamn'o'n
kondamnos	kondamn'os
kondamnu	kondamn'u
kondamnus	kondamn'us
kondamnado	kondamn'ad'o
kondamnanta	kondamn'ant'a
kondamnante	kondamn'ant'e
kondamnata	kondamn'at'a
kondamniĝis	kondamn'iĝ'is
kondamninda	kondamn'ind'a
kondamnita	kondamn'it'a
kondamnitaj	kondamn'it'a'j
kondamnitan	kondamn'it'a'n
kondamnito	kondamn'it'o
kondamnitoj	kondamn'it'o'j
kondamnitojn	kondamn'it'o'j'n
kondensas	kondens'as
kondensi	kondens'i
kondenso	kondens'o
kondensado	kondens'ad'o
kondensadon	kondens'ad'o'n
kondensaĵo	kondens'aĵ'o
kondensato	kondens'at'o
kondensiĝas	kondens'iĝ'as
kondensiĝo	kondens'iĝ'o
kondensilo	kondens'il'o
kondensiloj	kondens'il'o'j
kondensilojn	kondens'il'o'j'n
kondensilon	kondens'il'o'n
kondensita	kondens'it'a
kondicionalo	kondicional'o
kondicionaloj	kondicional'o'j
kondicionalon	kondicional'o'n
kondiĉa	kondiĉ'a
kondiĉaj	kondiĉ'a'j
kondiĉajn	kondiĉ'a'j'n
kondiĉan	kondiĉ'a'n
kondiĉas	kondiĉ'as
kondiĉe	kondiĉ'e
kondiĉi	kondiĉ'i
kondiĉis	kondiĉ'is
kondiĉo	kondiĉ'o
kondiĉoj	kondiĉ'o'j
kondiĉojn	kondiĉ'o'j'n
kondiĉon	kondiĉ'o'n
kondiĉigas	kondiĉ'ig'as
kondiĉigis	kondiĉ'ig'is
kondiĉigita	kondiĉ'ig'it'a
kondiĉigitaj	kondiĉ'ig'it'a'j
kondiĉigitan	kondiĉ'ig'it'a'n
kondiĉigite	kondiĉ'ig'it'e
kondiĉita	kondiĉ'it'a
kondiĉitaj	kondiĉ'it'a'j
kondimentoj	kondiment'o'j
kondimentojn	kondiment'o'j'n
kondolenca	kondolenc'a
kondolencas	kondolenc'as
kondolenci	kondolenc'i
kondolenco	kondolenc'o
kondolencojn	kondolenc'o'j'n
kondolencon	kondolenc'o'n
kondomo	kondom'o
kondomoj	kondom'o'j
kondomojn	kondom'o'j'n
kondomon	kondom'o'n
kondoro	kondor'o
konduka	konduk'a
kondukaj	konduk'a'j
kondukas	konduk'as
konduke	konduk'e
konduki	konduk'i
kondukis	konduk'is
konduko	konduk'o
kondukos	konduk'os
konduku	konduk'u
kondukus	konduk'us
kondukado	konduk'ad'o
kondukanta	konduk'ant'a
kondukantaj	konduk'ant'a'j
kondukantajn	konduk'ant'a'j'n
kondukantan	konduk'ant'a'n
kondukante	konduk'ant'e
kondukanto	konduk'ant'o
kondukantoj	konduk'ant'o'j
kondukata	konduk'at'a
kondukataj	konduk'at'a'j
kondukiĝis	konduk'iĝ'is
kondukilo	konduk'il'o
kondukiloj	konduk'il'o'j
kondukilojn	konduk'il'o'j'n
kondukinta	konduk'int'a
kondukisto	konduk'ist'o
kondukita	konduk'it'a
kondukitaj	konduk'it'a'j
kondukite	konduk'it'e
kondukpermesilon	konduk'permes'il'o'n
kondukta	kondukt'a
konduktaj	kondukt'a'j
konduktan	kondukt'a'n
konduktas	kondukt'as
konduktanto	kondukt'ant'o
kondukteco	kondukt'ec'o
konduktecon	kondukt'ec'o'n
konduktilo	kondukt'il'o
konduktiloj	kondukt'il'o'j
konduktiva	kondukt'iv'a
konduktivo	kondukt'iv'o
konduktivon	kondukt'iv'o'n
konduktoro	konduktor'o
konduktoroj	konduktor'o'j
konduktoron	konduktor'o'n
konduta	kondut'a
kondutaj	kondut'a'j
kondutajn	kondut'a'j'n
kondutas	kondut'as
kondute	kondut'e
konduti	kondut'i
kondutis	kondut'is
konduto	kondut'o
kondutoj	kondut'o'j
kondutojn	kondut'o'j'n
konduton	kondut'o'n
kondutos	kondut'os
kondutu	kondut'u
kondutus	kondut'us
kondutado	kondut'ad'o
kondutante	kondut'ant'e
kondutetiko	kondut'etik'o
kondutisma	kondut'ism'a
kondutismaj	kondut'ism'a'j
kondutismajn	kondut'ism'a'j'n
kondutisman	kondut'ism'a'n
kondutismo	kondut'ism'o
kondutmaniero	kondut'manier'o
kondutterapio	kondut'terapi'o
koneksa	koneks'a
koneksaj	koneks'a'j
koneksas	koneks'as
konekse	koneks'e
konekso	koneks'o
konekson	koneks'o'n
konekta	konekt'a
konektas	konekt'as
konekti	konekt'i
konektis	konekt'is
konekto	konekt'o
konektoj	konekt'o'j
konektojn	konekt'o'j'n
konekton	konekt'o'n
konektado	konekt'ad'o
konektanta	konekt'ant'a
konektata	konekt'at'a
konektataj	konekt'at'a'j
konektebla	konekt'ebl'a
konekteblaj	konekt'ebl'a'j
konektebleco	konekt'ebl'ec'o
konekteblecon	konekt'ebl'ec'o'n
konektiĝas	konekt'iĝ'as
konektiĝi	konekt'iĝ'i
konektiĝis	konekt'iĝ'is
konektilo	konekt'il'o
konektiloj	konekt'il'o'j
konektilojn	konekt'il'o'j'n
konektilon	konekt'il'o'n
konektita	konekt'it'a
konektitaj	konekt'it'a'j
konfederitoj	konfeder'it'o'j
konfederacia	konfederaci'a
konfederaciaj	konfederaci'a'j
konfederacio	konfederaci'o
konfederacioj	konfederaci'o'j
konfederacion	konfederaci'o'n
konfekcio	konfekci'o
konferenca	konferenc'a
konferencaj	konferenc'a'j
konferenco	konferenc'o
konferencoj	konferenc'o'j
konferencojn	konferenc'o'j'n
konferencon	konferenc'o'n
konferencado	konferenc'ad'o
konferencanoj	konferenc'an'o'j
konferencartikoloj	konferenc'artikol'o'j
konferencejo	konferenc'ej'o
konfesas	konfes'as
konfesi	konfes'i
konfesis	konfes'is
konfeso	konfes'o
konfesoj	konfes'o'j
konfesojn	konfes'o'j'n
konfeson	konfes'o'n
konfesos	konfes'os
konfesu	konfes'u
konfesus	konfes'us
konfesado	konfes'ad'o
konfesantaj	konfes'ant'a'j
konfesante	konfes'ant'e
konfesanto	konfes'ant'o
konfesantoj	konfes'ant'o'j
konfesata	konfes'at'a
konfesejo	konfes'ej'o
konfesinde	konfes'ind'e
konfesinta	konfes'int'a
konfesita	konfes'it'a
konfesitaj	konfes'it'a'j
konfesprenanto	konfes'pren'ant'o
konfesia	konfesi'a
konfesiaj	konfesi'a'j
konfesio	konfesi'o
konfesioj	konfesi'o'j
konfesiojn	konfesi'o'j'n
konfesion	konfesi'o'n
konfida	konfid'a
konfidas	konfid'as
konfide	konfid'e
konfidi	konfid'i
konfidis	konfid'is
konfido	konfid'o
konfidon	konfid'o'n
konfidos	konfid'os
konfidu	konfid'u
konfidus	konfid'us
konfidante	konfid'ant'e
konfidato	konfid'at'o
konfidita	konfid'it'a
konfiditaj	konfid'it'a'j
konfiditan	konfid'it'a'n
konfidulo	konfid'ul'o
konfidenca	konfidenc'a
konfidencaj	konfidenc'a'j
konfidencajn	konfidenc'a'j'n
konfidence	konfidenc'e
konfidenco	konfidenc'o
konfidencon	konfidenc'o'n
konfidenceco	konfidenc'ec'o
konfidencintervaloj	konfidenc'interval'o'j
konfiguro	konfigur'o
konfigurita	konfigur'it'a
konfiguracio	konfiguraci'o
konfiguracioj	konfiguraci'o'j
konfiguraciojn	konfiguraci'o'j'n
konfiguracion	konfiguraci'o'n
konfirma	konfirm'a
konfirman	konfirm'a'n
konfirmas	konfirm'as
konfirmi	konfirm'i
konfirmis	konfirm'is
konfirmo	konfirm'o
konfirmon	konfirm'o'n
konfirmos	konfirm'os
konfirmu	konfirm'u
konfirmado	konfirm'ad'o
konfirmanta	konfirm'ant'a
konfirmante	konfirm'ant'e
konfirmata	konfirm'at'a
konfirmebla	konfirm'ebl'a
konfirmeblaj	konfirm'ebl'a'j
konfirmiĝis	konfirm'iĝ'is
konfirmilo	konfirm'il'o
konfirmilon	konfirm'il'o'n
konfirmita	konfirm'it'a
konfirmitaj	konfirm'it'a'j
konfirmite	konfirm'it'e
konfirmacio	konfirmaci'o
konfiski	konfisk'i
konfiskis	konfisk'is
konfisko	konfisk'o
konfiskon	konfisk'o'n
konfiskado	konfisk'ad'o
konfiskante	konfisk'ant'e
konfiskita	konfisk'it'a
konfiskitaj	konfisk'it'a'j
konfiskitajn	konfisk'it'a'j'n
konfitaĵo	konfit'aĵ'o
konfitaĵoj	konfit'aĵ'o'j
konfitaĵojn	konfit'aĵ'o'j'n
konfitaĵon	konfit'aĵ'o'n
konflikta	konflikt'a
konfliktaj	konflikt'a'j
konfliktajn	konflikt'a'j'n
konfliktas	konflikt'as
konflikte	konflikt'e
konflikti	konflikt'i
konfliktis	konflikt'is
konflikto	konflikt'o
konfliktoj	konflikt'o'j
konfliktojn	konflikt'o'j'n
konflikton	konflikt'o'n
konfliktado	konflikt'ad'o
konfliktanta	konflikt'ant'a
konfliktantaj	konflikt'ant'a'j
konfliktantajn	konflikt'ant'a'j'n
konfliktsolvado	konflikt'solv'ad'o
konforma	konform'a
konformaj	konform'a'j
konformajn	konform'a'j'n
konforman	konform'a'n
konformas	konform'as
konforme	konform'e
konformi	konform'i
konformis	konform'is
konformo	konform'o
konformon	konform'o'n
konformos	konform'os
konformu	konform'u
konformeco	konform'ec'o
konformecon	konform'ec'o'n
konformigi	konform'ig'i
konformiĝas	konform'iĝ'as
konformiĝi	konform'iĝ'i
konformiĝu	konform'iĝ'u
konformismo	konform'ism'o
konformistoj	konform'ist'o'j
konfrontas	konfront'as
konfronti	konfront'i
konfronto	konfront'o
konfrontado	konfront'ad'o
konfrontiĝi	konfront'iĝ'i
konfrontiĝis	konfront'iĝ'is
konfrontiĝo	konfront'iĝ'o
konfrontiĝoj	konfront'iĝ'o'j
konfrontiĝon	konfront'iĝ'o'n
konfrontita	konfront'it'a
konfrontitaj	konfront'it'a'j
konfrontite	konfront'it'e
konfucea	konfuce'a
konfuceaj	konfuce'a'j
konfuceo	konfuce'o
konfuceon	konfuce'o'n
konfuceanismo	konfuce'an'ism'o
konfuceismo	konfuce'ism'o
konfuza	konfuz'a
konfuzaj	konfuz'a'j
konfuzajn	konfuz'a'j'n
konfuzan	konfuz'a'n
konfuzas	konfuz'as
konfuze	konfuz'e
konfuzi	konfuz'i
konfuzis	konfuz'is
konfuzo	konfuz'o
konfuzoj	konfuz'o'j
konfuzojn	konfuz'o'j'n
konfuzon	konfuz'o'n
konfuzos	konfuz'os
konfuzu	konfuz'u
konfuzado	konfuz'ad'o
konfuzaĵo	konfuz'aĵ'o
konfuzanta	konfuz'ant'a
konfuzantaj	konfuz'ant'a'j
konfuzante	konfuz'ant'e
konfuzata	konfuz'at'a
konfuzataj	konfuz'at'a'j
konfuzebla	konfuz'ebl'a
konfuziga	konfuz'ig'a
konfuzigas	konfuz'ig'as
konfuzigis	konfuz'ig'is
konfuziĝas	konfuz'iĝ'as
konfuziĝi	konfuz'iĝ'i
konfuziĝis	konfuz'iĝ'is
konfuziĝo	konfuz'iĝ'o
konfuziĝon	konfuz'iĝ'o'n
konfuziĝu	konfuz'iĝ'u
konfuziĝus	konfuz'iĝ'us
konfuzita	konfuz'it'a
konfuzitaj	konfuz'it'a'j
konfuzitan	konfuz'it'a'n
konfuzite	konfuz'it'e
konfuzia	konfuzi'a
konfuzio	konfuzi'o
konga	kong'a
kongaj	kong'a'j
kongo	kong'o
kongon	kong'o'n
kongolando	kong'o'land'o
konglomerato	konglomer'at'o
kongregacia	kongregaci'a
kongregacio	kongregaci'o
kongregacioj	kongregaci'o'j
kongregacion	kongregaci'o'n
kongresa	kongres'a
kongresaj	kongres'a'j
kongresajn	kongres'a'j'n
kongresan	kongres'a'n
kongresas	kongres'as
kongresi	kongres'i
kongresis	kongres'is
kongreso	kongres'o
kongresoj	kongres'o'j
kongresojn	kongres'o'j'n
kongreson	kongres'o'n
kongresos	kongres'os
kongresano	kongres'an'o
kongresanoj	kongres'an'o'j
kongresanojn	kongres'an'o'j'n
kongresanon	kongres'an'o'n
kongresanaro	kongres'an'ar'o
kongresejo	kongres'ej'o
kongresejoj	kongres'ej'o'j
kongresejon	kongres'ej'o'n
kongreseto	kongres'et'o
kongreslando	kongres'land'o
kongreslandoj	kongres'land'o'j
kongreslibro	kongres'libr'o
kongresloko	kongres'lok'o
kongreslokon	kongres'lok'o'n
kongresontoj	kongres'ont'o'j
kongrespartio	kongres'parti'o
kongrestemo	kongres'tem'o
kongresurbo	kongres'urb'o
kongrua	kongru'a
kongruaj	kongru'a'j
kongruajn	kongru'a'j'n
kongruan	kongru'a'n
kongruas	kongru'as
kongrue	kongru'e
kongrui	kongru'i
kongruis	kongru'is
kongruo	kongru'o
kongruu	kongru'u
kongruus	kongru'us
kongrueco	kongru'ec'o
kongruecon	kongru'ec'o'n
kongruigi	kongru'ig'i
konidioj	konidi'o'j
koniferaj	konifer'a'j
koniferoj	konifer'o'j
konjako	konjak'o
konjakon	konjak'o'n
konjekta	konjekt'a
konjektaj	konjekt'a'j
konjektan	konjekt'a'n
konjektas	konjekt'as
konjekti	konjekt'i
konjektis	konjekt'is
konjekto	konjekt'o
konjektoj	konjekt'o'j
konjektojn	konjekt'o'j'n
konjekton	konjekt'o'n
konjektu	konjekt'u
konjektante	konjekt'ant'e
konjekteble	konjekt'ebl'e
konjektita	konjekt'it'a
konjektitaj	konjekt'it'a'j
konjektite	konjekt'it'e
konjuga	konjug'a
konjugato	konjug'at'o
konjugita	konjug'it'a
konjugitaj	konjug'it'a'j
konjugacias	konjugaci'as
konjugacio	konjugaci'o
konjugacioj	konjugaci'o'j
konjugaciojn	konjugaci'o'j'n
konjugacion	konjugaci'o'n
konjunkcio	konjunkci'o
konjunkcioj	konjunkci'o'j
konjunkcion	konjunkci'o'n
konjunktivo	konjunktiv'o
konjunktivito	konjunktiv'it'o
konjunktura	konjunktur'a
konjunkturo	konjunktur'o
konka	konk'a
konko	konk'o
konkoj	konk'o'j
konkojn	konk'o'j'n
konkon	konk'o'n
konkana	konk'an'a
konkanoj	konk'an'o'j
konkava	konkav'a
konkavaj	konkav'a'j
konkavan	konkav'a'n
konkeras	konker'as
konkeri	konker'i
konkeris	konker'is
konkero	konker'o
konkeroj	konker'o'j
konkerojn	konker'o'j'n
konkeron	konker'o'n
konkeros	konker'os
konkeru	konker'u
konkerado	konker'ad'o
konkerante	konker'ant'e
konkeranto	konker'ant'o
konkerantoj	konker'ant'o'j
konkerebla	konker'ebl'a
konkerinte	konker'int'e
konkerinto	konker'int'o
konkerintoj	konker'int'o'j
konkerita	konker'it'a
konkeritaj	konker'it'a'j
konkeritajn	konker'it'a'j'n
konkistadoroj	konkistador'o'j
konklavo	konklav'o
konkluda	konklud'a
konkludas	konklud'as
konklude	konklud'e
konkludi	konklud'i
konkludis	konklud'is
konkludo	konklud'o
konkludoj	konklud'o'j
konkludojn	konklud'o'j'n
konkludon	konklud'o'n
konkludos	konklud'os
konkludu	konklud'u
konkludus	konklud'us
konkludado	konklud'ad'o
konkludante	konklud'ant'e
konkludiĝas	konklud'iĝ'as
konkludiĝis	konklud'iĝ'is
konkludita	konklud'it'a
konkluditaj	konklud'it'a'j
konkludite	konklud'it'e
konkorda	konkord'a
konkordas	konkord'as
konkorde	konkord'e
konkordo	konkord'o
konkordon	konkord'o'n
konkordato	konkord'at'o
konkordato	konkordat'o
konkreta	konkret'a
konkretaj	konkret'a'j
konkretajn	konkret'a'j'n
konkretan	konkret'a'n
konkrete	konkret'e
konkretaĵo	konkret'aĵ'o
konkretaĵoj	konkret'aĵ'o'j
konkreteco	konkret'ec'o
konkretigas	konkret'ig'as
konkretigi	konkret'ig'i
konkretigis	konkret'ig'is
konkretigo	konkret'ig'o
konkretiĝas	konkret'iĝ'as
konkubino	konkub'in'o
konkubinoj	konkub'in'o'j
konkubinojn	konkub'in'o'j'n
konkura	konkur'a
konkuraj	konkur'a'j
konkuras	konkur'as
konkure	konkur'e
konkuri	konkur'i
konkuris	konkur'is
konkuro	konkur'o
konkuroj	konkur'o'j
konkurojn	konkur'o'j'n
konkuron	konkur'o'n
konkuros	konkur'os
konkurado	konkur'ad'o
konkuradoj	konkur'ad'o'j
konkuradojn	konkur'ad'o'j'n
konkuradon	konkur'ad'o'n
konkuranta	konkur'ant'a
konkurantaj	konkur'ant'a'j
konkurantajn	konkur'ant'a'j'n
konkurante	konkur'ant'e
konkuranto	konkur'ant'o
konkurantoj	konkur'ant'o'j
konkurantojn	konkur'ant'o'j'n
konkuranton	konkur'ant'o'n
konkuremo	konkur'em'o
konkurjuro	konkur'jur'o
konkurenca	konkurenc'a
konkurencaj	konkurenc'a'j
konkurencan	konkurenc'a'n
konkurencas	konkurenc'as
konkurence	konkurenc'e
konkurenci	konkurenc'i
konkurencis	konkurenc'is
konkurenco	konkurenc'o
konkurencoj	konkurenc'o'j
konkurencon	konkurenc'o'n
konkurencantaj	konkurenc'ant'a'j
konkurencantoj	konkurenc'ant'o'j
konkurenculoj	konkurenc'ul'o'j
konkursa	konkurs'a
konkursaj	konkurs'a'j
konkursan	konkurs'a'n
konkursas	konkurs'as
konkursi	konkurs'i
konkursis	konkurs'is
konkurso	konkurs'o
konkursoj	konkurs'o'j
konkursojn	konkurs'o'j'n
konkurson	konkurs'o'n
konkursado	konkurs'ad'o
konkursaĵoj	konkurs'aĵ'o'j
konkursanto	konkurs'ant'o
konkursantoj	konkurs'ant'o'j
konkursaŭtoj	konkurs'aŭt'o'j
konkursejo	konkurs'ej'o
konkursejoj	konkurs'ej'o'j
konotacio	konotaci'o
konotacioj	konotaci'o'j
konotaciojn	konotaci'o'j'n
konotacion	konotaci'o'n
konrado	konrad'o
konscia	konsci'a
konsciaj	konsci'a'j
konsciajn	konsci'a'j'n
konscian	konsci'a'n
konscias	konsci'as
konscie	konsci'e
konscii	konsci'i
konsciis	konsci'is
konscio	konsci'o
konscioj	konsci'o'j
konscion	konsci'o'n
konscios	konsci'os
konsciu	konsci'u
konscius	konsci'us
konsciante	konsci'ant'e
konsciigas	konsci'ig'as
konsciigi	konsci'ig'i
konsciigis	konsci'ig'is
konsciigo	konsci'ig'o
konsciiĝas	konsci'iĝ'as
konsciiĝi	konsci'iĝ'i
konsciiĝis	konsci'iĝ'is
konsciiĝo	konsci'iĝ'o
konsciiĝon	konsci'iĝ'o'n
konsciiĝu	konsci'iĝ'u
konscienca	konscienc'a
konsciencaj	konscienc'a'j
konsciencan	konscienc'a'n
konscience	konscienc'e
konscienco	konscienc'o
konsciencoj	konscienc'o'j
konsciencojn	konscienc'o'j'n
konsciencon	konscienc'o'n
konscienceco	konscienc'ec'o
konsciencriproĉoj	konscienc'riproĉ'o'j
konsciencriproĉojn	konscienc'riproĉ'o'j'n
konsekras	konsekr'as
konsekri	konsekr'i
konsekris	konsekr'is
konsekro	konsekr'o
konsekron	konsekr'o'n
konsekrado	konsekr'ad'o
konsekrita	konsekr'it'a
konsekritaj	konsekr'it'a'j
konsekritajn	konsekr'it'a'j'n
konsekritan	konsekr'it'a'n
konsekvenca	konsekvenc'a
konsekvencaj	konsekvenc'a'j
konsekvencan	konsekvenc'a'n
konsekvence	konsekvenc'e
konsekvenco	konsekvenc'o
konsekvencoj	konsekvenc'o'j
konsekvencojn	konsekvenc'o'j'n
konsekvencon	konsekvenc'o'n
konsekvenceco	konsekvenc'ec'o
konsenta	konsent'a
konsentaj	konsent'a'j
konsentas	konsent'as
konsente	konsent'e
konsenti	konsent'i
konsentis	konsent'is
konsento	konsent'o
konsentoj	konsent'o'j
konsenton	konsent'o'n
konsentos	konsent'os
konsentu	konsent'u
konsentus	konsent'us
konsentado	konsent'ad'o
konsentante	konsent'ant'e
konsentigi	konsent'ig'i
konsentinta	konsent'int'a
konsentita	konsent'it'a
konsentitaj	konsent'it'a'j
konsentite	konsent'it'e
konserva	konserv'a
konservas	konserv'as
konservi	konserv'i
konservis	konserv'is
konservo	konserv'o
konservon	konserv'o'n
konservos	konserv'os
konservu	konserv'u
konservus	konserv'us
konservadaj	konserv'ad'a'j
konservadis	konserv'ad'is
konservado	konserv'ad'o
konservadon	konserv'ad'o'n
konservadekologio	konserv'ad'ekologi'o
konservadoiniciatoj	konserv'ad'o'iniciat'o'j
konservadoiniciatojn	konserv'ad'o'iniciat'o'j'n
konservaĵo	konserv'aĵ'o
konservaĵoj	konserv'aĵ'o'j
konservaĵojn	konserv'aĵ'o'j'n
konservanta	konserv'ant'a
konservantaj	konserv'ant'a'j
konservantan	konserv'ant'a'n
konservante	konserv'ant'e
konservanto	konserv'ant'o
konservantoj	konserv'ant'o'j
konservata	konserv'at'a
konservataj	konserv'at'a'j
konservatajn	konserv'at'a'j'n
konservebla	konserv'ebl'a
konserveblaj	konserv'ebl'a'j
konservejo	konserv'ej'o
konservejoj	konserv'ej'o'j
konservema	konserv'em'a
konservemaj	konserv'em'a'j
konservenda	konserv'end'a
konserviĝas	konserv'iĝ'as
konserviĝi	konserv'iĝ'i
konserviĝis	konserv'iĝ'is
konserviĝo	konserv'iĝ'o
konserviĝon	konserv'iĝ'o'n
konserviĝos	konserv'iĝ'os
konserviĝinta	konserv'iĝ'int'a
konserviĝintaj	konserv'iĝ'int'a'j
konservinta	konserv'int'a
konservisma	konserv'ism'a
konservismo	konserv'ism'o
konservisto	konserv'ist'o
konservistoj	konserv'ist'o'j
konservita	konserv'it'a
konservitaj	konserv'it'a'j
konservitajn	konserv'it'a'j'n
konservitan	konserv'it'a'n
konservite	konserv'it'e
konservitis	konserv'it'is
konservostatuso	konserv'o'status'o
konservota	konserv'ot'a
konservativa	konservativ'a
konservativaj	konservativ'a'j
konservativajn	konservativ'a'j'n
konservativan	konservativ'a'n
konservative	konservativ'e
konservativismo	konservativ'ism'o
konservativismon	konservativ'ism'o'n
konservativulo	konservativ'ul'o
konservativuloj	konservativ'ul'o'j
konservativulojn	konservativ'ul'o'j'n
konservatorio	konservatori'o
konservatorioj	konservatori'o'j
konservatorion	konservatori'o'n
konsideras	konsider'as
konsidere	konsider'e
konsideri	konsider'i
konsideris	konsider'is
konsidero	konsider'o
konsideroj	konsider'o'j
konsiderojn	konsider'o'j'n
konsideron	konsider'o'n
konsideros	konsider'os
konsideru	konsider'u
konsiderus	konsider'us
konsiderada	konsider'ad'a
konsiderado	konsider'ad'o
konsideradoj	konsider'ad'o'j
konsideradon	konsider'ad'o'n
konsideranta	konsider'ant'a
konsiderantaj	konsider'ant'a'j
konsiderante	konsider'ant'e
konsiderata	konsider'at'a
konsiderataj	konsider'at'a'j
konsideratas	konsider'at'as
konsiderate	konsider'at'e
konsiderebla	konsider'ebl'a
konsidereblaj	konsider'ebl'a'j
konsidereblas	konsider'ebl'as
konsiderenda	konsider'end'a
konsiderendas	konsider'end'as
konsideriĝas	konsider'iĝ'as
konsideriĝi	konsider'iĝ'i
konsideriĝis	konsider'iĝ'is
konsiderinda	konsider'ind'a
konsiderindaj	konsider'ind'a'j
konsiderindajn	konsider'ind'a'j'n
konsiderindan	konsider'ind'a'n
konsiderindas	konsider'ind'as
konsiderinde	konsider'ind'e
konsiderinte	konsider'int'e
konsiderita	konsider'it'a
konsideritaj	konsider'it'a'j
konsideritajn	konsider'it'a'j'n
konsideritan	konsider'it'a'n
konsiderite	konsider'it'e
konsiderota	konsider'ot'a
konsila	konsil'a
konsilaj	konsil'a'j
konsilajn	konsil'a'j'n
konsilan	konsil'a'n
konsilas	konsil'as
konsili	konsil'i
konsilis	konsil'is
konsilo	konsil'o
konsiloj	konsil'o'j
konsilojn	konsil'o'j'n
konsilon	konsil'o'n
konsilos	konsil'os
konsilu	konsil'u
konsilus	konsil'us
konsilado	konsil'ad'o
konsiladon	konsil'ad'o'n
konsilanta	konsil'ant'a
konsilantaj	konsil'ant'a'j
konsilantan	konsil'ant'a'n
konsilante	konsil'ant'e
konsilanto	konsil'ant'o
konsilantoj	konsil'ant'o'j
konsilantojn	konsil'ant'o'j'n
konsilanton	konsil'ant'o'n
konsilantara	konsil'ant'ar'a
konsilantaro	konsil'ant'ar'o
konsilantaroj	konsil'ant'ar'o'j
konsilantaron	konsil'ant'ar'o'n
konsilaro	konsil'ar'o
konsileto	konsil'et'o
konsiletoj	konsil'et'o'j
konsiletojn	konsil'et'o'j'n
konsileton	konsil'et'o'n
konsiliĝi	konsil'iĝ'i
konsiliĝis	konsil'iĝ'is
konsiliĝo	konsil'iĝ'o
konsilinda	konsil'ind'a
konsilindas	konsil'ind'as
konsilinde	konsil'ind'e
konsilisto	konsil'ist'o
konsilistoj	konsil'ist'o'j
konsilistojn	konsil'ist'o'j'n
konsiliston	konsil'ist'o'n
konsilistino	konsil'ist'in'o
konsilita	konsil'it'a
konsilitaj	konsil'it'a'j
konsilite	konsil'it'e
konsilia	konsili'a
konsiliaj	konsili'a'j
konsilio	konsili'o
konsilioj	konsili'o'j
konsiliojn	konsili'o'j'n
konsilion	konsili'o'n
konsiliano	konsili'an'o
konsilianoj	konsili'an'o'j
konsilistaro	konsili'star'o
konsista	konsist'a
konsistaj	konsist'a'j
konsistas	konsist'as
konsisti	konsist'i
konsistis	konsist'is
konsisto	konsist'o
konsiston	konsist'o'n
konsistos	konsist'os
konsistu	konsist'u
konsistus	konsist'us
konsistado	konsist'ad'o
konsistanta	konsist'ant'a
konsistantaj	konsist'ant'a'j
konsistantajn	konsist'ant'a'j'n
konsistantan	konsist'ant'a'n
konsistante	konsist'ant'e
konsisteroj	konsist'er'o'j
konsistiga	konsist'ig'a
konsistigaj	konsist'ig'a'j
konsistigajn	konsist'ig'a'j'n
konsistigas	konsist'ig'as
konsistigi	konsist'ig'i
konsistigis	konsist'ig'is
konsistigo	konsist'ig'o
konsistigos	konsist'ig'os
konsistigu	konsist'ig'u
konsistigus	konsist'ig'us
konsistigado	konsist'ig'ad'o
konsistiganta	konsist'ig'ant'a
konsistigantaj	konsist'ig'ant'a'j
konsistigante	konsist'ig'ant'e
konsistigita	konsist'ig'it'a
konsistigitaj	konsist'ig'it'a'j
konsistigitan	konsist'ig'it'a'n
konsistita	konsist'it'a
konsistenco	konsistenc'o
konsistencon	konsistenc'o'n
konsistorio	konsistori'o
konskriptitaj	konskript'it'a'j
konsola	konsol'a
konsolaj	konsol'a'j
konsolajn	konsol'a'j'n
konsolan	konsol'a'n
konsolas	konsol'as
konsole	konsol'e
konsoli	konsol'i
konsolis	konsol'is
konsolo	konsol'o
konsoloj	konsol'o'j
konsolon	konsol'o'n
konsolos	konsol'os
konsolu	konsol'u
konsolante	konsol'ant'e
konsolanto	konsol'ant'o
konsoliĝas	konsol'iĝ'as
konsoliĝis	konsol'iĝ'is
konsolita	konsol'it'a
konsonanco	konsonanc'o
konsonanta	konsonant'a
konsonantaj	konsonant'a'j
konsonanto	konsonant'o
konsonantoj	konsonant'o'j
konsonantojn	konsonant'o'j'n
konsonanton	konsonant'o'n
konsonantgrupo	konsonant'grup'o
konsonantgrupoj	konsonant'grup'o'j
konsonantgrupojn	konsonant'grup'o'j'n
konsonantletero	konsonant'leter'o
konsorcio	konsorci'o
konsorcioj	konsorci'o'j
konspira	konspir'a
konspiraj	konspir'a'j
konspirajn	konspir'a'j'n
konspiras	konspir'as
konspiri	konspir'i
konspiris	konspir'is
konspiro	konspir'o
konspiroj	konspir'o'j
konspiron	konspir'o'n
konspirado	konspir'ad'o
konspirantoj	konspir'ant'o'j
konspirantojn	konspir'ant'o'j'n
konstanca	konstanc'a
konstanco	konstanc'o
konstanta	konstant'a
konstantaj	konstant'a'j
konstantajn	konstant'a'j'n
konstantan	konstant'a'n
konstante	konstant'e
konstanto	konstant'o
konstantoj	konstant'o'j
konstantojn	konstant'o'j'n
konstanton	konstant'o'n
konstanteco	konstant'ec'o
konstantecon	konstant'ec'o'n
konstanteno	konstanten'o
konstantino	konstantin'o
konstantinon	konstantin'o'n
konstantinopola	konstantinopol'a
konstantinopolo	konstantinopol'o
konstantinopolon	konstantinopol'o'n
konstatas	konstat'as
konstati	konstat'i
konstatis	konstat'is
konstato	konstat'o
konstatoj	konstat'o'j
konstatojn	konstat'o'j'n
konstaton	konstat'o'n
konstatos	konstat'os
konstatu	konstat'u
konstatus	konstat'us
konstatante	konstat'ant'e
konstatebla	konstat'ebl'a
konstateblaj	konstat'ebl'a'j
konstateblas	konstat'ebl'as
konstateble	konstat'ebl'e
konstatinte	konstat'int'e
konstatita	konstat'it'a
konstatitaj	konstat'it'a'j
konstatite	konstat'it'e
konstelacio	konstelaci'o
konstelacioj	konstelaci'o'j
konstelaciojn	konstelaci'o'j'n
konstelacion	konstelaci'o'n
konsterna	konstern'a
konsternas	konstern'as
konsterne	konstern'e
konsternis	konstern'is
konsterno	konstern'o
konsternon	konstern'o'n
konsterniĝis	konstern'iĝ'is
konsterniĝo	konstern'iĝ'o
konsterniĝon	konstern'iĝ'o'n
konsternita	konstern'it'a
konsternitaj	konstern'it'a'j
konsternite	konstern'it'e
konstitua	konstitu'a
konstituas	konstitu'as
konstitui	konstitu'i
konstituis	konstitu'is
konstituantaj	konstitu'ant'a'j
konstituante	konstitu'ant'e
konstituantoj	konstitu'ant'o'j
konstituata	konstitu'at'a
konstituiga	konstitu'ig'a
konstituigaj	konstitu'ig'a'j
konstituita	konstitu'it'a
konstituitaj	konstitu'it'a'j
konstitucia	konstituci'a
konstituciaj	konstituci'a'j
konstituciajn	konstituci'a'j'n
konstitucian	konstituci'a'n
konstitucie	konstituci'e
konstitucio	konstituci'o
konstitucioj	konstituci'o'j
konstituciojn	konstituci'o'j'n
konstitucion	konstituci'o'n
konstituciiga	konstituci'ig'a
konstrua	konstru'a
konstruaj	konstru'a'j
konstruajn	konstru'a'j'n
konstruan	konstru'a'n
konstruas	konstru'as
konstrue	konstru'e
konstrui	konstru'i
konstruis	konstru'is
konstruo	konstru'o
konstruoj	konstru'o'j
konstruojn	konstru'o'j'n
konstruon	konstru'o'n
konstruos	konstru'os
konstruu	konstru'u
konstruus	konstru'us
konstruadi	konstru'ad'i
konstruadis	konstru'ad'is
konstruado	konstru'ad'o
konstruadoj	konstru'ad'o'j
konstruadon	konstru'ad'o'n
konstruaĵa	konstru'aĵ'a
konstruaĵaj	konstru'aĵ'a'j
konstruajho	konstru'aĵ'o
konstruaĵo	konstru'aĵ'o
konstruaĵoj	konstru'aĵ'o'j
konstruaĵojn	konstru'aĵ'o'j'n
konstruaĵon	konstru'aĵ'o'n
konstruaĵaro	konstru'aĵ'ar'o
konstruanta	konstru'ant'a
konstruantaj	konstru'ant'a'j
konstruante	konstru'ant'e
konstruanto	konstru'ant'o
konstruantoj	konstru'ant'o'j
konstruarto	konstru'art'o
konstruata	konstru'at'a
konstruataj	konstru'at'a'j
konstrubloko	konstru'blok'o
konstrubriketo	konstru'brik'et'o
konstrubriketoj	konstru'brik'et'o'j
konstrubriketojn	konstru'brik'et'o'j'n
konstruebla	konstru'ebl'a
konstrueblaj	konstru'ebl'a'j
konstruejo	konstru'ej'o
konstruejoj	konstru'ej'o'j
konstruejon	konstru'ej'o'n
konstruelemento	konstru'element'o
konstruelementoj	konstru'element'o'j
konstruentreprenoj	konstru'entrepren'o'j
konstruestro	konstru'estr'o
konstruestroj	konstru'estr'o'j
konstrufako	konstru'fak'o
konstrufazo	konstru'faz'o
konstrufazoj	konstru'faz'o'j
konstruformo	konstru'form'o
konstruformoj	konstru'form'o'j
konstruigas	konstru'ig'as
konstruigi	konstru'ig'i
konstruigis	konstru'ig'is
konstruiganto	konstru'ig'ant'o
konstruigita	konstru'ig'it'a
konstruiĝas	konstru'iĝ'as
konstruiĝi	konstru'iĝ'i
konstruiĝis	konstru'iĝ'is
konstruindustrio	konstru'industri'o
konstruinĝenieriko	konstru'inĝenier'ik'o
konstruinta	konstru'int'a
konstruintaj	konstru'int'a'j
konstruinto	konstru'int'o
konstruintoj	konstru'int'o'j
konstruismo	konstru'ism'o
konstruisto	konstru'ist'o
konstruistoj	konstru'ist'o'j
konstruita	konstru'it'a
konstruitaj	konstru'it'a'j
konstruitajn	konstru'it'a'j'n
konstruitan	konstru'it'a'n
konstruite	konstru'it'e
konstruitis	konstru'it'is
konstrukostoj	konstru'kost'o'j
konstrulaboro	konstru'labor'o
konstrulaboroj	konstru'labor'o'j
konstrulaborojn	konstru'labor'o'j'n
konstrulaboristo	konstru'labor'ist'o
konstrulaboristoj	konstru'labor'ist'o'j
konstruligno	konstru'lign'o
konstrulignoj	konstru'lign'o'j
konstrulignon	konstru'lign'o'n
konstruloko	konstru'lok'o
konstrumaniero	konstru'manier'o
konstrumanieroj	konstru'manier'o'j
konstrumateriala	konstru'material'a
konstrumaterialo	konstru'material'o
konstrumaterialoj	konstru'material'o'j
konstrumaterialojn	konstru'material'o'j'n
konstrumaterialon	konstru'material'o'n
konstruota	konstru'ot'a
konstruotaj	konstru'ot'a'j
konstrupartoj	konstru'part'o'j
konstrupreparis	konstru'prepar'is
konstrupreparita	konstru'prepar'it'a
konstruprojekto	konstru'projekt'o
konstruprojektoj	konstru'projekt'o'j
konstrustilo	konstru'stil'o
konstrutekniko	konstru'teknik'o
konstruteknikoj	konstru'teknik'o'j
konstrutipo	konstru'tip'o
konsula	konsul'a
konsulaj	konsul'a'j
konsulan	konsul'a'n
konsulo	konsul'o
konsuloj	konsul'o'j
konsulojn	konsul'o'j'n
konsulon	konsul'o'n
konsulejo	konsul'ej'o
konsulejoj	konsul'ej'o'j
konsulejon	konsul'ej'o'n
konsulta	konsult'a
konsultaj	konsult'a'j
konsultajn	konsult'a'j'n
konsultan	konsult'a'n
konsultas	konsult'as
konsulti	konsult'i
konsultis	konsult'is
konsulto	konsult'o
konsultoj	konsult'o'j
konsultojn	konsult'o'j'n
konsulton	konsult'o'n
konsultos	konsult'os
konsultu	konsult'u
konsultus	konsult'us
konsultado	konsult'ad'o
konsultadon	konsult'ad'o'n
konsultante	konsult'ant'e
konsultata	konsult'at'a
konsultebla	konsult'ebl'a
konsulteblaj	konsult'ebl'a'j
konsultejo	konsult'ej'o
konsultejon	konsult'ej'o'n
konsultiĝa	konsult'iĝ'a
konsultiĝo	konsult'iĝ'o
konsultiĝoj	konsult'iĝ'o'j
konsultinte	konsult'int'e
konsultisto	konsult'ist'o
konsultistoj	konsult'ist'o'j
konsultistojn	konsult'ist'o'j'n
konsultiston	konsult'ist'o'n
konsultita	konsult'it'a
konsultitaj	konsult'it'a'j
konsultverkoj	konsult'verk'o'j
konsuma	konsum'a
konsuman	konsum'a'n
konsumas	konsum'as
konsumi	konsum'i
konsumis	konsum'is
konsumo	konsum'o
konsumon	konsum'o'n
konsumos	konsum'os
konsumu	konsum'u
konsumado	konsum'ad'o
konsumadon	konsum'ad'o'n
konsumaĵoj	konsum'aĵ'o'j
konsumanta	konsum'ant'a
konsumantaj	konsum'ant'a'j
konsumante	konsum'ant'e
konsumanto	konsum'ant'o
konsumantoj	konsum'ant'o'j
konsumantojn	konsum'ant'o'j'n
konsumanton	konsum'ant'o'n
konsumantmerkato	konsum'ant'merkat'o
konsumata	konsum'at'a
konsumataj	konsum'at'a'j
konsumebla	konsum'ebl'a
konsumeblaj	konsum'ebl'a'j
konsumelektroniko	konsum'elektron'ik'o
konsumiĝas	konsum'iĝ'as
konsumiĝis	konsum'iĝ'is
konsumisma	konsum'ism'a
konsumismo	konsum'ism'o
konsumita	konsum'it'a
konsumitaj	konsum'it'a'j
konsumite	konsum'it'e
konsumvaroj	konsum'var'o'j
konsumvarojn	konsum'var'o'j'n
konto	kont'o
kontoj	kont'o'j
kontojn	kont'o'j'n
konton	kont'o'n
kontada	kont'ad'a
kontadaj	kont'ad'a'j
kontadajn	kont'ad'a'j'n
kontado	kont'ad'o
kontadon	kont'ad'o'n
kontisto	kont'ist'o
kontaĝa	kontaĝ'a
kontaĝaj	kontaĝ'a'j
kontaĝas	kontaĝ'as
kontaĝo	kontaĝ'o
kontakta	kontakt'a
kontaktaj	kontakt'a'j
kontaktas	kontakt'as
kontakte	kontakt'e
kontakti	kontakt'i
kontaktis	kontakt'is
kontakto	kontakt'o
kontaktoj	kontakt'o'j
kontaktojn	kontakt'o'j'n
kontakton	kontakt'o'n
kontaktos	kontakt'os
kontaktu	kontakt'u
kontaktus	kontakt'us
kontaktado	kontakt'ad'o
kontaktadon	kontakt'ad'o'n
kontaktalvoko	kontakt'al'vok'o
kontaktante	kontakt'ant'e
kontaktareo	kontakt'are'o
kontaktigi	kontakt'ig'i
kontaktiĝas	kontakt'iĝ'as
kontaktiĝi	kontakt'iĝ'i
kontaktiĝis	kontakt'iĝ'is
kontaktiĝo	kontakt'iĝ'o
kontaktiĝon	kontakt'iĝ'o'n
kontaktiĝos	kontakt'iĝ'os
kontaktiĝu	kontakt'iĝ'u
kontaktiĝema	kontakt'iĝ'em'a
kontaktiĝeman	kontakt'iĝ'em'a'n
kontaktilo	kontakt'il'o
kontaktiloj	kontakt'il'o'j
kontaktinformoj	kontakt'inform'o'j
kontaktita	kontakt'it'a
kontaktitaj	kontakt'it'a'j
kontaktlensoj	kontakt'lens'o'j
kontaktlensojn	kontakt'lens'o'j'n
kontanta	kontant'a
kontantan	kontant'a'n
kontante	kontant'e
kontantmono	kontant'mon'o
kontantmonon	kontant'mon'o'n
konteksta	kontekst'a
kontekstaj	kontekst'a'j
kontekstajn	kontekst'a'j'n
kontekstan	kontekst'a'n
konteksto	kontekst'o
kontekstoj	kontekst'o'j
kontempla	kontempl'a
kontemplas	kontempl'as
kontempli	kontempl'i
kontemplis	kontempl'is
kontemplo	kontempl'o
kontempladis	kontempl'ad'is
kontemplado	kontempl'ad'o
kontempladon	kontempl'ad'o'n
kontemplante	kontempl'ant'e
kontenera	kontener'a
kontenero	kontener'o
konteneroj	kontener'o'j
kontenerojn	kontener'o'j'n
kontenta	kontent'a
kontentaj	kontent'a'j
kontentajn	kontent'a'j'n
kontentan	kontent'a'n
kontentas	kontent'as
kontente	kontent'e
kontenti	kontent'i
kontentis	kontent'is
kontento	kontent'o
kontenton	kontent'o'n
kontentos	kontent'os
kontenteco	kontent'ec'o
kontentecon	kontent'ec'o'n
kontentiga	kontent'ig'a
kontentigaj	kontent'ig'a'j
kontentigajn	kontent'ig'a'j'n
kontentigan	kontent'ig'a'n
kontentigas	kontent'ig'as
kontentige	kontent'ig'e
kontentigi	kontent'ig'i
kontentigis	kontent'ig'is
kontentigo	kontent'ig'o
kontentigon	kontent'ig'o'n
kontentigos	kontent'ig'os
kontentigu	kontent'ig'u
kontentigus	kontent'ig'us
kontentigado	kontent'ig'ad'o
kontentiganta	kontent'ig'ant'a
kontentigante	kontent'ig'ant'e
kontentigebla	kontent'ig'ebl'a
kontentigita	kontent'ig'it'a
kontentigitaj	kontent'ig'it'a'j
kontentigite	kontent'ig'it'e
kontentiĝas	kontent'iĝ'as
kontentiĝi	kontent'iĝ'i
kontentiĝis	kontent'iĝ'is
kontentiĝo	kontent'iĝ'o
kontentiĝon	kontent'iĝ'o'n
kontentiĝos	kontent'iĝ'os
kontentiĝu	kontent'iĝ'u
kontestas	kontest'as
kontesti	kontest'i
kontestis	kontest'is
kontesto	kontest'o
kontestado	kontest'ad'o
kontestanto	kontest'ant'o
kontestata	kontest'at'a
kontestataj	kontest'at'a'j
kontestatajn	kontest'at'a'j'n
kontestatan	kontest'at'a'n
kontestate	kontest'at'e
kontestebla	kontest'ebl'a
kontestita	kontest'it'a
kontestitaj	kontest'it'a'j
kontinenta	kontinent'a
kontinentaj	kontinent'a'j
kontinentajn	kontinent'a'j'n
kontinentan	kontinent'a'n
kontinento	kontinent'o
kontinentoj	kontinent'o'j
kontinentojn	kontinent'o'j'n
kontinenton	kontinent'o'n
kontinentdeklivo	kontinent'dekliv'o
kontinentplatoj	kontinent'plat'o'j
kontingenco	kontingenc'o
kontingento	kontingent'o
kontingentoj	kontingent'o'j
kontingenton	kontingent'o'n
kontinua	kontinu'a
kontinuaj	kontinu'a'j
kontinuajn	kontinu'a'j'n
kontinuan	kontinu'a'n
kontinuas	kontinu'as
kontinue	kontinu'e
kontinui	kontinu'i
kontinuis	kontinu'is
kontinuo	kontinu'o
kontinuos	kontinu'os
kontinuaĵo	kontinu'aĵ'o
kontinueco	kontinu'ec'o
kontinuecon	kontinu'ec'o'n
kontinuigebla	kontinu'ig'ebl'a
kontinuigeblan	kontinu'ig'ebl'a'n
kontinukurenta	kontinu'kurent'a
kontinuumo	kontinu'um'o
kontinuumon	kontinu'um'o'n
kontoro	kontor'o
kontoron	kontor'o'n
kontoristo	kontor'ist'o
kontrabandi	kontraband'i
kontrabandis	kontraband'is
kontrabando	kontraband'o
kontrabandado	kontraband'ad'o
kontrabandadon	kontraband'ad'o'n
kontrabandisto	kontraband'ist'o
kontrabandistoj	kontraband'ist'o'j
kontrabandita	kontraband'it'a
kontrabaso	kontrabas'o
kontrabasoj	kontrabas'o'j
kontrabason	kontrabas'o'n
kontrabasisto	kontrabas'ist'o
kontrabasistoj	kontrabas'ist'o'j
kontrakta	kontrakt'a
kontraktaj	kontrakt'a'j
kontraktajn	kontrakt'a'j'n
kontraktas	kontrakt'as
kontrakte	kontrakt'e
kontrakti	kontrakt'i
kontraktis	kontrakt'is
kontrakto	kontrakt'o
kontraktoj	kontrakt'o'j
kontraktojn	kontrakt'o'j'n
kontrakton	kontrakt'o'n
kontraktado	kontrakt'ad'o
kontraktiĝas	kontrakt'iĝ'as
kontraktiĝi	kontrakt'iĝ'i
kontraktiĝis	kontrakt'iĝ'is
kontraktita	kontrakt'it'a
kontraktitaj	kontrakt'it'a'j
kontrapunkta	kontrapunkt'a
kontrapunktaj	kontrapunkt'a'j
kontrapunkto	kontrapunkt'o
kontrasta	kontrast'a
kontrastaj	kontrast'a'j
kontrastajn	kontrast'a'j'n
kontrastan	kontrast'a'n
kontrastas	kontrast'as
kontraste	kontrast'e
kontrasti	kontrast'i
kontrastis	kontrast'is
kontrasto	kontrast'o
kontrastoj	kontrast'o'j
kontrastojn	kontrast'o'j'n
kontraston	kontrast'o'n
kontrastado	kontrast'ad'o
kontrastante	kontrast'ant'e
kontrastiga	kontrast'ig'a
kontrastigaj	kontrast'ig'a'j
kontrastigas	kontrast'ig'as
kontrastigi	kontrast'ig'i
kontrastita	kontrast'it'a
kontrastitaj	kontrast'it'a'j
kontrau	kontraŭ
kontraŭ	kontraŭ
kontraua	kontraŭ'a
kontraŭa	kontraŭ'a
kontrauaj	kontraŭ'a'j
kontraŭaj	kontraŭ'a'j
kontraŭajn	kontraŭ'a'j'n
kontrauan	kontraŭ'a'n
kontraŭan	kontraŭ'a'n
kontrauas	kontraŭ'as
kontraŭas	kontraŭ'as
kontraue	kontraŭ'e
kontraŭe	kontraŭ'e
kontraŭen	kontraŭ'e'n
kontraŭi	kontraŭ'i
kontrauis	kontraŭ'is
kontraŭis	kontraŭ'is
kontraŭo	kontraŭ'o
kontraŭoj	kontraŭ'o'j
kontraŭon	kontraŭ'o'n
kontraŭos	kontraŭ'os
kontraŭu	kontraŭ'u
kontraŭus	kontraŭ'us
kontraŭado	kontraŭ'ad'o
kontraŭagas	kontraŭ'ag'as
kontraŭagi	kontraŭ'ag'i
kontraŭagis	kontraŭ'ag'is
kontraŭaĵo	kontraŭ'aĵ'o
kontraŭaĵoj	kontraŭ'aĵ'o'j
kontraŭaĵojn	kontraŭ'aĵ'o'j'n
kontraŭaĵon	kontraŭ'aĵ'o'n
kontraŭante	kontraŭ'ant'e
kontraŭantoj	kontraŭ'ant'o'j
kontraŭantibiotika	kontraŭ'antibiotik'a
kontraŭargumento	kontraŭ'argument'o
kontraŭargumentoj	kontraŭ'argument'o'j
kontraŭargumentojn	kontraŭ'argument'o'j'n
kontraŭargumenton	kontraŭ'argument'o'n
kontraŭatakis	kontraŭ'atak'is
kontraŭatako	kontraŭ'atak'o
kontraŭatakoj	kontraŭ'atak'o'j
kontraŭatakojn	kontraŭ'atak'o'j'n
kontraŭatakon	kontraŭ'atak'o'n
kontraŭaviadila	kontraŭ'aviad'il'a
kontraŭaviadilaj	kontraŭ'aviad'il'a'j
kontraŭbakteria	kontraŭ'bakteri'a
kontraubatalas	kontraŭ'batal'as
kontraŭbatalas	kontraŭ'batal'as
kontraubatali	kontraŭ'batal'i
kontraŭbatali	kontraŭ'batal'i
kontraŭbatalis	kontraŭ'batal'is
kontraŭbatalo	kontraŭ'batal'o
kontraŭbatalos	kontraŭ'batal'os
kontraŭbatalu	kontraŭ'batal'u
kontraŭbatalus	kontraŭ'batal'us
kontraŭbatalado	kontraŭ'batal'ad'o
kontraŭbatalanta	kontraŭ'batal'ant'a
kontraŭbatalantaj	kontraŭ'batal'ant'a'j
kontraŭbatalante	kontraŭ'batal'ant'e
kontraŭbatalita	kontraŭ'batal'it'a
kontraŭbatalitaj	kontraŭ'batal'it'a'j
kontraŭdira	kontraŭ'dir'a
kontraŭdiraj	kontraŭ'dir'a'j
kontraŭdirajn	kontraŭ'dir'a'j'n
kontraŭdiras	kontraŭ'dir'as
kontraŭdiri	kontraŭ'dir'i
kontraŭdiris	kontraŭ'dir'is
kontraŭdiro	kontraŭ'dir'o
kontraudiroj	kontraŭ'dir'o'j
kontraŭdiroj	kontraŭ'dir'o'j
kontraŭdirojn	kontraŭ'dir'o'j'n
kontraŭdiron	kontraŭ'dir'o'n
kontraŭdiros	kontraŭ'dir'os
kontraŭdiru	kontraŭ'dir'u
kontraŭdirus	kontraŭ'dir'us
kontraŭdirante	kontraŭ'dir'ant'e
kontraŭdirita	kontraŭ'dir'it'a
kontraŭdolorilo	kontraŭ'dolor'il'o
kontraŭdoloriloj	kontraŭ'dolor'il'o'j
kontraŭeco	kontraŭ'ec'o
kontraŭecoj	kontraŭ'ec'o'j
kontraŭecon	kontraŭ'ec'o'n
kontraŭeklezia	kontraŭ'eklezi'a
kontraŭekzemplo	kontraŭ'ekzempl'o
kontraŭfaŝisma	kontraŭ'faŝism'a
kontraŭfaŝismaj	kontraŭ'faŝism'a'j
kontraŭflua	kontraŭ'flu'a
kontraŭfluaj	kontraŭ'flu'a'j
kontraŭfluan	kontraŭ'flu'a'n
kontraŭflue	kontraŭ'flu'e
kontraŭfortaj	kontraŭ'fort'a'j
kontraŭforto	kontraŭ'fort'o
kontraŭfrapo	kontraŭ'frap'o
kontraŭfundamenta	kontraŭ'fundament'a
kontraŭgermana	kontraŭ'german'a
kontraŭhoma	kontraŭ'hom'a
kontraŭimperiisma	kontraŭ'imperi'ism'a
kontraŭimperiismo	kontraŭ'imperi'ism'o
kontraŭinflama	kontraŭ'inflam'a
kontraŭinflamaj	kontraŭ'inflam'a'j
kontraŭiniciatoj	kontraŭ'iniciat'o'j
kontraŭiniciatojn	kontraŭ'iniciat'o'j'n
kontraŭintuicia	kontraŭ'intuici'a
kontraŭislama	kontraŭ'islam'a
kontraŭita	kontraŭ'it'a
kontraŭjapana	kontraŭ'japan'a
kontraŭjuda	kontraŭ'jud'a
kontraŭjudaj	kontraŭ'jud'a'j
kontraŭjudismo	kontraŭ'jud'ism'o
kontraŭkancera	kontraŭ'kancer'a
kontraŭkanceraj	kontraŭ'kancer'a'j
kontraŭkapitalisma	kontraŭ'kapital'ism'a
kontraŭkatastrofa	kontraŭ'katastrof'a
kontraŭkatastrofan	kontraŭ'katastrof'a'n
kontraŭkolonia	kontraŭ'koloni'a
kontraŭkomunista	kontraŭ'komun'ist'a
kontraŭkomunistaj	kontraŭ'komun'ist'a'j
kontraŭkoncipa	kontraŭ'koncip'a
kontraŭkoncipaj	kontraŭ'koncip'a'j
kontraŭkoncipo	kontraŭ'koncip'o
kontraŭkoncipado	kontraŭ'koncip'ad'o
kontraŭkoncipilo	kontraŭ'koncip'il'o
kontraŭkoncipiloj	kontraŭ'koncip'il'o'j
kontraŭkoncipilojn	kontraŭ'koncip'il'o'j'n
kontraŭkonstitucia	kontraŭ'konstituci'a
kontraŭkonstituciaj	kontraŭ'konstituci'a'j
kontraŭkorupta	kontraŭ'korupt'a
kontraŭkristana	kontraŭ'krist'an'a
kontraŭkristanaj	kontraŭ'krist'an'a'j
kontraŭkultura	kontraŭ'kultur'a
kontraŭkulturo	kontraŭ'kultur'o
kontraŭleĝa	kontraŭ'leĝ'a
kontraŭleĝaj	kontraŭ'leĝ'a'j
kontraŭleĝajn	kontraŭ'leĝ'a'j'n
kontraŭleĝan	kontraŭ'leĝ'a'n
kontraŭleĝe	kontraŭ'leĝ'e
kontraŭleĝeco	kontraŭ'leĝ'ec'o
kontraŭlumo	kontraŭ'lum'o
kontraŭmetas	kontraŭ'met'as
kontraŭmetis	kontraŭ'met'is
kontraŭmilita	kontraŭ'milit'a
kontraŭmilitaj	kontraŭ'milit'a'j
kontraŭmisila	kontraŭ'misil'a
kontraŭmisilan	kontraŭ'misil'a'n
kontraŭnatura	kontraŭ'natur'a
kontraŭnuklea	kontraŭ'nukle'a
kontraŭnukleaj	kontraŭ'nukle'a'j
kontraŭofensivo	kontraŭ'ofensiv'o
kontraŭparalela	kontraŭ'paralel'a
kontraŭparalelaj	kontraŭ'paralel'a'j
kontraŭparto	kontraŭ'part'o
kontraŭpersonaj	kontraŭ'person'a'j
kontraŭpezi	kontraŭ'pez'i
kontraŭpezo	kontraŭ'pez'o
kontraŭpezilo	kontraŭ'pez'il'o
kontraŭpezilon	kontraŭ'pez'il'o'n
kontraŭpruvi	kontraŭ'pruv'i
kontraŭpruvita	kontraŭ'pruv'it'a
kontraŭreago	kontraŭ're'ag'o
kontraŭreagon	kontraŭ're'ag'o'n
kontraŭreformacio	kontraŭ'reformaci'o
kontraŭregistara	kontraŭ'reg'ist'ar'a
kontraŭregistaraj	kontraŭ'reg'ist'ar'a'j
kontraŭreligia	kontraŭ'religi'a
kontraŭreligiaj	kontraŭ'religi'a'j
kontraŭretrovirusa	kontraŭ'retro'virus'a
kontraŭretrovirusaj	kontraŭ'retro'virus'a'j
kontraŭrevolucia	kontraŭ'revoluci'a
kontraŭrevoluciaj	kontraŭ'revoluci'a'j
kontraŭrevolucio	kontraŭ'revoluci'o
kontraŭsecesia	kontraŭ'secesi'a
kontraŭsekso	kontraŭ'seks'o
kontraŭsimetria	kontraŭ'simetri'a
kontraŭsocia	kontraŭ'soci'a
kontraŭsovetia	kontraŭ'soveti'a
kontraŭspionado	kontraŭ'spion'ad'o
kontraŭstara	kontraŭ'star'a
kontraŭstaraj	kontraŭ'star'a'j
kontraŭstarajn	kontraŭ'star'a'j'n
kontraŭstaran	kontraŭ'star'a'n
kontraustaras	kontraŭ'star'as
kontraŭstaras	kontraŭ'star'as
kontraŭstare	kontraŭ'star'e
kontraustari	kontraŭ'star'i
kontraŭstari	kontraŭ'star'i
kontraŭstaris	kontraŭ'star'is
kontraustaro	kontraŭ'star'o
kontraŭstaro	kontraŭ'star'o
kontraŭstaroj	kontraŭ'star'o'j
kontraŭstarojn	kontraŭ'star'o'j'n
kontraŭstaron	kontraŭ'star'o'n
kontraŭstaros	kontraŭ'star'os
kontraŭstaru	kontraŭ'star'u
kontraŭstarus	kontraŭ'star'us
kontraŭstarado	kontraŭ'star'ad'o
kontraŭstaranta	kontraŭ'star'ant'a
kontraŭstarantaj	kontraŭ'star'ant'a'j
kontraŭstarantajn	kontraŭ'star'ant'a'j'n
kontraŭstarante	kontraŭ'star'ant'e
kontraŭstarigas	kontraŭ'star'ig'as
kontraŭstarigi	kontraŭ'star'ig'i
kontraŭtanka	kontraŭ'tank'a
kontraŭtankaj	kontraŭ'tank'a'j
kontraŭtertrema	kontraŭ'ter'trem'a
kontraŭterorisma	kontraŭ'teror'ism'a
kontraŭterorismaj	kontraŭ'teror'ism'a'j
kontraŭterorisman	kontraŭ'teror'ism'a'n
kontraŭterorismo	kontraŭ'teror'ism'o
kontraŭtumultaj	kontraŭ'tumult'a'j
kontraŭturkaj	kontraŭ'turk'a'j
kontrauulo	kontraŭ'ul'o
kontraŭulo	kontraŭ'ul'o
kontrauuloj	kontraŭ'ul'o'j
kontraŭuloj	kontraŭ'ul'o'j
kontraŭulojn	kontraŭ'ul'o'j'n
kontraŭulon	kontraŭ'ul'o'n
kontraŭusonaj	kontraŭ'uson'a'j
kontraŭvarma	kontraŭ'varm'a
kontraŭveneno	kontraŭ'venen'o
kontraŭvenenon	kontraŭ'venen'o'n
kontraŭvirusa	kontraŭ'virus'a
kontraŭvirusilo	kontraŭ'virus'il'o
kontraŭvola	kontraŭ'vol'a
kontraŭvolaj	kontraŭ'vol'a'j
kontraŭvolan	kontraŭ'vol'a'n
kontraŭvole	kontraŭ'vol'e
kontreo	kontre'o
kontreon	kontre'o'n
kontribuas	kontribu'as
kontribui	kontribu'i
kontribuis	kontribu'is
kontribuo	kontribu'o
kontribuoj	kontribu'o'j
kontribuojn	kontribu'o'j'n
kontribuon	kontribu'o'n
kontribuos	kontribu'os
kontribuu	kontribu'u
kontribuus	kontribu'us
kontribuado	kontribu'ad'o
kontribuadon	kontribu'ad'o'n
kontribuaĵo	kontribu'aĵ'o
kontribuaĵoj	kontribu'aĵ'o'j
kontribuaĵojn	kontribu'aĵ'o'j'n
kontribuaĵon	kontribu'aĵ'o'n
kontribuanta	kontribu'ant'a
kontribuantaj	kontribu'ant'a'j
kontribuante	kontribu'ant'e
kontribuanto	kontribu'ant'o
kontribuantoj	kontribu'ant'o'j
kontribuantojn	kontribu'ant'o'j'n
kontribuintoj	kontribu'int'o'j
kontribuita	kontribu'it'a
kontribuitaj	kontribu'it'a'j
kontribuite	kontribu'it'e
kontribucio	kontribuci'o
kontribucion	kontribuci'o'n
kontrola	kontrol'a
kontrolaj	kontrol'a'j
kontrolajn	kontrol'a'j'n
kontrolan	kontrol'a'n
kontrolas	kontrol'as
kontroli	kontrol'i
kontrolis	kontrol'is
kontrolo	kontrol'o
kontroloj	kontrol'o'j
kontrolojn	kontrol'o'j'n
kontrolon	kontrol'o'n
kontrolos	kontrol'os
kontrolu	kontrol'u
kontrolus	kontrol'us
kontrolado	kontrol'ad'o
kontroladon	kontrol'ad'o'n
kontrolanta	kontrol'ant'a
kontrolantaj	kontrol'ant'a'j
kontrolante	kontrol'ant'e
kontrolanto	kontrol'ant'o
kontrolantoj	kontrol'ant'o'j
kontrolata	kontrol'at'a
kontrolataj	kontrol'at'a'j
kontrolebla	kontrol'ebl'a
kontroleblaj	kontrol'ebl'a'j
kontrolejo	kontrol'ej'o
kontrolgrupo	kontrol'grup'o
kontroligi	kontrol'ig'i
kontrolilo	kontrol'il'o
kontroliloj	kontrol'il'o'j
kontrolinstanco	kontrol'instanc'o
kontrolinterfacoj	kontrol'inter'fac'o'j
kontrolisto	kontrol'ist'o
kontrolistoj	kontrol'ist'o'j
kontrolistojn	kontrol'ist'o'j'n
kontroliston	kontrol'ist'o'n
kontrolita	kontrol'it'a
kontrolitaj	kontrol'it'a'j
kontrolitajn	kontrol'it'a'j'n
kontrolitan	kontrol'it'a'n
kontrolite	kontrol'it'e
kontrolpanelo	kontrol'panel'o
kontrolpunktojn	kontrol'punkt'o'j'n
kontrolsistemo	kontrol'sistem'o
kontrolsistemoj	kontrol'sistem'o'j
kontrolsistemojn	kontrol'sistem'o'j'n
kontrolsistemon	kontrol'sistem'o'n
konturas	kontur'as
konturi	kontur'i
konturis	kontur'is
konturo	kontur'o
konturoj	kontur'o'j
konturojn	kontur'o'j'n
konturon	kontur'o'n
konturado	kontur'ad'o
konturiĝas	kontur'iĝ'as
konturiĝis	kontur'iĝ'is
konturita	kontur'it'a
konturitaj	kontur'it'a'j
kontuzis	kontuz'is
kontuzo	kontuz'o
kontuzoj	kontuz'o'j
kontuzon	kontuz'o'n
kontuzita	kontuz'it'a
konusa	konus'a
konusaj	konus'a'j
konusan	konus'a'n
konuso	konus'o
konusoj	konus'o'j
konusojn	konus'o'j'n
konuson	konus'o'n
konusĉeloj	konus'ĉel'o'j
konusetoj	konus'et'o'j
konusforma	konus'form'a
konusformaj	konus'form'a'j
konvalesko	konvalesk'o
konvekcio	konvekci'o
konveksa	konveks'a
konveksaj	konveks'a'j
konveksajn	konveks'a'j'n
konveksan	konveks'a'n
konvekseco	konveks'ec'o
konvekta	konvekt'a
konvektaj	konvekt'a'j
konvektan	konvekt'a'n
konvena	konven'a
konvenaj	konven'a'j
konvenajn	konven'a'j'n
konvenan	konven'a'n
konvenas	konven'as
konvene	konven'e
konveni	konven'i
konvenis	konven'is
konveno	konven'o
konvenos	konven'os
konvenus	konven'us
konvenanta	konven'ant'a
konvenante	konven'ant'e
konveneco	konven'ec'o
konvenigita	konven'ig'it'a
konvenigitaj	konven'ig'it'a'j
konvenita	konven'it'a
konvenitaj	konven'it'a'j
konvenite	konven'it'e
konvencia	konvenci'a
konvenciaj	konvenci'a'j
konvenciajn	konvenci'a'j'n
konvencian	konvenci'a'n
konvencie	konvenci'e
konvencio	konvenci'o
konvencioj	konvenci'o'j
konvenciojn	konvenci'o'j'n
konvencion	konvenci'o'n
konventa	konvent'a
konvento	konvent'o
konverĝa	konverĝ'a
konverĝaj	konverĝ'a'j
konverĝan	konverĝ'a'n
konverĝas	konverĝ'as
konverĝi	konverĝ'i
konverĝis	konverĝ'is
konverĝo	konverĝ'o
konverĝon	konverĝ'o'n
konversado	konvers'ad'o
konversacia	konversaci'a
konversaciaj	konversaci'a'j
konversaciajn	konversaci'a'j'n
konversacian	konversaci'a'n
konversacias	konversaci'as
konversacii	konversaci'i
konversaciis	konversaci'is
konversacio	konversaci'o
konversacioj	konversaci'o'j
konversaciojn	konversaci'o'j'n
konversacion	konversaci'o'n
konversaciado	konversaci'ad'o
konversaciante	konversaci'ant'e
konversacianto	konversaci'ant'o
konversaciantoj	konversaci'ant'o'j
konverta	konvert'a
konvertaj	konvert'a'j
konvertajn	konvert'a'j'n
konvertan	konvert'a'n
konvertas	konvert'as
konverti	konvert'i
konvertis	konvert'is
konverto	konvert'o
konvertoj	konvert'o'j
konverton	konvert'o'n
konvertado	konvert'ad'o
konvertante	konvert'ant'e
konvertebla	konvert'ebl'a
konverteblaj	konvert'ebl'a'j
konvertiĝas	konvert'iĝ'as
konvertiĝi	konvert'iĝ'i
konvertiĝis	konvert'iĝ'is
konvertiĝo	konvert'iĝ'o
konvertiĝoj	konvert'iĝ'o'j
konvertiĝojn	konvert'iĝ'o'j'n
konvertiĝon	konvert'iĝ'o'n
konvertiĝu	konvert'iĝ'u
konvertilo	konvert'il'o
konvertismo	konvert'ism'o
konvertita	konvert'it'a
konvertitaj	konvert'it'a'j
konvertito	konvert'it'o
konvertitoj	konvert'it'o'j
konvertitojn	konvert'it'o'j'n
konvinka	konvink'a
konvinkaj	konvink'a'j
konvinkajn	konvink'a'j'n
konvinkan	konvink'a'n
konvinkas	konvink'as
konvinke	konvink'e
konvinki	konvink'i
konvinkis	konvink'is
konvinko	konvink'o
konvinkoj	konvink'o'j
konvinkojn	konvink'o'j'n
konvinkon	konvink'o'n
konvinkos	konvink'os
konvinku	konvink'u
konvinkado	konvink'ad'o
konvinkanta	konvink'ant'a
konvinkante	konvink'ant'e
konvinkiĝas	konvink'iĝ'as
konvinkiĝi	konvink'iĝ'i
konvinkiĝis	konvink'iĝ'is
konvinkiĝo	konvink'iĝ'o
konvinkiĝoj	konvink'iĝ'o'j
konvinkiĝojn	konvink'iĝ'o'j'n
konvinkiĝon	konvink'iĝ'o'n
konvinkiĝos	konvink'iĝ'os
konvinkiĝu	konvink'iĝ'u
konvinkiĝinte	konvink'iĝ'int'e
konvinkinta	konvink'int'a
konvinkita	konvink'it'a
konvinkitaj	konvink'it'a'j
konvinkite	konvink'it'e
konvinkiteco	konvink'it'ec'o
konvojo	konvoj'o
konvojoj	konvoj'o'j
konvojojn	konvoj'o'j'n
konvojon	konvoj'o'n
konvulsia	konvulsi'a
konvulsias	konvulsi'as
konvulsie	konvulsi'e
konvulsiis	konvulsi'is
konvulsio	konvulsi'o
konvulsioj	konvulsi'o'j
konvulsiojn	konvulsi'o'j'n
konvulsion	konvulsi'o'n
konzerno	konzern'o
konzernoj	konzern'o'j
konzernojn	konzern'o'j'n
konzernon	konzern'o'n
konzolo	konzol'o
konzoloj	konzol'o'j
konzolon	konzol'o'n
koopera	kooper'a
kooperaj	kooper'a'j
kooperajn	kooper'a'j'n
kooperan	kooper'a'n
koopere	kooper'e
kooperado	kooper'ad'o
kooperativa	kooperativ'a
kooperativaj	kooperativ'a'j
kooperativo	kooperativ'o
kooperativoj	kooperativ'o'j
kooperativojn	kooperativ'o'j'n
kooperativon	kooperativ'o'n
kooperativismo	kooperativ'ism'o
koordinata	koordinat'a
koordinato	koordinat'o
koordinatoj	koordinat'o'j
koordinatojn	koordinat'o'j'n
koordinatsistemo	koordinat'sistem'o
koordinatsistemoj	koordinat'sistem'o'j
koordinatsistemon	koordinat'sistem'o'n
kopeko	kopek'o
kopekoj	kopek'o'j
kopekojn	kopek'o'j'n
kopekon	kopek'o'n
kopenhaga	kopenhag'a
kopenhagan	kopenhag'a'n
kopenhago	kopenhag'o
kopenhagon	kopenhag'o'n
kopernika	kopernik'a
koperniko	kopernik'o
kopia	kopi'a
kopias	kopi'as
kopie	kopi'e
kopii	kopi'i
kopiis	kopi'is
kopio	kopi'o
kopioj	kopi'o'j
kopiojn	kopi'o'j'n
kopion	kopi'o'n
kopios	kopi'os
kopiu	kopi'u
kopiado	kopi'ad'o
kopiadon	kopi'ad'o'n
kopiaĵo	kopi'aĵ'o
kopiaĵoj	kopi'aĵ'o'j
kopiaĵon	kopi'aĵ'o'n
kopiante	kopi'ant'e
kopiisto	kopi'ist'o
kopiistoj	kopi'ist'o'j
kopiita	kopi'it'a
kopiitaj	kopi'it'a'j
kopirajta	kopi'rajt'a
kopirajtaj	kopi'rajt'a'j
kopirajto	kopi'rajt'o
kopirajtoj	kopi'rajt'o'j
kopirajtojn	kopi'rajt'o'j'n
kopirajton	kopi'rajt'o'n
kopirajtigita	kopi'rajt'ig'it'a
kopirajtigitaj	kopi'rajt'ig'it'a'j
kopirajtigitan	kopi'rajt'ig'it'a'n
kopirajtleĝo	kopi'rajt'leĝ'o
kopirajtleĝoj	kopi'rajt'leĝ'o'j
kopirajtomalrespekto	kopi'rajt'o'mal'respekt'o
kopirajtoposedanto	kopi'rajt'o'posed'ant'o
kopirajtprotektado	kopi'rajt'protekt'ad'o
kopirajtulo	kopi'rajt'ul'o
kopirajtuloj	kopi'rajt'ul'o'j
kopta	kopt'a
koptaj	kopt'a'j
kopto	kopt'o
koptoj	kopt'o'j
kopulacias	kopulaci'as
kopulacio	kopulaci'o
kopulacioj	kopulaci'o'j
kora	kor'a
koraj	kor'a'j
korajn	kor'a'j'n
koran	kor'a'n
kore	kor'e
koro	kor'o
koroj	kor'o'j
korojn	kor'o'j'n
koron	kor'o'n
koramiko	kor'amik'o
koramikoj	kor'amik'o'j
koramikon	kor'amik'o'n
koramikino	kor'amik'in'o
koramikinojn	kor'amik'in'o'j'n
koramikinon	kor'amik'in'o'n
koratako	kor'atak'o
koratakoj	kor'atak'o'j
koratakon	kor'atak'o'n
korbato	kor'bat'o
korbatoj	kor'bat'o'j
korbatojn	kor'bat'o'j'n
korbatado	kor'bat'ad'o
korbatadon	kor'bat'ad'o'n
kordoloro	kor'dolor'o
kordoloron	kor'dolor'o'n
koreco	kor'ec'o
koregan	kor'eg'a'n
korege	kor'eg'e
korfavora	kor'favor'a
korforma	kor'form'a
korformaj	kor'form'a'j
korfrekvenco	kor'frekvenc'o
korfrekvencon	kor'frekvenc'o'n
korhalto	kor'halt'o
korhalton	kor'halt'o'n
korinklino	kor'inklin'o
korinklinon	kor'inklin'o'n
kormalsano	kor'mal'san'o
kormalsanoj	kor'mal'san'o'j
kormalsanon	kor'mal'san'o'n
kormuskolo	kor'muskol'o
korprema	kor'prem'a
korproblemoj	kor'problem'o'j
korstimuliloj	kor'stimul'il'o'j
korŝira	kor'ŝir'a
korŝire	kor'ŝir'e
kortuŝa	kor'tuŝ'a
kortuŝaj	kor'tuŝ'a'j
kortuŝajn	kor'tuŝ'a'j'n
kortuŝan	kor'tuŝ'a'n
kortuŝas	kor'tuŝ'as
kortuŝe	kor'tuŝ'e
kortuŝi	kor'tuŝ'i
kortuŝis	kor'tuŝ'is
kortuŝo	kor'tuŝ'o
kortuŝon	kor'tuŝ'o'n
kortuŝata	kor'tuŝ'at'a
kortuŝiĝas	kor'tuŝ'iĝ'as
kortuŝiĝis	kor'tuŝ'iĝ'is
kortuŝita	kor'tuŝ'it'a
kortuŝitaj	kor'tuŝ'it'a'j
kortuŝite	kor'tuŝ'it'e
korvalvoj	kor'valv'o'j
korvarmiga	kor'varm'ig'a
korventriklo	kor'ventrikl'o
korala	koral'a
koralaj	koral'a'j
koralajn	koral'a'j'n
koralo	koral'o
koraloj	koral'o'j
koralojn	koral'o'j'n
koralruĝa	koral'ruĝ'a
koralruĝaj	koral'ruĝ'a'j
korana	koran'a
korano	koran'o
koranon	koran'o'n
korben	korb'e'n
korbo	korb'o
korboj	korb'o'j
korbojn	korb'o'j'n
korbon	korb'o'n
korbeto	korb'et'o
korbeton	korb'et'o'n
korbopilka	korb'o'pilk'a
korbopilko	korb'o'pilk'o
korbopilkon	korb'o'pilk'o'n
korbopilkado	korb'o'pilk'ad'o
korda	kord'a
kordaj	kord'a'j
kordo	kord'o
kordoj	kord'o'j
kordojn	kord'o'j'n
kordon	kord'o'n
kordinstrumento	kord'instrument'o
kordinstrumentoj	kord'instrument'o'j
kordoĥoroj	kord'o'ĥor'o'j
kordilero	kordiler'o
kordobo	kordob'o
kordono	kordon'o
kordonon	kordon'o'n
kordova	kordov'a
kordovo	kordov'o
korea	kore'a
koreaj	kore'a'j
koreajn	kore'a'j'n
korean	kore'a'n
koreo	kore'o
koreoj	kore'o'j
koreanoj	kore'an'o'j
koreia	kore'i'a
koreio	kore'i'o
koreion	kore'i'o'n
koreujo	kore'uj'o
koregrafio	koregraf'i'o
korekta	korekt'a
korektaj	korekt'a'j
korektajn	korekt'a'j'n
korektan	korekt'a'n
korektas	korekt'as
korekte	korekt'e
korekti	korekt'i
korektis	korekt'is
korekto	korekt'o
korektoj	korekt'o'j
korektojn	korekt'o'j'n
korekton	korekt'o'n
korektos	korekt'os
korektu	korekt'u
korektus	korekt'us
korektado	korekt'ad'o
korektadon	korekt'ad'o'n
korektaĵoj	korekt'aĵ'o'j
korektante	korekt'ant'e
korektata	korekt'at'a
korektebla	korekt'ebl'a
korekteblaj	korekt'ebl'a'j
korekteco	korekt'ec'o
korektecon	korekt'ec'o'n
korektilo	korekt'il'o
korektisto	korekt'ist'o
korektita	korekt'it'a
korektitaj	korekt'it'a'j
korektitan	korekt'it'a'n
korelacias	korelaci'as
korelacii	korelaci'i
korelaciis	korelaci'is
korelacio	korelaci'o
korelacioj	korelaci'o'j
korelaciojn	korelaci'o'j'n
korelacion	korelaci'o'n
korelaciaĵoj	korelaci'aĵ'o'j
korelaciita	korelaci'it'a
korelaciitaj	korelaci'it'a'j
korelaciokoeficiento	korelaci'o'koeficient'o
korelativa	korelativ'a
korelativaj	korelativ'a'j
korelativoj	korelativ'o'j
koreografo	koreograf'o
koresponda	korespond'a
korespondaj	korespond'a'j
korespondajn	korespond'a'j'n
korespondan	korespond'a'n
korespondas	korespond'as
koresponde	korespond'e
korespondi	korespond'i
korespondis	korespond'is
korespondo	korespond'o
korespondon	korespond'o'n
korespondos	korespond'os
korespondu	korespond'u
korespondus	korespond'us
korespondadi	korespond'ad'i
korespondadis	korespond'ad'is
korespondado	korespond'ad'o
korespondadoj	korespond'ad'o'j
korespondadojn	korespond'ad'o'j'n
korespondadon	korespond'ad'o'n
korespondaĵo	korespond'aĵ'o
korespondaĵoj	korespond'aĵ'o'j
korespondaĵojn	korespond'aĵ'o'j'n
korespondamikojn	korespond'amik'o'j'n
korespondanta	korespond'ant'a
korespondante	korespond'ant'e
korespondanto	korespond'ant'o
korespondantoj	korespond'ant'o'j
korespondantojn	korespond'ant'o'j'n
korespondanton	korespond'ant'o'n
korespondantino	korespond'ant'in'o
korespondisto	korespond'ist'o
korespondistoj	korespond'ist'o'j
koriandro	koriandr'o
koriandron	koriandr'o'n
koridora	koridor'a
koridoro	koridor'o
koridoroj	koridor'o'j
koridorojn	koridor'o'j'n
koridoron	koridor'o'n
korifeo	korife'o
korifeoj	korife'o'j
korinta	korint'a
korintaj	korint'a'j
korinto	korint'o
korinton	korint'o'n
korintanoj	korint'an'o'j
korjakoj	korjak'o'j
korko	kork'o
korkon	kork'o'n
korktirilo	kork'tir'il'o
korktirilon	kork'tir'il'o'n
kormorano	kormoran'o
kormoranoj	kormoran'o'j
korna	korn'a
korno	korn'o
kornoj	korn'o'j
kornojn	korn'o'j'n
kornon	korn'o'n
kornaro	korn'ar'o
kornaron	korn'ar'o'n
korneca	korn'ec'a
kornuloj	korn'ul'o'j
kornea	korne'a
korneo	korne'o
korneoj	korne'o'j
korneon	korne'o'n
kornelio	korneli'o
korneto	kornet'o
korneton	kornet'o'n
kornico	kornic'o
kornicoj	kornic'o'j
kornicon	kornic'o'n
korniko	kornik'o
kornikoj	kornik'o'j
kornuso	kornus'o
kornvala	kornval'a
kornvalaj	kornval'a'j
kornvalo	kornval'o
koroda	korod'a
korodaj	korod'a'j
korodajn	korod'a'j'n
korodas	korod'as
korodo	korod'o
korodon	korod'o'n
korodrezisto	korod'rezist'o
korolo	korol'o
korolario	korolari'o
korona	koron'a
koronaj	koron'a'j
korono	koron'o
koronviruso	koron'virus'o
koronaria	koronari'a
korpa	korp'a
korpaj	korp'a'j
korpajn	korp'a'j'n
korpan	korp'a'n
korpe	korp'e
korpo	korp'o
korpoj	korp'o'j
korpojn	korp'o'j'n
korpon	korp'o'n
korpbildo	korp'bild'o
korpekzercado	korp'ekzerc'ad'o
korpeto	korp'et'o
korpeton	korp'et'o'n
korpgrandeco	korp'grand'ec'o
korpigas	korp'ig'as
korpigi	korp'ig'i
korpigis	korp'ig'is
korpkavaĵo	korp'kav'aĵ'o
korplikvaĵoj	korp'likv'aĵ'o'j
korplingvo	korp'lingv'o
korpmuro	korp'mur'o
korpoformo	korp'o'form'o
korpogardisto	korp'o'gard'ist'o
korpogardistoj	korp'o'gard'ist'o'j
korpogardiston	korp'o'gard'ist'o'n
korpomaso	korp'o'mas'o
korpomovoj	korp'o'mov'o'j
korpoparto	korp'o'part'o
korpopartoj	korp'o'part'o'j
korpopartojn	korp'o'part'o'j'n
korpoparton	korp'o'part'o'n
korpopezo	korp'o'pez'o
korpopezon	korp'o'pez'o'n
korpotemperaturo	korp'o'temperatur'o
korpotemperaturon	korp'o'temperatur'o'n
korpovarmecon	korp'o'varm'ec'o'n
korporacia	korporaci'a
korporaciaj	korporaci'a'j
korporacio	korporaci'o
korporacioj	korporaci'o'j
korporaciojn	korporaci'o'j'n
korporacion	korporaci'o'n
korporaciismo	korporaci'ism'o
korpulenta	korpulent'a
korpuso	korpus'o
korpusoj	korpus'o'j
korpuson	korpus'o'n
korpusklo	korpuskl'o
korpuskloj	korpuskl'o'j
korsaĵo	korsaĵ'o
korsaroj	korsar'o'j
korseto	korset'o
korseton	korset'o'n
korsika	korsik'a
korsiko	korsik'o
korsikano	korsik'an'o
korta	kort'a
kortaj	kort'a'j
korto	kort'o
kortoj	kort'o'j
kortojn	kort'o'j'n
korton	kort'o'n
kortbirdoj	kort'bird'o'j
kortbirdojn	kort'bird'o'j'n
kortdomo	kort'dom'o
kortega	kort'eg'a
kortegaj	kort'eg'a'j
kortegan	kort'eg'a'n
kortego	kort'eg'o
kortegoj	kort'eg'o'j
kortegon	kort'eg'o'n
kortegano	kort'eg'an'o
korteganoj	kort'eg'an'o'j
korteganojn	kort'eg'an'o'j'n
korteganino	kort'eg'an'in'o
korteto	kort'et'o
kortisto	kort'ist'o
kortobirdoj	kort'o'bird'o'j
kortobirdojn	kort'o'bird'o'j'n
kortodomo	kort'o'dom'o
kortuma	kort'um'a
kortumo	kort'um'o
kortumoj	kort'um'o'j
kortumon	kort'um'o'n
kortumkazoj	kort'um'kaz'o'j
kortekso	korteks'o
kortekson	korteks'o'n
korteza	kortez'a
kortiko	kortik'o
korupta	korupt'a
koruptaj	korupt'a'j
koruptajn	korupt'a'j'n
koruptan	korupt'a'n
koruptas	korupt'as
korupti	korupt'i
koruptis	korupt'is
korupto	korupt'o
koruptoj	korupt'o'j
korupton	korupt'o'n
koruptado	korupt'ad'o
koruptadon	korupt'ad'o'n
korupteco	korupt'ec'o
koruptecoj	korupt'ec'o'j
koruptecon	korupt'ec'o'n
koruptita	korupt'it'a
koruptitaj	korupt'it'a'j
koruse	korus'e
koruso	korus'o
korusoj	korus'o'j
korusojn	korus'o'j'n
koruson	korus'o'n
korvo	korv'o
korvoj	korv'o'j
korvojn	korv'o'j'n
korvon	korv'o'n
korvino	korv'in'o
korvedoj	korved'o'j
kosinuso	kosinus'o
kosma	kosm'a
kosmaj	kosm'a'j
kosmajn	kosm'a'j'n
kosman	kosm'a'n
kosmo	kosm'o
kosmon	kosm'o'n
kosmoesploro	kosm'o'esplor'o
kosmolifto	kosm'o'lift'o
kosmopramo	kosm'o'pram'o
kosmopramoj	kosm'o'pram'o'j
kosmosondilo	kosm'o'sond'il'o
kosmosondiloj	kosm'o'sond'il'o'j
kosmostacio	kosm'o'staci'o
kosmostacioj	kosm'o'staci'o'j
kosmostacion	kosm'o'staci'o'n
kosmoŝipo	kosm'o'ŝip'o
kosmoŝipoj	kosm'o'ŝip'o'j
kosmoŝipojn	kosm'o'ŝip'o'j'n
kosmoŝipon	kosm'o'ŝip'o'n
kosmoteleskopo	kosm'o'teleskop'o
kosmovesto	kosm'o'vest'o
kosmoveturilo	kosm'o'vetur'il'o
kosmologia	kosm'olog'i'a
kosmologiaj	kosm'olog'i'a'j
kosmologian	kosm'olog'i'a'n
kosmologio	kosm'olog'i'o
kosmologion	kosm'olog'i'o'n
kosmetika	kosmetik'a
kosmetikaj	kosmetik'a'j
kosmetikan	kosmetik'a'n
kosmetiko	kosmetik'o
kosmetikaĵo	kosmetik'aĵ'o
kosmetikaĵoj	kosmetik'aĵ'o'j
kosmetikaĵojn	kosmetik'aĵ'o'j'n
kosmodromo	kosmodrom'o
kosmogonio	kosmogoni'o
kosmogonioj	kosmogoni'o'j
kosmonaŭto	kosmonaŭt'o
kosmonaŭtoj	kosmonaŭt'o'j
kosmonaŭtiko	kosmonaŭt'ik'o
kosmopolita	kosmopolit'a
kosmopolitaj	kosmopolit'a'j
kosmopolitan	kosmopolit'a'n
kosmopolito	kosmopolit'o
kosmopolitoj	kosmopolit'o'j
kosmopolitismo	kosmopolit'ism'o
kosova	kosov'a
kosovaj	kosov'a'j
kosovan	kosov'a'n
kosovo	kosov'o
kosovon	kosov'o'n
kosovanoj	kosov'an'o'j
kosta	kost'a
kostaj	kost'a'j
kostajn	kost'a'j'n
kostan	kost'a'n
kostas	kost'as
koste	kost'e
kosti	kost'i
kostis	kost'is
kosto	kost'o
kostoj	kost'o'j
kostojn	kost'o'j'n
koston	kost'o'n
kostos	kost'os
kostu	kost'u
kostus	kost'us
kostante	kost'ant'e
kostefika	kost'efik'a
kostefikaj	kost'efik'a'j
kostefikan	kost'efik'a'n
kostefikeco	kost'efik'ec'o
kostarika	kostarik'a
kostariko	kostarik'o
kostumo	kostum'o
kostumoj	kostum'o'j
kostumojn	kostum'o'j'n
kostumon	kostum'o'n
kostumisto	kostum'ist'o
koŝera	koŝer'a
koŝeraj	koŝer'a'j
koŝia	koŝi'a
koŝmaro	koŝmar'o
koŝmaroj	koŝmar'o'j
koŝmarojn	koŝmar'o'j'n
koŝmaron	koŝmar'o'n
kota	kot'a
kotaj	kot'a'j
kotajn	kot'a'j'n
koto	kot'o
koton	kot'o'n
kotejoj	kot'ej'o'j
koterio	koteri'o
koterioj	koteri'o'j
kotizi	kotiz'i
kotizo	kotiz'o
kotizoj	kotiz'o'j
kotizojn	kotiz'o'j'n
kotizon	kotiz'o'n
kotleto	kotlet'o
kotletojn	kotlet'o'j'n
kotleton	kotlet'o'n
kotona	koton'a
kotonaj	koton'a'j
kotonajn	koton'a'j'n
kotono	koton'o
kotonoj	koton'o'j
kotonojn	koton'o'j'n
kotonon	koton'o'n
kotonŝtofo	koton'ŝtof'o
koturno	koturn'o
koturnoj	koturn'o'j
kovas	kov'as
kovi	kov'i
kovis	kov'is
kovado	kov'ad'o
kovadon	kov'ad'o'n
kovejo	kov'ej'o
kovejoj	kov'ej'o'j
kovilo	kov'il'o
kovalenta	kovalent'a
kovalentaj	kovalent'a'j
kovalentan	kovalent'a'n
kovalente	kovalent'e
koverto	kovert'o
kovertoj	kovert'o'j
kovertojn	kovert'o'j'n
koverton	kovert'o'n
kovra	kovr'a
kovraj	kovr'a'j
kovras	kovr'as
kovri	kovr'i
kovris	kovr'is
kovro	kovr'o
kovroj	kovr'o'j
kovrojn	kovr'o'j'n
kovron	kovr'o'n
kovros	kovr'os
kovru	kovr'u
kovrus	kovr'us
kovrado	kovr'ad'o
kovradon	kovr'ad'o'n
kovraĵo	kovr'aĵ'o
kovraĵoj	kovr'aĵ'o'j
kovraĵon	kovr'aĵ'o'n
kovranta	kovr'ant'a
kovrantaj	kovr'ant'a'j
kovrantajn	kovr'ant'a'j'n
kovrantan	kovr'ant'a'n
kovrante	kovr'ant'e
kovrata	kovr'at'a
kovrataj	kovr'at'a'j
kovriĝas	kovr'iĝ'as
kovriĝis	kovr'iĝ'is
kovrila	kovr'il'a
kovrilo	kovr'il'o
kovriloj	kovr'il'o'j
kovrilojn	kovr'il'o'j'n
kovrilon	kovr'il'o'n
kovrilpaĝa	kovr'il'paĝ'a
kovrilpaĝo	kovr'il'paĝ'o
kovrinta	kovr'int'a
kovrinte	kovr'int'e
kovrita	kovr'it'a
kovritaj	kovr'it'a'j
kovritajn	kovr'it'a'j'n
kovritan	kovr'it'a'n
kovrite	kovr'it'e
kovritis	kovr'it'is
kovrokultivaĵoj	kovr'o'kultiv'aĵ'o'j
kovroŝtono	kovr'o'ŝton'o
kozaka	kozak'a
kozako	kozak'o
kozakoj	kozak'o'j
kozakojn	kozak'o'j'n
krabo	krab'o
kraboj	krab'o'j
krabojn	krab'o'j'n
krabon	krab'o'n
kraĉas	kraĉ'as
kraĉi	kraĉ'i
kraĉis	kraĉ'is
kraĉos	kraĉ'os
kraĉu	kraĉ'u
kraĉado	kraĉ'ad'o
krada	krad'a
kradaj	krad'a'j
krado	krad'o
kradoj	krad'o'j
kradojn	krad'o'j'n
kradon	krad'o'n
kradpordo	krad'pord'o
kradrostado	krad'rost'ad'o
kradrostita	krad'rost'it'a
kradrostitaj	krad'rost'it'a'j
krajone	krajon'e
krajono	krajon'o
krajonoj	krajon'o'j
krajonojn	krajon'o'j'n
krajonon	krajon'o'n
kraka	krak'a
krakas	krak'as
krake	krak'e
kraki	krak'i
krakis	krak'is
krako	krak'o
krakon	krak'o'n
krakadis	krak'ad'is
krakado	krak'ad'o
krakadon	krak'ad'o'n
krakanta	krak'ant'a
krakego	krak'eg'o
kraketa	krak'et'a
kraketas	krak'et'as
kraketis	krak'et'is
kraketado	krak'et'ad'o
kraketanta	krak'et'ant'a
krakeno	kraken'o
krakova	krakov'a
krakovo	krakov'o
krakovon	krakov'o'n
krampo	kramp'o
krampoj	kramp'o'j
krampojn	kramp'o'j'n
krampon	kramp'o'n
krampita	kramp'it'a
krano	kran'o
kranoj	kran'o'j
kranon	kran'o'n
kranakvo	kran'akv'o
krania	krani'a
kraniaj	krani'a'j
kranian	krani'a'n
kranio	krani'o
kranioj	krani'o'j
kraniojn	krani'o'j'n
kranion	krani'o'n
kranko	krank'o
krankon	krank'o'n
krankoŝafto	krank'o'ŝaft'o
krankoŝaftoj	krank'o'ŝaft'o'j
kraŝas	kraŝ'as
kraŝi	kraŝ'i
kraŝis	kraŝ'is
kraŝo	kraŝ'o
kraŝoj	kraŝ'o'j
kraŝon	kraŝ'o'n
kratago	kratag'o
kratera	krater'a
kratero	krater'o
krateroj	krater'o'j
kraterojn	krater'o'j'n
krateron	krater'o'n
kravato	kravat'o
kravatoj	kravat'o'j
kravatojn	kravat'o'j'n
kravaton	kravat'o'n
krea	kre'a
kreaj	kre'a'j
kreajn	kre'a'j'n
krean	kre'a'n
kreas	kre'as
krei	kre'i
kreis	kre'is
kreo	kre'o
kreoj	kre'o'j
kreon	kre'o'n
kreos	kre'os
kreu	kre'u
kreus	kre'us
kreada	kre'ad'a
kreadi	kre'ad'i
kreadis	kre'ad'is
kreado	kre'ad'o
kreadoj	kre'ad'o'j
kreadojn	kre'ad'o'j'n
kreadon	kre'ad'o'n
kreajho	kre'aĵ'o
kreaĵo	kre'aĵ'o
kreaĵoj	kre'aĵ'o'j
kreaĵojn	kre'aĵ'o'j'n
kreaĵon	kre'aĵ'o'n
kreaĵaro	kre'aĵ'ar'o
kreanta	kre'ant'a
kreantaj	kre'ant'a'j
kreante	kre'ant'e
kreanto	kre'ant'o
kreantoj	kre'ant'o'j
kreanton	kre'ant'o'n
kreata	kre'at'a
kreataj	kre'at'a'j
kreema	kre'em'a
kreemaj	kre'em'a'j
kreeman	kre'em'a'n
kreemo	kre'em'o
kreemon	kre'em'o'n
kreiĝas	kre'iĝ'as
kreiĝi	kre'iĝ'i
kreiĝis	kre'iĝ'is
kreiĝo	kre'iĝ'o
kreiĝon	kre'iĝ'o'n
kreiĝos	kre'iĝ'os
kreinta	kre'int'a
kreintaj	kre'int'a'j
kreinte	kre'int'e
kreinto	kre'int'o
kreintoj	kre'int'o'j
kreintojn	kre'int'o'j'n
kreinton	kre'int'o'n
kreismo	kre'ism'o
kreita	kre'it'a
kreitaj	kre'it'a'j
kreitajn	kre'it'a'j'n
kreitan	kre'it'a'n
kreite	kre'it'e
kreito	kre'it'o
kreitoj	kre'it'o'j
kreitaĵo	kre'it'aĵ'o
kreitaĵoj	kre'it'aĵ'o'j
kreitaĵojn	kre'it'aĵ'o'j'n
kreitaĵon	kre'it'aĵ'o'n
kreitaĵaro	kre'it'aĵ'ar'o
kreitaro	kre'it'ar'o
kreitulo	kre'it'ul'o
kreituloj	kre'it'ul'o'j
kreota	kre'ot'a
kreda	kred'a
kredas	kred'as
kredi	kred'i
kredis	kred'is
kredo	kred'o
kredoj	kred'o'j
kredojn	kred'o'j'n
kredon	kred'o'n
kredos	kred'os
kredu	kred'u
kredus	kred'us
kredado	kred'ad'o
kredaĵoj	kred'aĵ'o'j
kredanta	kred'ant'a
kredantaj	kred'ant'a'j
kredante	kred'ant'e
kredanto	kred'ant'o
kredantoj	kred'ant'o'j
kredantojn	kred'ant'o'j'n
kredanton	kred'ant'o'n
kredantaro	kred'ant'ar'o
kredaro	kred'ar'o
kredaroj	kred'ar'o'j
kredarojn	kred'ar'o'j'n
kredaron	kred'ar'o'n
kredata	kred'at'a
kredebla	kred'ebl'a
kredeblaj	kred'ebl'a'j
kredeblas	kred'ebl'as
kredeble	kred'ebl'e
kredebleco	kred'ebl'ec'o
kredeblecon	kred'ebl'ec'o'n
kredema	kred'em'a
kredemo	kred'em'o
krederoj	kred'er'o'j
kredigas	kred'ig'as
kredigi	kred'ig'i
kredigis	kred'ig'is
kredigante	kred'ig'ant'e
kredinda	kred'ind'a
kredindaj	kred'ind'a'j
kredindajn	kred'ind'a'j'n
kredindan	kred'ind'a'n
kredinde	kred'ind'e
kredindeco	kred'ind'ec'o
kredindecon	kred'ind'ec'o'n
kredinta	kred'int'a
kredintus	kred'int'us
kredita	kred'it'a
kreditaj	kred'it'a'j
kreditajn	kred'it'a'j'n
kreditan	kred'it'a'n
kredite	kred'it'e
kreditaĵoj	kred'it'aĵ'o'j
kreditaĵojn	kred'it'aĵ'o'j'n
kredkonfeso	kred'konfes'o
kredkonfeson	kred'konfes'o'n
kredokonfeso	kred'o'konfes'o
kredsistemo	kred'sistem'o
kredsistemoj	kred'sistem'o'j
kreduloj	kred'ul'o'j
kredita	kredit'a
kreditaj	kredit'a'j
kreditajn	kredit'a'j'n
kreditan	kredit'a'n
kreditas	kredit'as
kredite	kredit'e
krediti	kredit'i
kreditis	kredit'is
kredito	kredit'o
kreditoj	kredit'o'j
kreditojn	kredit'o'j'n
krediton	kredit'o'n
kreditita	kredit'it'a
kredititaj	kredit'it'a'j
kreditkarto	kredit'kart'o
kreditkartoj	kredit'kart'o'j
kreditkartojn	kredit'kart'o'j'n
kreditkarton	kredit'kart'o'n
kreditoro	kreditor'o
kreditoroj	kreditor'o'j
kreditorojn	kreditor'o'j'n
kreiva	kreiv'a
kreivaj	kreiv'a'j
kreivajn	kreiv'a'j'n
kreivan	kreiv'a'n
kreive	kreiv'e
kreivo	kreiv'o
kreivon	kreiv'o'n
kreiveco	kreiv'ec'o
kreivecon	kreiv'ec'o'n
krema	krem'a
kremo	krem'o
kremoj	krem'o'j
kremon	krem'o'n
kremaĵo	krem'aĵ'o
kremkolora	krem'kolor'a
kremkoloraj	krem'kolor'a'j
kremokoloraj	krem'o'kolor'a'j
kremacio	kremaci'o
kremacion	kremaci'o'n
kremaciejo	kremaci'ej'o
kremla	kreml'a
kremlo	kreml'o
kreno	kren'o
kreneloj	krenel'o'j
kreola	kreol'a
kreolaj	kreol'a'j
kreolan	kreol'a'n
kreoloj	kreol'o'j
kreolino	kreol'in'o
kreolinoj	kreol'in'o'j
kreono	kreon'o
krepo	krep'o
krepuska	krepusk'a
krepuskaj	krepusk'a'j
krepuske	krepusk'e
krepusko	krepusk'o
krepuskon	krepusk'o'n
krepuskiĝis	krepusk'iĝ'is
krepuskiĝo	krepusk'iĝ'o
krescento	krescent'o
kreska	kresk'a
kreskaj	kresk'a'j
kreskan	kresk'a'n
kreskas	kresk'as
kreski	kresk'i
kreskis	kresk'is
kresko	kresk'o
kreskoj	kresk'o'j
kreskon	kresk'o'n
kreskos	kresk'os
kresku	kresk'u
kreskus	kresk'us
kreskadas	kresk'ad'as
kreskadis	kresk'ad'is
kreskado	kresk'ad'o
kreskadon	kresk'ad'o'n
kreskaĵo	kresk'aĵ'o
kreskaĵoj	kresk'aĵ'o'j
kreskaĵojn	kresk'aĵ'o'j'n
kreskaĵaro	kresk'aĵ'ar'o
kreskanta	kresk'ant'a
kreskantaj	kresk'ant'a'j
kreskantajn	kresk'ant'a'j'n
kreskantan	kresk'ant'a'n
kreskante	kresk'ant'e
kreskejo	kresk'ej'o
kreskejoj	kresk'ej'o'j
kreskfaktoroj	kresk'faktor'o'j
kreskigas	kresk'ig'as
kreskigi	kresk'ig'i
kreskigis	kresk'ig'is
kreskigo	kresk'ig'o
kreskigos	kresk'ig'os
kreskigu	kresk'ig'u
kreskigus	kresk'ig'us
kreskigado	kresk'ig'ad'o
kreskiganta	kresk'ig'ant'a
kreskigante	kresk'ig'ant'e
kreskigita	kresk'ig'it'a
kreskigitaj	kresk'ig'it'a'j
kreskigite	kresk'ig'it'e
kreskiĝas	kresk'iĝ'as
kreskiĝis	kresk'iĝ'is
kreskiĝo	kresk'iĝ'o
kreskinta	kresk'int'a
kreskintaj	kresk'int'a'j
kreskintan	kresk'int'a'n
kreskinte	kresk'int'e
kreskita	kresk'it'a
kreskitaj	kresk'it'a'j
kreskorapideco	kresk'o'rapid'ec'o
kreskorapidecoj	kresk'o'rapid'ec'o'j
kreskorapidecojn	kresk'o'rapid'ec'o'j'n
kreskorapidecon	kresk'o'rapid'ec'o'n
kresksezono	kresk'sezon'o
kreskuloj	kresk'ul'o'j
krespo	kresp'o
krespoj	kresp'o'j
krespojn	kresp'o'j'n
kresta	krest'a
kresto	krest'o
krestoj	krest'o'j
krestojn	krest'o'j'n
kreston	krest'o'n
krestomatio	krestomati'o
krestomation	krestomati'o'n
kreta	kret'a
kretaj	kret'a'j
kreto	kret'o
kreton	kret'o'n
kretano	kret'an'o
kretanoj	kret'an'o'j
kretecaj	kret'ec'a'j
kretinga	kret'ing'a
kretaceo	kretace'o
kretena	kreten'a
kreteno	kreten'o
kretenoj	kreten'o'j
kretono	kreton'o
kreuzo	kreuz'o
krevas	krev'as
krevi	krev'i
krevis	krev'is
krevo	krev'o
krevon	krev'o'n
krevos	krev'os
krevu	krev'u
krevus	krev'us
krevado	krev'ad'o
krevanta	krev'ant'a
krevante	krev'ant'e
krevigas	krev'ig'as
krevigi	krev'ig'i
krevigis	krev'ig'is
krevigado	krev'ig'ad'o
krevigante	krev'ig'ant'e
krevigita	krev'ig'it'a
krevigitaj	krev'ig'it'a'j
krevinta	krev'int'a
krevita	krev'it'a
kria	kri'a
krias	kri'as
krie	kri'e
krii	kri'i
krio	kri'o
krioj	kri'o'j
kriojn	kri'o'j'n
krion	kri'o'n
krios	kri'os
kriu	kri'u
krius	kri'us
kriaĉas	kri'aĉ'as
kriaĉi	kri'aĉ'i
kriaĉo	kri'aĉ'o
kriadi	kri'ad'i
kriadis	kri'ad'is
kriado	kri'ad'o
kriadon	kri'ad'o'n
krianta	kri'ant'a
kriantaj	kri'ant'a'j
kriantan	kri'ant'a'n
kriante	kri'ant'e
kriegas	kri'eg'as
kriegi	kri'eg'i
kriegis	kri'eg'is
kriego	kri'eg'o
kriegoj	kri'eg'o'j
kriegojn	kri'eg'o'j'n
kriegon	kri'eg'o'n
kriegado	kri'eg'ad'o
krieganta	kri'eg'ant'a
kriegante	kri'eg'ant'e
krietis	kri'et'is
kriinte	kri'int'e
krisigno	kri'sign'o
krisignon	kri'sign'o'n
kribras	kribr'as
kribri	kribr'i
kribrado	kribr'ad'o
kribrilo	kribr'il'o
kribriloj	kribr'il'o'j
kribrilon	kribr'il'o'n
kriĉis	kriĉ'is
kriĉo	kriĉ'o
krifoj	krif'o'j
kriketo	kriket'o
kriketon	kriket'o'n
kriketteamo	kriket'team'o
krilo	kril'o
krima	krim'a
krimaj	krim'a'j
krimajn	krim'a'j'n
kriman	krim'a'n
krimas	krim'as
krime	krim'e
krimis	krim'is
krimo	krim'o
krimoj	krim'o'j
krimojn	krim'o'j'n
krimon	krim'o'n
krimado	krim'ad'o
krimago	krim'ag'o
krimeco	krim'ec'o
krimecon	krim'ec'o'n
krimema	krim'em'a
krimeto	krim'et'o
krimfrekvencoj	krim'frekvenc'o'j
krimigas	krim'ig'as
kriminto	krim'int'o
krimintoj	krim'int'o'j
krimkodo	krim'kod'o
krimloko	krim'lok'o
krimmedicina	krim'medicin'a
krimmedicinaj	krim'medicin'a'j
krimpatologo	krim'patolog'o
krimprocesoj	krim'proces'o'j
krimromano	krim'roman'o
krimromanoj	krim'roman'o'j
krimromanojn	krim'roman'o'j'n
krimulo	krim'ul'o
krimuloj	krim'ul'o'j
krimulojn	krim'ul'o'j'n
krimulon	krim'ul'o'n
krimea	krime'a
krimeaj	krime'a'j
krimean	krime'a'n
krimeo	krime'o
krimeon	krime'o'n
krimetatara	krime'tatar'a
krimetataroj	krime'tatar'o'j
kriminala	kriminal'a
kriminalaj	kriminal'a'j
kriminalan	kriminal'a'n
kriminologio	kriminologi'o
kripo	krip'o
kripla	kripl'a
kriplaj	kripl'a'j
kriplan	kripl'a'n
kriple	kripl'e
kriplaĵoj	kripl'aĵ'o'j
kripleco	kripl'ec'o
kripliga	kripl'ig'a
kripligas	kripl'ig'as
kripligi	kripl'ig'i
kripligis	kripl'ig'is
kripligo	kripl'ig'o
kripligita	kripl'ig'it'a
kripligitaj	kripl'ig'it'a'j
kripligitan	kripl'ig'it'a'n
kripliĝo	kripl'iĝ'o
kripliĝoj	kripl'iĝ'o'j
kripliĝojn	kripl'iĝ'o'j'n
kripliĝon	kripl'iĝ'o'n
kriplulo	kripl'ul'o
kripluloj	kripl'ul'o'j
kriplulojn	kripl'ul'o'j'n
kripta	kript'a
kriptaj	kript'a'j
kripto	kript'o
kriptoj	kript'o'j
kripton	kript'o'n
kriptanalizo	kript'analiz'o
kriptiga	kript'ig'a
kriptigaj	kript'ig'a'j
kriptografio	kriptografi'o
krisolo	krisol'o
krispa	krisp'a
krispaj	krisp'a'j
krispajn	krisp'a'j'n
krispan	krisp'a'n
krispigas	krisp'ig'as
krispigita	krisp'ig'it'a
krista	krist'a
kristan	krist'a'n
kristo	krist'o
kriston	krist'o'n
kristana	krist'an'a
kristanaj	krist'an'a'j
kristanajn	krist'an'a'j'n
kristanan	krist'an'a'n
kristane	krist'an'e
kristano	krist'an'o
kristanoj	krist'an'o'j
kristanojn	krist'an'o'j'n
kristanon	krist'an'o'n
kristanaro	krist'an'ar'o
kristanaron	krist'an'ar'o'n
kristandemokrata	krist'an'demokrat'a
kristandemokratoj	krist'an'demokrat'o'j
kristaneco	krist'an'ec'o
kristanecon	krist'an'ec'o'n
kristanigi	krist'an'ig'i
kristanigo	krist'an'ig'o
kristanigon	krist'an'ig'o'n
kristanigitaj	krist'an'ig'it'a'j
kristaniĝis	krist'an'iĝ'is
kristaniĝo	krist'an'iĝ'o
kristanino	krist'an'in'o
kristanisma	krist'an'ism'a
kristanismaj	krist'an'ism'a'j
kristanismo	krist'an'ism'o
kristanismon	krist'an'ism'o'n
kristarbon	krist'arb'o'n
kristismo	krist'ism'o
kristnaska	krist'nask'a
kristnaskaj	krist'nask'a'j
kristnaskajn	krist'nask'a'j'n
kristnaskan	krist'nask'a'n
kristnaske	krist'nask'e
kristnasko	krist'nask'o
kristnaskon	krist'nask'o'n
kristonaska	krist'o'nask'a
kristonasko	krist'o'nask'o
kristologia	krist'olog'i'a
kristologiaj	krist'olog'i'a'j
kristologio	krist'olog'i'o
kristala	kristal'a
kristalaj	kristal'a'j
kristalajn	kristal'a'j'n
kristalan	kristal'a'n
kristale	kristal'e
kristalo	kristal'o
kristaloj	kristal'o'j
kristalojn	kristal'o'j'n
kristalon	kristal'o'n
kristalblanka	kristal'blank'a
kristaleca	kristal'ec'a
kristaligas	kristal'ig'as
kristaligi	kristal'ig'i
kristaligis	kristal'ig'is
kristaligita	kristal'ig'it'a
kristaliĝas	kristal'iĝ'as
kristaliĝis	kristal'iĝ'is
kristaliĝo	kristal'iĝ'o
kristalklara	kristal'klar'a
kristalkrado	kristal'krad'o
kristalografo	kristal'o'graf'o
kristalografio	kristal'o'graf'i'o
kristalsistemo	kristal'sistem'o
kristalstrukturo	kristal'struktur'o
kristalstrukturon	kristal'struktur'o'n
kristalineco	kristalin'ec'o
kristiano	kristian'o
kristianismo	kristian'ism'o
kristina	kristin'a
kristino	kristin'o
kristoforo	kristofor'o
kriŝna	kriŝn'a
kriŝno	kriŝn'o
kriteria	kriteri'a
kriterio	kriteri'o
kriterioj	kriteri'o'j
kriteriojn	kriteri'o'j'n
kriterion	kriteri'o'n
kritika	kritik'a
kritikaj	kritik'a'j
kritikajn	kritik'a'j'n
kritikan	kritik'a'n
kritikas	kritik'as
kritike	kritik'e
kritiki	kritik'i
kritikis	kritik'is
kritiko	kritik'o
kritikoj	kritik'o'j
kritikojn	kritik'o'j'n
kritikon	kritik'o'n
kritikos	kritik'os
kritiku	kritik'u
kritikaĉas	kritik'aĉ'as
kritikaĉi	kritik'aĉ'i
kritikado	kritik'ad'o
kritikadon	kritik'ad'o'n
kritikanta	kritik'ant'a
kritikantaj	kritik'ant'a'j
kritikante	kritik'ant'e
kritikanto	kritik'ant'o
kritikantoj	kritik'ant'o'j
kritikantojn	kritik'ant'o'j'n
kritikata	kritik'at'a
kritikataj	kritik'at'a'j
kritikema	kritik'em'a
kritikemaj	kritik'em'a'j
kritikeme	kritik'em'e
kritikemo	kritik'em'o
kritikinda	kritik'ind'a
kritikindaj	kritik'ind'a'j
kritikindan	kritik'ind'a'n
kritikismo	kritik'ism'o
kritikisto	kritik'ist'o
kritikistoj	kritik'ist'o'j
kritikistojn	kritik'ist'o'j'n
kritikiston	kritik'ist'o'n
kritikistaplaŭdo	kritik'ist'aplaŭd'o
kritikistaplaŭdon	kritik'ist'aplaŭd'o'n
kritikistaro	kritik'ist'ar'o
kritikita	kritik'it'a
kritikitaj	kritik'it'a'j
kritikuloj	kritik'ul'o'j
kriza	kriz'a
krizaj	kriz'a'j
krizajn	kriz'a'j'n
krizan	kriz'a'n
krize	kriz'e
krizo	kriz'o
krizoj	kriz'o'j
krizojn	kriz'o'j'n
krizon	kriz'o'n
krizhelpa	kriz'help'a
krizhelpaj	kriz'help'a'j
krizhelpajn	kriz'help'a'j'n
krizhelpo	kriz'help'o
krizhelpoj	kriz'help'o'j
krizhelpon	kriz'help'o'n
krizostato	kriz'o'stat'o
krizokazo	kriz'okaz'o
krizalido	krizalid'o
krizantemo	krizantem'o
krizantemoj	krizantem'o'j
kroata	kroat'a
kroataj	kroat'a'j
kroatajn	kroat'a'j'n
kroatan	kroat'a'n
kroate	kroat'e
kroato	kroat'o
kroatoj	kroat'o'j
kroatia	kroat'i'a
kroatiaj	kroat'i'a'j
kroatio	kroat'i'o
kroation	kroat'i'o'n
kroatujo	kroat'uj'o
kroĉas	kroĉ'as
kroĉi	kroĉ'i
kroĉis	kroĉ'is
kroĉiĝas	kroĉ'iĝ'as
kroĉiĝis	kroĉ'iĝ'is
kroĉiĝante	kroĉ'iĝ'ant'e
kroĉita	kroĉ'it'a
kroĉitaj	kroĉ'it'a'j
kroketo	kroket'o
krokodila	krokodil'a
krokodili	krokodil'i
krokodilo	krokodil'o
krokodiloj	krokodil'o'j
krokodilojn	krokodil'o'j'n
krokodilon	krokodil'o'n
krokodilado	krokodil'ad'o
krom	krom
kroma	krom'a
kromaj	krom'a'j
kromajn	krom'a'j'n
kroman	krom'a'n
krome	krom'e
kromo	krom'o
kromaĵo	krom'aĵ'o
kromaĵoj	krom'aĵ'o'j
kromakcento	krom'akcent'o
kromakcentoj	krom'akcent'o'j
kromalie	krom'ali'e
kromedzino	krom'edz'in'o
kromefiko	krom'efik'o
kromefikoj	krom'efik'o'j
kromefikojn	krom'efik'o'j'n
kromefikon	krom'efik'o'n
kromfakturo	krom'faktur'o
kromgusto	krom'gust'o
kromkostoj	krom'kost'o'j
kromlaboro	krom'labor'o
kromnomas	krom'nom'as
kromnomis	krom'nom'is
kromnomo	krom'nom'o
kromnomoj	krom'nom'o'j
kromnomon	krom'nom'o'n
kromnomata	krom'nom'at'a
kromnomita	krom'nom'it'a
kromprodukto	krom'produkt'o
kromproduktoj	krom'produkt'o'j
kromproduktojn	krom'produkt'o'j'n
kromprogramo	krom'program'o
kromprogramoj	krom'program'o'j
kromsignoj	krom'sign'o'j
kromvelo	krom'vel'o
kromata	kromat'a
kromataj	kromat'a'j
kromatajn	kromat'a'j'n
kromatan	kromat'a'n
kromate	kromat'e
kromatoforoj	kromatofor'o'j
kromatografio	kromatografi'o
kromio	kromi'o
kromiato	kromi'at'o
kromosoma	kromosom'a
kromosomaj	kromosom'a'j
kromosoman	kromosom'a'n
kromosomo	kromosom'o
kromosomoj	kromosom'o'j
kromosomojn	kromosom'o'j'n
kromosomon	kromosom'o'n
krona	kron'a
kronas	kron'as
kroni	kron'i
kronis	kron'is
krono	kron'o
kronoj	kron'o'j
kronojn	kron'o'j'n
kronon	kron'o'n
kronos	kron'os
kronado	kron'ad'o
kronadon	kron'ad'o'n
kronata	kron'at'a
kroniĝis	kron'iĝ'is
kronita	kron'it'a
kronitaj	kron'it'a'j
kronitan	kron'it'a'n
kronlando	kron'land'o
kronprinco	kron'princ'o
kronviruso	kron'virus'o
kronika	kronik'a
kronikaj	kronik'a'j
kronikajn	kronik'a'j'n
kronikan	kronik'a'n
kronikas	kronik'as
kronike	kronik'e
kroniko	kronik'o
kronikoj	kronik'o'j
kronikojn	kronik'o'j'n
kronikon	kronik'o'n
kronikisto	kronik'ist'o
kronikistoj	kronik'ist'o'j
kronologia	kronologi'a
kronologiaj	kronologi'a'j
kronologian	kronologi'a'n
kronologie	kronologi'e
kronologio	kronologi'o
kronologion	kronologi'o'n
kropo	krop'o
krotalo	krotal'o
krotaloj	krotal'o'j
krozas	kroz'as
krozis	kroz'is
krozado	kroz'ad'o
krozilo	kroz'il'o
krozmisiloj	kroz'misil'o'j
krozoŝipo	kroz'o'ŝip'o
krozoŝipoj	kroz'o'ŝip'o'j
krozŝipo	kroz'ŝip'o
krozŝipoj	kroz'ŝip'o'j
kruca	kruc'a
krucaj	kruc'a'j
krucan	kruc'a'n
krucas	kruc'as
kruce	kruc'e
kruci	kruc'i
krucis	kruc'is
kruco	kruc'o
krucoj	kruc'o'j
krucojn	kruc'o'j'n
krucon	kruc'o'n
krucado	kruc'ad'o
krucanta	kruc'ant'a
krucantaj	kruc'ant'a'j
krucante	kruc'ant'e
krucbabilo	kruc'babil'o
krucbredi	kruc'bred'i
krucbredado	kruc'bred'ad'o
krucdisciplina	kruc'disciplin'a
kruceto	kruc'et'o
krucforma	kruc'form'a
kruciginte	kruc'ig'int'e
krucigitaj	kruc'ig'it'a'j
kruciĝas	kruc'iĝ'as
kruciĝis	kruc'iĝ'is
kruciĝo	kruc'iĝ'o
kruciĝoj	kruc'iĝ'o'j
kruciĝantaj	kruc'iĝ'ant'a'j
kruciĝejo	kruc'iĝ'ej'o
krucinte	kruc'int'e
krucistaj	kruc'ist'a'j
krucisto	kruc'ist'o
krucistoj	kruc'ist'o'j
krucistojn	kruc'ist'o'j'n
krucita	kruc'it'a
krucitaj	kruc'it'a'j
kruckavaliroj	kruc'kavalir'o'j
krucmilito	kruc'milit'o
krucmilitoj	kruc'milit'o'j
krucmiliton	kruc'milit'o'n
krucmilitistaj	kruc'milit'ist'a'j
krucmilitistoj	kruc'milit'ist'o'j
krucosignis	kruc'o'sign'is
krucosigno	kruc'o'sign'o
krucosignon	kruc'o'sign'o'n
krucpolenado	kruc'polen'ad'o
krucumas	kruc'um'as
krucumi	kruc'um'i
krucumis	kruc'um'is
krucumo	kruc'um'o
krucumon	kruc'um'o'n
krucumado	kruc'um'ad'o
krucumita	kruc'um'it'a
krucumito	kruc'um'it'o
krucvojo	kruc'voj'o
krucvojoj	kruc'voj'o'j
krucvojon	kruc'voj'o'n
krucvortenigmo	kruc'vort'enigm'o
krucvortenigmon	kruc'vort'enigm'o'n
krucifikso	krucifiks'o
krucifiksoj	krucifiks'o'j
krucifikson	krucifiks'o'n
krucho	kruĉ'o
kruĉo	kruĉ'o
kruĉoj	kruĉ'o'j
kruĉojn	kruĉ'o'j'n
kruĉon	kruĉ'o'n
kruda	krud'a
krudaj	krud'a'j
krudajn	krud'a'j'n
krudan	krud'a'n
krude	krud'e
krudaĵo	krud'aĵ'o
krudaĵoj	krud'aĵ'o'j
krudaĵojn	krud'aĵ'o'j'n
krudaĵon	krud'aĵ'o'n
krudeco	krud'ec'o
krudecon	krud'ec'o'n
krudfero	krud'fer'o
krudmaterialo	krud'material'o
krudmaterialoj	krud'material'o'j
krudmaterialojn	krud'material'o'j'n
krudmaterialon	krud'material'o'n
krudulo	krud'ul'o
krudvaro	krud'var'o
krudvaroj	krud'var'o'j
krudvarojn	krud'var'o'j'n
krudvaron	krud'var'o'n
kruela	kruel'a
kruelaj	kruel'a'j
kruelajn	kruel'a'j'n
kruelan	kruel'a'n
kruelas	kruel'as
kruele	kruel'e
kruelo	kruel'o
kruelon	kruel'o'n
kruelaĵo	kruel'aĵ'o
kruelaĵoj	kruel'aĵ'o'j
kruelaĵojn	kruel'aĵ'o'j'n
krueleco	kruel'ec'o
kruelecon	kruel'ec'o'n
kruelega	kruel'eg'a
kruelegaj	kruel'eg'a'j
kruelege	kruel'eg'e
kruelulo	kruel'ul'o
kruro	krur'o
kruroj	krur'o'j
krurojn	krur'o'j'n
kruron	krur'o'n
kruretoj	krur'et'o'j
krurumoj	krur'um'o'j
krustan	krust'a'n
krusto	krust'o
krustoj	krust'o'j
kruston	krust'o'n
krusteca	krust'ec'a
krustuloj	krust'ul'o'j
krustulojn	krust'ul'o'j'n
kruta	krut'a
krutaj	krut'a'j
krutajn	krut'a'j'n
krutan	krut'a'n
krute	krut'e
krutaĵo	krut'aĵ'o
krutaĵoj	krut'aĵ'o'j
krutaĵon	krut'aĵ'o'n
kruteco	krut'ec'o
ksavero	ksaver'o
ksenofobia	ksenofob'i'a
ksenofobiaj	ksenofob'i'a'j
ksenofobio	ksenofob'i'o
ksenofobion	ksenofob'i'o'n
ksenofono	ksenofon'o
ksenono	ksenon'o
ksilografio	ksilograf'i'o
ksilografiaĵo	ksilograf'i'aĵ'o
ksilografiaĵoj	ksilograf'i'aĵ'o'j
kuba	kub'a
kubaj	kub'a'j
kubajn	kub'a'j'n
kuban	kub'a'n
kubo	kub'o
kuboj	kub'o'j
kubojn	kub'o'j'n
kubon	kub'o'n
kubano	kub'an'o
kubanoj	kub'an'o'j
kubisma	kub'ism'a
kubismo	kub'ism'o
kubute	kubut'e
kubuto	kubut'o
kubutoj	kubut'o'j
kubutojn	kubut'o'j'n
kubuton	kubut'o'n
kudras	kudr'as
kudri	kudr'i
kudris	kudr'is
kudrado	kudr'ad'o
kudradon	kudr'ad'o'n
kudrante	kudr'ant'e
kudrero	kudr'er'o
kudreroj	kudr'er'o'j
kudrerojn	kudr'er'o'j'n
kudrilo	kudr'il'o
kudriloj	kudr'il'o'j
kudrilon	kudr'il'o'n
kudristino	kudr'ist'in'o
kudrita	kudr'it'a
kudritaj	kudr'it'a'j
kudromaŝino	kudr'o'maŝin'o
kudromaŝinoj	kudr'o'maŝin'o'j
kufo	kuf'o
kufon	kuf'o'n
kufovestita	kuf'o'vest'it'a
kuglo	kugl'o
kugloj	kugl'o'j
kuglojn	kugl'o'j'n
kuglon	kugl'o'n
kuglego	kugl'eg'o
kuira	kuir'a
kuiras	kuir'as
kuiri	kuir'i
kuiris	kuir'is
kuiro	kuir'o
kuiros	kuir'os
kuiru	kuir'u
kuiradis	kuir'ad'is
kuirado	kuir'ad'o
kuiradon	kuir'ad'o'n
kuiraĵo	kuir'aĵ'o
kuiraĵoj	kuir'aĵ'o'j
kuiraĵon	kuir'aĵ'o'n
kuiranta	kuir'ant'a
kuirante	kuir'ant'e
kuirarta	kuir'art'a
kuirartaj	kuir'art'a'j
kuirartajn	kuir'art'a'j'n
kuirarto	kuir'art'o
kuirartoj	kuir'art'o'j
kuirartojn	kuir'art'o'j'n
kuirarton	kuir'art'o'n
kuirata	kuir'at'a
kuiratan	kuir'at'a'n
kuireja	kuir'ej'a
kuirejaj	kuir'ej'a'j
kuirejan	kuir'ej'a'n
kuirejo	kuir'ej'o
kuirejoj	kuir'ej'o'j
kuirejojn	kuir'ej'o'j'n
kuirejon	kuir'ej'o'n
kuirforno	kuir'forn'o
kuirfornoj	kuir'forn'o'j
kuirilo	kuir'il'o
kuiriloj	kuir'il'o'j
kuirilojn	kuir'il'o'j'n
kuirilaro	kuir'il'ar'o
kuiristo	kuir'ist'o
kuiristoj	kuir'ist'o'j
kuiristojn	kuir'ist'o'j'n
kuiriston	kuir'ist'o'n
kuiristino	kuir'ist'in'o
kuiristinon	kuir'ist'in'o'n
kuirita	kuir'it'a
kuiritaj	kuir'it'a'j
kuiritajn	kuir'it'a'j'n
kuiritan	kuir'it'a'n
kuirite	kuir'it'e
kuirlibroj	kuir'libr'o'j
kuirmaniero	kuir'manier'o
kuiroleo	kuir'ole'o
kuirpoto	kuir'pot'o
kuirpotoj	kuir'pot'o'j
kuirpoton	kuir'pot'o'n
kuko	kuk'o
kukoj	kuk'o'j
kukojn	kuk'o'j'n
kukon	kuk'o'n
kuketo	kuk'et'o
kuketoj	kuk'et'o'j
kuketojn	kuk'et'o'j'n
kuketon	kuk'et'o'n
kuketokuiristino	kuk'et'o'kuir'ist'in'o
kukolo	kukol'o
kukoloj	kukol'o'j
kukolon	kukol'o'n
kukumo	kukum'o
kukumoj	kukum'o'j
kukumojn	kukum'o'j'n
kukumon	kukum'o'n
kukurba	kukurb'a
kukurban	kukurb'a'n
kukurbo	kukurb'o
kukurboj	kukurb'o'j
kukurbojn	kukurb'o'j'n
kukurbon	kukurb'o'n
kukurbacoj	kukurb'ac'o'j
kukurbokapo	kukurb'o'kap'o
kukurbokapon	kukurb'o'kap'o'n
kulo	kul'o
kuloj	kul'o'j
kulojn	kul'o'j'n
kuledo	kul'ed'o
kulakoj	kulak'o'j
kulero	kuler'o
kuleroj	kuler'o'j
kulerojn	kuler'o'j'n
kuleron	kuler'o'n
kulereto	kuler'et'o
kulioj	kuli'o'j
kulinara	kulinar'a
kulinaraj	kulinar'a'j
kuliso	kulis'o
kulisoj	kulis'o'j
kulisojn	kulis'o'j'n
kulmina	kulmin'a
kulminas	kulmin'as
kulmine	kulmin'e
kulminis	kulmin'is
kulmino	kulmin'o
kulminoj	kulmin'o'j
kulminon	kulmin'o'n
kulminaĵo	kulmin'aĵ'o
kulminaĵoj	kulmin'aĵ'o'j
kulminaĵojn	kulmin'aĵ'o'j'n
kulminante	kulmin'ant'e
kulombo	kulomb'o
kulpa	kulp'a
kulpaj	kulp'a'j
kulpan	kulp'a'n
kulpas	kulp'as
kulpe	kulp'e
kulpi	kulp'i
kulpis	kulp'is
kulpo	kulp'o
kulpoj	kulp'o'j
kulpojn	kulp'o'j'n
kulpon	kulp'o'n
kulpos	kulp'os
kulpus	kulp'us
kulpanto	kulp'ant'o
kulpeco	kulp'ec'o
kulpecon	kulp'ec'o'n
kulpigas	kulp'ig'as
kulpigi	kulp'ig'i
kulpigis	kulp'ig'is
kulpigo	kulp'ig'o
kulpigoj	kulp'ig'o'j
kulpigon	kulp'ig'o'n
kulpigos	kulp'ig'os
kulpigu	kulp'ig'u
kulpigus	kulp'ig'us
kulpigado	kulp'ig'ad'o
kulpigante	kulp'ig'ant'e
kulpigita	kulp'ig'it'a
kulpigitaj	kulp'ig'it'a'j
kulpinto	kulp'int'o
kulpintoj	kulp'int'o'j
kulposento	kulp'o'sent'o
kulpulo	kulp'ul'o
kulpuloj	kulp'ul'o'j
kulpulojn	kulp'ul'o'j'n
kulpulon	kulp'ul'o'n
kulta	kult'a
kultaj	kult'a'j
kultan	kult'a'n
kultas	kult'as
kulti	kult'i
kultis	kult'is
kulto	kult'o
kultoj	kult'o'j
kulton	kult'o'n
kultado	kult'ad'o
kultadon	kult'ad'o'n
kultata	kult'at'a
kultataj	kult'at'a'j
kultejo	kult'ej'o
kultejoj	kult'ej'o'j
kultiva	kultiv'a
kultivas	kultiv'as
kultivi	kultiv'i
kultivis	kultiv'is
kultivo	kultiv'o
kultivoj	kultiv'o'j
kultivado	kultiv'ad'o
kultivadon	kultiv'ad'o'n
kultivaĵo	kultiv'aĵ'o
kultivaĵoj	kultiv'aĵ'o'j
kultivaĵojn	kultiv'aĵ'o'j'n
kultivaĵon	kultiv'aĵ'o'n
kultivaĵoproduktado	kultiv'aĵ'o'produkt'ad'o
kultivaĵorendimentoj	kultiv'aĵ'o'rendiment'o'j
kultivaĵorendimentojn	kultiv'aĵ'o'rendiment'o'j'n
kultivante	kultiv'ant'e
kultivaro	kultiv'ar'o
kultivaroj	kultiv'ar'o'j
kultivata	kultiv'at'a
kultivataj	kultiv'at'a'j
kultivciklo	kultiv'cikl'o
kultivebla	kultiv'ebl'a
kultiveblaj	kultiv'ebl'a'j
kultivejo	kultiv'ej'o
kultivejoj	kultiv'ej'o'j
kultiviĝas	kultiv'iĝ'as
kultivisto	kultiv'ist'o
kultivistoj	kultiv'ist'o'j
kultivistojn	kultiv'ist'o'j'n
kultivita	kultiv'it'a
kultivitaj	kultiv'it'a'j
kultivitajn	kultiv'it'a'j'n
kultivitan	kultiv'it'a'n
kultura	kultur'a
kulturaj	kultur'a'j
kulturajn	kultur'a'j'n
kulturan	kultur'a'n
kulturas	kultur'as
kulture	kultur'e
kulturi	kultur'i
kulturis	kultur'is
kulturo	kultur'o
kulturoj	kultur'o'j
kulturojn	kultur'o'j'n
kulturon	kultur'o'n
kulturado	kultur'ad'o
kulturadon	kultur'ad'o'n
kulturaĵo	kultur'aĵ'o
kulturaĵoj	kultur'aĵ'o'j
kulturata	kultur'at'a
kulturataj	kultur'at'a'j
kulturcentro	kultur'centr'o
kulturcentroj	kultur'centr'o'j
kulturdiferencoj	kultur'diferenc'o'j
kulturdiferencojn	kultur'diferenc'o'j'n
kulturdomo	kultur'dom'o
kulturevoluo	kultur'evolu'o
kulturformoj	kultur'form'o'j
kulturheredaĵo	kultur'hered'aĵ'o
kulturhistorio	kultur'histori'o
kulturigo	kultur'ig'o
kulturimpreso	kultur'impres'o
kulturimpresoj	kultur'impres'o'j
kulturindustrio	kultur'industri'o
kulturita	kultur'it'a
kulturitaj	kultur'it'a'j
kulturligo	kultur'lig'o
kulturlingvo	kultur'lingv'o
kulturlingvoj	kultur'lingv'o'j
kulturpalaco	kultur'palac'o
kulturplanto	kultur'plant'o
kulturplantoj	kultur'plant'o'j
kulturpomo	kultur'pom'o
kulturrelativismo	kultur'relativ'ism'o
kultursciencoj	kultur'scienc'o'j
kulturtradicioj	kultur'tradici'o'j
kulturtradiciojn	kultur'tradici'o'j'n
kulturvaloroj	kultur'valor'o'j
kulturvalorojn	kultur'valor'o'j'n
kulturvario	kultur'vari'o
kulturvarioj	kultur'vari'o'j
kulturvivo	kultur'viv'o
kumino	kumin'o
kumuluso	kumulus'o
kun	kun
kuna	kun'a
kunaj	kun'a'j
kunajn	kun'a'j'n
kunan	kun'a'n
kunas	kun'as
kune	kun'e
kuno	kun'o
kunagas	kun'ag'as
kunagi	kun'ag'i
kunagadi	kun'ag'ad'i
kunagado	kun'ag'ad'o
kunaĵo	kun'aĵ'o
kunaŭtoris	kun'aŭtor'is
kunaŭtoro	kun'aŭtor'o
kunaŭtoroj	kun'aŭtor'o'j
kunbatalanto	kun'batal'ant'o
kunbatalantoj	kun'batal'ant'o'j
kuncelebris	kun'celebr'is
kuncelebrita	kun'celebr'it'a
kuncivitanoj	kun'civit'an'o'j
kundependo	kun'de'pend'o
kundecidi	kun'decid'i
kundirektoro	kun'direktor'o
kundividas	kun'divid'as
kundividi	kun'divid'i
kundividis	kun'divid'is
kundivido	kun'divid'o
kundividu	kun'divid'u
kundividita	kun'divid'it'a
kundividitaj	kun'divid'it'a'j
kuneco	kun'ec'o
kunecoj	kun'ec'o'j
kunecon	kun'ec'o'n
kunekzistas	kun'ekzist'as
kunekzisti	kun'ekzist'i
kunekzistis	kun'ekzist'is
kunekzisto	kun'ekzist'o
kunekziston	kun'ekzist'o'n
kunekzistado	kun'ekzist'ad'o
kunekzistadon	kun'ekzist'ad'o'n
kunestas	kun'est'as
kunesti	kun'est'i
kunestis	kun'est'is
kunesto	kun'est'o
kuneston	kun'est'o'n
kunestado	kun'est'ad'o
kunestadon	kun'est'ad'o'n
kunfalas	kun'fal'as
kunfali	kun'fal'i
kunfalis	kun'fal'is
kunfaldaĵo	kun'fald'aĵ'o
kunfandas	kun'fand'as
kunfandi	kun'fand'i
kunfandis	kun'fand'is
kunfando	kun'fand'o
kunfandado	kun'fand'ad'o
kunfandante	kun'fand'ant'e
kunfandiĝas	kun'fand'iĝ'as
kunfandiĝi	kun'fand'iĝ'i
kunfandiĝis	kun'fand'iĝ'is
kunfandiĝo	kun'fand'iĝ'o
kunfandiĝon	kun'fand'iĝ'o'n
kunfandiĝos	kun'fand'iĝ'os
kunfandita	kun'fand'it'a
kunfanditaj	kun'fand'it'a'j
kunfluas	kun'flu'as
kunfluis	kun'flu'is
kunfluo	kun'flu'o
kunfluejo	kun'flu'ej'o
kunfondis	kun'fond'is
kunfondinto	kun'fond'int'o
kunfondintoj	kun'fond'int'o'j
kunformas	kun'form'as
kunfrapis	kun'frap'is
kunfrapante	kun'frap'ant'e
kunfrato	kun'frat'o
kunfratoj	kun'frat'o'j
kunfunkciebleco	kun'funkci'ebl'ec'o
kunfunkcieblecon	kun'funkci'ebl'ec'o'n
kungluitaj	kun'glu'it'a'j
kungrupiĝis	kun'grup'iĝ'is
kunĝui	kun'ĝu'i
kunhavas	kun'hav'as
kunhavi	kun'hav'i
kunhavis	kun'hav'is
kunhavante	kun'hav'ant'e
kunhavata	kun'hav'at'a
kunhavataj	kun'hav'at'a'j
kunhavigi	kun'hav'ig'i
kunhavita	kun'hav'it'a
kunhelpas	kun'help'as
kunhelpi	kun'help'i
kunhelpis	kun'help'is
kunhelpo	kun'help'o
kunhomo	kun'hom'o
kunhomoj	kun'hom'o'j
kunhomojn	kun'hom'o'j'n
kuniga	kun'ig'a
kunigaj	kun'ig'a'j
kunigas	kun'ig'as
kunigi	kun'ig'i
kunigis	kun'ig'is
kunigo	kun'ig'o
kunigoj	kun'ig'o'j
kunigojn	kun'ig'o'j'n
kunigon	kun'ig'o'n
kunigos	kun'ig'os
kunigu	kun'ig'u
kunigus	kun'ig'us
kunigado	kun'ig'ad'o
kuniganta	kun'ig'ant'a
kunigantaj	kun'ig'ant'a'j
kunigante	kun'ig'ant'e
kunigata	kun'ig'at'a
kunigataj	kun'ig'at'a'j
kuniginte	kun'ig'int'e
kunigita	kun'ig'it'a
kunigitaj	kun'ig'it'a'j
kunigitajn	kun'ig'it'a'j'n
kuniĝas	kun'iĝ'as
kuniĝi	kun'iĝ'i
kuniĝis	kun'iĝ'is
kuniĝo	kun'iĝ'o
kuniĝoj	kun'iĝ'o'j
kuniĝon	kun'iĝ'o'n
kuniĝos	kun'iĝ'os
kuniĝu	kun'iĝ'u
kuniĝus	kun'iĝ'us
kuniĝado	kun'iĝ'ad'o
kuniĝanta	kun'iĝ'ant'a
kuniĝantaj	kun'iĝ'ant'a'j
kuniĝintaj	kun'iĝ'int'a'j
kuniras	kun'ir'as
kuniri	kun'ir'i
kuniris	kun'ir'is
kuniros	kun'ir'os
kuniru	kun'ir'u
kunirigi	kun'ir'ig'i
kunkanti	kun'kant'i
kunkantis	kun'kant'is
kunkreinto	kun'kre'int'o
kunkreskas	kun'kresk'as
kunkreskis	kun'kresk'is
kunkreskinta	kun'kresk'int'a
kunkreskintaj	kun'kresk'int'a'j
kunkudris	kun'kudr'is
kunkulpeco	kun'kulp'ec'o
kunkulpulo	kun'kulp'ul'o
kunkuro	kun'kur'o
kunlabora	kun'labor'a
kunlaboraj	kun'labor'a'j
kunlaborajn	kun'labor'a'j'n
kunlaboran	kun'labor'a'n
kunlaboras	kun'labor'as
kunlabore	kun'labor'e
kunlabori	kun'labor'i
kunlaboris	kun'labor'is
kunlaboro	kun'labor'o
kunlaboroj	kun'labor'o'j
kunlaborojn	kun'labor'o'j'n
kunlaboron	kun'labor'o'n
kunlaboros	kun'labor'os
kunlaboru	kun'labor'u
kunlaborus	kun'labor'us
kunlaborado	kun'labor'ad'o
kunlaboradon	kun'labor'ad'o'n
kunlaboranta	kun'labor'ant'a
kunlaborantaj	kun'labor'ant'a'j
kunlaborante	kun'labor'ant'e
kunlaboranto	kun'labor'ant'o
kunlaborantoj	kun'labor'ant'o'j
kunlaborantojn	kun'labor'ant'o'j'n
kunlaboranton	kun'labor'ant'o'n
kunlaborantaro	kun'labor'ant'ar'o
kunlaborantaroj	kun'labor'ant'ar'o'j
kunlaborantaron	kun'labor'ant'ar'o'n
kunlaborema	kun'labor'em'a
kunlaboremo	kun'labor'em'o
kunlaborintoj	kun'labor'int'o'j
kunlaboristo	kun'labor'ist'o
kunlaboristoj	kun'labor'ist'o'j
kunlernanto	kun'lern'ant'o
kunlernantoj	kun'lern'ant'o'j
kunliga	kun'lig'a
kunligaj	kun'lig'a'j
kunligas	kun'lig'as
kunlige	kun'lig'e
kunligi	kun'lig'i
kunligis	kun'lig'is
kunligo	kun'lig'o
kunligoj	kun'lig'o'j
kunligon	kun'lig'o'n
kunligos	kun'lig'os
kunligu	kun'lig'u
kunligado	kun'lig'ad'o
kunliganta	kun'lig'ant'a
kunligante	kun'lig'ant'e
kunligataj	kun'lig'at'a'j
kunligiĝas	kun'lig'iĝ'as
kunligita	kun'lig'it'a
kunligitaj	kun'lig'it'a'j
kunligitajn	kun'lig'it'a'j'n
kunligitan	kun'lig'it'a'n
kunligite	kun'lig'it'e
kunloĝas	kun'loĝ'as
kunloĝis	kun'loĝ'is
kunloĝanto	kun'loĝ'ant'o
kunludi	kun'lud'i
kunludis	kun'lud'is
kunludo	kun'lud'o
kunludantoj	kun'lud'ant'o'j
kunmetas	kun'met'as
kunmeti	kun'met'i
kunmetis	kun'met'is
kunmeto	kun'met'o
kunmetoj	kun'met'o'j
kunmetojn	kun'met'o'j'n
kunmeton	kun'met'o'n
kunmetu	kun'met'u
kunmetado	kun'met'ad'o
kunmetadon	kun'met'ad'o'n
kunmetaĵo	kun'met'aĵ'o
kunmetaĵoj	kun'met'aĵ'o'j
kunmetaĵojn	kun'met'aĵ'o'j'n
kunmetaĵon	kun'met'aĵ'o'n
kunmetaĵvortoj	kun'met'aĵ'vort'o'j
kunmetante	kun'met'ant'e
kunmetiĝas	kun'met'iĝ'as
kunmetinte	kun'met'int'e
kunmetita	kun'met'it'a
kunmetitaj	kun'met'it'a'j
kunmetitajn	kun'met'it'a'j'n
kunmetitan	kun'met'it'a'n
kunmetite	kun'met'it'e
kunmiksitaj	kun'miks'it'a'j
kunoficiala	kun'oficial'a
kunoficialaj	kun'oficial'a'j
kunordiga	kun'ord'ig'a
kunordigaj	kun'ord'ig'a'j
kunordigan	kun'ord'ig'a'n
kunordigas	kun'ord'ig'as
kunordigi	kun'ord'ig'i
kunordigis	kun'ord'ig'is
kunordigo	kun'ord'ig'o
kunordigon	kun'ord'ig'o'n
kunordigos	kun'ord'ig'os
kunordigado	kun'ord'ig'ad'o
kunordigante	kun'ord'ig'ant'e
kunordiganto	kun'ord'ig'ant'o
kunordigantoj	kun'ord'ig'ant'o'j
kunordigita	kun'ord'ig'it'a
kunordigitaj	kun'ord'ig'it'a'j
kunordigitajn	kun'ord'ig'it'a'j'n
kunordigitan	kun'ord'ig'it'a'n
kunorganizas	kun'organiz'as
kunorganizis	kun'organiz'is
kunparolanto	kun'parol'ant'o
kunparolantoj	kun'parol'ant'o'j
kunplektas	kun'plekt'as
kunplektitaj	kun'plekt'it'a'j
kunportas	kun'port'as
kunporti	kun'port'i
kunportis	kun'port'is
kunportos	kun'port'os
kunportu	kun'port'u
kunportus	kun'port'us
kunportado	kun'port'ad'o
kunportanta	kun'port'ant'a
kunportante	kun'port'ant'e
kunportita	kun'port'it'a
kunportitaj	kun'port'it'a'j
kunportitajn	kun'port'it'a'j'n
kunprema	kun'prem'a
kunpremaj	kun'prem'a'j
kunpremas	kun'prem'as
kunpremi	kun'prem'i
kunpremis	kun'prem'is
kunpremo	kun'prem'o
kunpremado	kun'prem'ad'o
kunpremadon	kun'prem'ad'o'n
kunpremante	kun'prem'ant'e
kunpremata	kun'prem'at'a
kunpremebla	kun'prem'ebl'a
kunpremiĝis	kun'prem'iĝ'is
kunpreminte	kun'prem'int'e
kunpremita	kun'prem'it'a
kunpremitaj	kun'prem'it'a'j
kunpremitajn	kun'prem'it'a'j'n
kunpremitan	kun'prem'it'a'n
kunpremite	kun'prem'it'e
kunprenas	kun'pren'as
kunpreni	kun'pren'i
kunprenis	kun'pren'is
kunprenos	kun'pren'os
kunprenu	kun'pren'u
kunprenus	kun'pren'us
kunprenante	kun'pren'ant'e
kunpreninte	kun'pren'int'e
kunpuŝiĝis	kun'puŝ'iĝ'is
kunpuŝiĝo	kun'puŝ'iĝ'o
kunpuŝiĝoj	kun'puŝ'iĝ'o'j
kunredaktoro	kun'redaktor'o
kunreganto	kun'reg'ant'o
kunrespondeco	kun'respond'ec'o
kunsendas	kun'send'as
kunsentas	kun'sent'as
kunsenti	kun'sent'i
kunsentis	kun'sent'is
kunsento	kun'sent'o
kunsenton	kun'sent'o'n
kunsida	kun'sid'a
kunsidas	kun'sid'as
kunsidi	kun'sid'i
kunsidis	kun'sid'is
kunsido	kun'sid'o
kunsidoj	kun'sid'o'j
kunsidojn	kun'sid'o'j'n
kunsidon	kun'sid'o'n
kunsidos	kun'sid'os
kunsidejo	kun'sid'ej'o
kunskriboj	kun'skrib'o'j
kunstelulo	kun'stel'ul'o
kunstudantoj	kun'stud'ant'o'j
kunteksta	kun'tekst'a
kuntekste	kun'tekst'e
kunteksto	kun'tekst'o
kuntekstoj	kun'tekst'o'j
kuntekstojn	kun'tekst'o'j'n
kuntekston	kun'tekst'o'n
kuntenas	kun'ten'as
kunteni	kun'ten'i
kuntira	kun'tir'a
kuntiras	kun'tir'as
kuntiri	kun'tir'i
kuntiris	kun'tir'is
kuntirado	kun'tir'ad'o
kuntirante	kun'tir'ant'e
kuntiriĝas	kun'tir'iĝ'as
kuntiriĝis	kun'tir'iĝ'is
kuntiriĝo	kun'tir'iĝ'o
kuntiriĝoj	kun'tir'iĝ'o'j
kuntiriĝojn	kun'tir'iĝ'o'j'n
kuntiriĝon	kun'tir'iĝ'o'n
kuntirinte	kun'tir'int'e
kuntirita	kun'tir'it'a
kuntiritaj	kun'tir'it'a'j
kuntrenas	kun'tren'as
kuntreni	kun'tren'i
kuntrenis	kun'tren'is
kunula	kun'ul'a
kunulaj	kun'ul'a'j
kunulo	kun'ul'o
kunuloj	kun'ul'o'j
kunulojn	kun'ul'o'j'n
kunulon	kun'ul'o'n
kunularo	kun'ul'ar'o
kunularon	kun'ul'ar'o'n
kunuleco	kun'ul'ec'o
kunulecon	kun'ul'ec'o'n
kunulino	kun'ul'in'o
kunulinoj	kun'ul'in'o'j
kunulinon	kun'ul'in'o'n
kunvarianca	kun'varianc'a
kunvarianco	kun'varianc'o
kunvena	kun'ven'a
kunvenas	kun'ven'as
kunveni	kun'ven'i
kunvenis	kun'ven'is
kunveno	kun'ven'o
kunvenoj	kun'ven'o'j
kunvenojn	kun'ven'o'j'n
kunvenon	kun'ven'o'n
kunvenos	kun'ven'os
kunvenu	kun'ven'u
kunvenus	kun'ven'us
kunvenadas	kun'ven'ad'as
kunvenadis	kun'ven'ad'is
kunvenado	kun'ven'ad'o
kunvenante	kun'ven'ant'e
kunvenantoj	kun'ven'ant'o'j
kunvenejo	kun'ven'ej'o
kunvenejoj	kun'ven'ej'o'j
kunvenejojn	kun'ven'ej'o'j'n
kunvenejon	kun'ven'ej'o'n
kunvenhalo	kun'ven'hal'o
kunvenigas	kun'ven'ig'as
kunvenigi	kun'ven'ig'i
kunvenigis	kun'ven'ig'is
kunvenigos	kun'ven'ig'os
kunvenigu	kun'ven'ig'u
kunvenigita	kun'ven'ig'it'a
kunveninta	kun'ven'int'a
kunvenintaj	kun'ven'int'a'j
kunveninte	kun'ven'int'e
kunvenintoj	kun'ven'int'o'j
kunvenintojn	kun'ven'int'o'j'n
kunvenita	kun'ven'it'a
kunvenitaj	kun'ven'it'a'j
kunverkis	kun'verk'is
kunveturi	kun'vetur'i
kunveturis	kun'vetur'is
kunveturigi	kun'vetur'ig'i
kunveturigis	kun'vetur'ig'is
kunvivas	kun'viv'as
kunvivi	kun'viv'i
kunvivis	kun'viv'is
kunvivo	kun'viv'o
kunvivon	kun'viv'o'n
kunvivu	kun'viv'u
kunvivado	kun'viv'ad'o
kunvivadon	kun'viv'ad'o'n
kunvojaĝanto	kun'vojaĝ'ant'o
kunvojaĝantoj	kun'vojaĝ'ant'o'j
kunvojaĝantojn	kun'vojaĝ'ant'o'j'n
kunvokas	kun'vok'as
kunvoki	kun'vok'i
kunvokis	kun'vok'is
kunvoko	kun'vok'o
kunvokita	kun'vok'it'a
kunvokitaj	kun'vok'it'a'j
kunvolvita	kun'volv'it'a
kungfua	kungfu'a
kungfuo	kungfu'o
kungfuon	kungfu'o'n
kunikla	kunikl'a
kuniklo	kunikl'o
kunikloj	kunikl'o'j
kuniklojn	kunikl'o'j'n
kuniklon	kunikl'o'n
kunikleto	kunikl'et'o
kupeo	kupe'o
kupeoj	kupe'o'j
kupeojn	kupe'o'j'n
kupeon	kupe'o'n
kupido	kupid'o
kuplado	kupl'ad'o
kupladoj	kupl'ad'o'j
kupladon	kupl'ad'o'n
kuplita	kupl'it'a
kuplitaj	kupl'it'a'j
kupola	kupol'a
kupolo	kupol'o
kupoloj	kupol'o'j
kupolojn	kupol'o'j'n
kupolon	kupol'o'n
kupolhava	kupol'hav'a
kupolhavaj	kupol'hav'a'j
kupono	kupon'o
kuponoj	kupon'o'j
kuponojn	kupon'o'j'n
kuponon	kupon'o'n
kupra	kupr'a
kupraj	kupr'a'j
kuprajn	kupr'a'j'n
kupran	kupr'a'n
kupro	kupr'o
kupron	kupr'o'n
kupristo	kupr'ist'o
kuprogravuro	kupr'o'gravur'o
kuprogravuroj	kupr'o'gravur'o'j
kuprogravurojn	kupr'o'gravur'o'j'n
kuprulo	kupr'ul'o
kura	kur'a
kuras	kur'as
kure	kur'e
kuri	kur'i
kuris	kur'is
kuro	kur'o
kuroj	kur'o'j
kurojn	kur'o'j'n
kuron	kur'o'n
kuros	kur'os
kuru	kur'u
kurus	kur'us
kuradas	kur'ad'as
kuradi	kur'ad'i
kuradis	kur'ad'is
kurado	kur'ad'o
kuradon	kur'ad'o'n
kuranta	kur'ant'a
kurantaj	kur'ant'a'j
kurantajn	kur'ant'a'j'n
kurantan	kur'ant'a'n
kurante	kur'ant'e
kuranto	kur'ant'o
kurantoj	kur'ant'o'j
kuratingi	kur'ating'i
kuratingis	kur'ating'is
kurĉevaloj	kur'ĉeval'o'j
kuregas	kur'eg'as
kuregi	kur'eg'i
kuregis	kur'eg'is
kuregado	kur'eg'ad'o
kuregitaj	kur'eg'it'a'j
kurejo	kur'ej'o
kurejoj	kur'ej'o'j
kurinta	kur'int'a
kurinte	kur'int'e
kuristo	kur'ist'o
kuristoj	kur'ist'o'j
kurulo	kur'ul'o
kuraca	kurac'a
kuracaj	kurac'a'j
kuracajn	kurac'a'j'n
kuracan	kurac'a'n
kuracas	kurac'as
kuraci	kurac'i
kuracis	kurac'is
kuraco	kurac'o
kuracoj	kurac'o'j
kuracojn	kurac'o'j'n
kuracon	kurac'o'n
kuracos	kurac'os
kuracu	kurac'u
kuracado	kurac'ad'o
kuracadon	kurac'ad'o'n
kuracanta	kurac'ant'a
kuracantaj	kurac'ant'a'j
kuracante	kurac'ant'e
kuracanto	kurac'ant'o
kuracarto	kurac'art'o
kuracata	kurac'at'a
kuracataj	kurac'at'a'j
kuracebla	kurac'ebl'a
kuraceblaj	kurac'ebl'a'j
kuracejo	kurac'ej'o
kuracejoj	kurac'ej'o'j
kuracejon	kurac'ej'o'n
kuracherbo	kurac'herb'o
kuracherboj	kurac'herb'o'j
kuracherbon	kurac'herb'o'n
kuraciĝi	kurac'iĝ'i
kuracilo	kurac'il'o
kuraciloj	kurac'il'o'j
kuracilojn	kurac'il'o'j'n
kuracilon	kurac'il'o'n
kuracista	kurac'ist'a
kuracistaj	kurac'ist'a'j
kuracistajn	kurac'ist'a'j'n
kuracistan	kurac'ist'a'n
kuracisto	kurac'ist'o
kuracistoj	kurac'ist'o'j
kuracistojn	kurac'ist'o'j'n
kuraciston	kurac'ist'o'n
kuracistentrepreno	kurac'ist'entrepren'o
kuracistino	kurac'ist'in'o
kuracistservoj	kurac'ist'serv'o'j
kuracita	kurac'it'a
kuracitaj	kurac'it'a'j
kuracloko	kurac'lok'o
kuraclokoj	kurac'lok'o'j
kuracmetodo	kurac'metod'o
kuracplanto	kurac'plant'o
kuracplantoj	kurac'plant'o'j
kuracserva	kurac'serv'a
kuragha	kuraĝ'a
kuraĝa	kuraĝ'a
kuraĝaj	kuraĝ'a'j
kuraĝajn	kuraĝ'a'j'n
kuraĝan	kuraĝ'a'n
kuraĝas	kuraĝ'as
kuraghe	kuraĝ'e
kuraĝe	kuraĝ'e
kuraĝi	kuraĝ'i
kuraĝis	kuraĝ'is
kuragho	kuraĝ'o
kuraĝo	kuraĝ'o
kuraĝon	kuraĝ'o'n
kuraĝos	kuraĝ'os
kuraĝu	kuraĝ'u
kuraĝus	kuraĝ'us
kuraĝante	kuraĝ'ant'e
kuraĝeco	kuraĝ'ec'o
kuraĝecon	kuraĝ'ec'o'n
kuraĝiga	kuraĝ'ig'a
kuraĝigaj	kuraĝ'ig'a'j
kuraĝigajn	kuraĝ'ig'a'j'n
kuraĝigan	kuraĝ'ig'a'n
kuraĝigas	kuraĝ'ig'as
kuraĝige	kuraĝ'ig'e
kuraĝigi	kuraĝ'ig'i
kuraĝigis	kuraĝ'ig'is
kuraĝigo	kuraĝ'ig'o
kuraĝigoj	kuraĝ'ig'o'j
kuraĝigon	kuraĝ'ig'o'n
kuraĝigos	kuraĝ'ig'os
kuraĝigu	kuraĝ'ig'u
kuraĝigus	kuraĝ'ig'us
kuraĝigante	kuraĝ'ig'ant'e
kuraĝigataj	kuraĝ'ig'at'a'j
kuraĝigita	kuraĝ'ig'it'a
kuraĝigitaj	kuraĝ'ig'it'a'j
kuraĝigite	kuraĝ'ig'it'e
kuraĝiĝis	kuraĝ'iĝ'is
kuraĝulo	kuraĝ'ul'o
kuraĝuloj	kuraĝ'ul'o'j
kuraĝulojn	kuraĝ'ul'o'j'n
kuratora	kurator'a
kuratoro	kurator'o
kuratoroj	kurator'o'j
kuratoron	kurator'o'n
kuratoraro	kurator'ar'o
kuratoreco	kurator'ec'o
kuratorecon	kurator'ec'o'n
kurba	kurb'a
kurbaj	kurb'a'j
kurbajn	kurb'a'j'n
kurban	kurb'a'n
kurbe	kurb'e
kurbo	kurb'o
kurboj	kurb'o'j
kurbojn	kurb'o'j'n
kurbon	kurb'o'n
kurbeco	kurb'ec'o
kurbecon	kurb'ec'o'n
kurbigas	kurb'ig'as
kurbigi	kurb'ig'i
kurbigis	kurb'ig'is
kurbigita	kurb'ig'it'a
kurbigitaj	kurb'ig'it'a'j
kurbiĝas	kurb'iĝ'as
kurbiĝis	kurb'iĝ'is
kurbiĝo	kurb'iĝ'o
kurbiĝoj	kurb'iĝ'o'j
kurbiĝon	kurb'iĝ'o'n
kurbiĝinta	kurb'iĝ'int'a
kurboriĉa	kurb'o'riĉ'a
kurda	kurd'a
kurdo	kurd'o
kurdio	kurd'i'o
kurdistano	kurdistan'o
kurenta	kurent'a
kurento	kurent'o
kurentoj	kurent'o'j
kurentojn	kurent'o'j'n
kurenton	kurent'o'n
kurentkonduktilo	kurent'kondukt'il'o
kurentkonduktiloj	kurent'kondukt'il'o'j
kuria	kuri'a
kurio	kuri'o
kuriero	kurier'o
kurieroj	kurier'o'j
kurierojn	kurier'o'j'n
kurieron	kurier'o'n
kurioza	kurioz'a
kuriozaj	kurioz'a'j
kuriozajn	kurioz'a'j'n
kuriozan	kurioz'a'n
kuriozas	kurioz'as
kurioze	kurioz'e
kuriozaĵo	kurioz'aĵ'o
kuriozaĵoj	kurioz'aĵ'o'j
kuriozaĵojn	kurioz'aĵ'o'j'n
kuriozeco	kurioz'ec'o
kurkumo	kurkum'o
kursa	kurs'a
kursaj	kurs'a'j
kurso	kurs'o
kursoj	kurs'o'j
kursojn	kurs'o'j'n
kurson	kurs'o'n
kursano	kurs'an'o
kursanoj	kurs'an'o'j
kursanojn	kurs'an'o'j'n
kursaro	kurs'ar'o
kursejo	kurs'ej'o
kursestro	kurs'estr'o
kursfinintoj	kurs'fin'int'o'j
kursgvidanto	kurs'gvid'ant'o
kursgvidantoj	kurs'gvid'ant'o'j
kurslaboraĵo	kurs'labor'aĵ'o
kurslaboraĵon	kurs'labor'aĵ'o'n
kursiva	kursiv'a
kursivaj	kursiv'a'j
kursivan	kursiv'a'n
kursive	kursiv'e
kursivo	kursiv'o
kursivon	kursiv'o'n
kursoro	kursor'o
kursoron	kursor'o'n
kurta	kurt'a
kurtaj	kurt'a'j
kurtajn	kurt'a'j'n
kurtan	kurt'a'n
kurte	kurt'e
kurtonda	kurt'ond'a
kurteno	kurten'o
kurtenoj	kurten'o'j
kurtenojn	kurten'o'j'n
kurtenon	kurten'o'n
kurza	kurz'a
kurzo	kurz'o
kurzoj	kurz'o'j
kurzojn	kurz'o'j'n
kurzon	kurz'o'n
kuseno	kusen'o
kusenoj	kusen'o'j
kusenojn	kusen'o'j'n
kusenon	kusen'o'n
kuseneto	kusen'et'o
kusenetoj	kusen'et'o'j
kusenetojn	kusen'et'o'j'n
kuseneton	kusen'et'o'n
kuŝa	kuŝ'a
kuŝas	kuŝ'as
kuŝe	kuŝ'e
kuŝi	kuŝ'i
kuŝis	kuŝ'is
kuŝos	kuŝ'os
kuŝu	kuŝ'u
kuŝus	kuŝ'us
kuŝadis	kuŝ'ad'is
kuŝado	kuŝ'ad'o
kuŝanta	kuŝ'ant'a
kuŝantaj	kuŝ'ant'a'j
kuŝantajn	kuŝ'ant'a'j'n
kuŝantan	kuŝ'ant'a'n
kuŝante	kuŝ'ant'e
kuŝejo	kuŝ'ej'o
kuŝejoj	kuŝ'ej'o'j
kuŝejojn	kuŝ'ej'o'j'n
kuŝejon	kuŝ'ej'o'n
kuŝigas	kuŝ'ig'as
kuŝigi	kuŝ'ig'i
kuŝigis	kuŝ'ig'is
kuŝigu	kuŝ'ig'u
kuŝiĝas	kuŝ'iĝ'as
kuŝiĝi	kuŝ'iĝ'i
kuŝiĝis	kuŝ'iĝ'is
kuŝiĝos	kuŝ'iĝ'os
kuŝiĝu	kuŝ'iĝ'u
kuŝinta	kuŝ'int'a
kuŝiro	kuŝ'ir'o
kutima	kutim'a
kutimaj	kutim'a'j
kutimajn	kutim'a'j'n
kutiman	kutim'a'n
kutimas	kutim'as
kutime	kutim'e
kutimi	kutim'i
kutimis	kutim'is
kutimo	kutim'o
kutimoj	kutim'o'j
kutimojn	kutim'o'j'n
kutimon	kutim'o'n
kutimaĉo	kutim'aĉ'o
kutimaro	kutim'ar'o
kutimaroj	kutim'ar'o'j
kutimaron	kutim'ar'o'n
kutimeblo	kutim'ebl'o
kutimiga	kutim'ig'a
kutimigas	kutim'ig'as
kutimigi	kutim'ig'i
kutimigis	kutim'ig'is
kutimigo	kutim'ig'o
kutimiĝas	kutim'iĝ'as
kutimiĝi	kutim'iĝ'i
kutimiĝis	kutim'iĝ'is
kutimiĝo	kutim'iĝ'o
kutimiĝos	kutim'iĝ'os
kutimiĝu	kutim'iĝ'u
kutimiĝinta	kutim'iĝ'int'a
kutimiĝintaj	kutim'iĝ'int'a'j
kutimjuro	kutim'jur'o
kutimklientaj	kutim'klient'a'j
kutro	kutr'o
kuvo	kuv'o
kuvoj	kuv'o'j
kuvon	kuv'o'n
kuvajta	kuvajt'a
kuvajtaj	kuvajt'a'j
kuvajto	kuvajt'o
kuvajton	kuvajt'o'n
kuzo	kuz'o
kuzoj	kuz'o'j
kuzojn	kuz'o'j'n
kuzon	kuz'o'n
kuzgeedziĝo	kuz'ge'edz'iĝ'o
kuzino	kuz'in'o
kuzinoj	kuz'in'o'j
kuzinon	kuz'in'o'n
kvadranto	kvadrant'o
kvadrata	kvadrat'a
kvadrataj	kvadrat'a'j
kvadratajn	kvadrat'a'j'n
kvadratan	kvadrat'a'n
kvadrate	kvadrat'e
kvadrato	kvadrat'o
kvadratoj	kvadrat'o'j
kvadratojn	kvadrat'o'j'n
kvadraton	kvadrat'o'n
kvadratetoj	kvadrat'et'o'j
kvadratita	kvadrat'it'a
kvadratitaj	kvadrat'it'a'j
kvadratitan	kvadrat'it'a'n
kvakas	kvak'as
kvakis	kvak'is
kvakado	kvak'ad'o
kvakadon	kvak'ad'o'n
kvakera	kvaker'a
kvakero	kvaker'o
kvakeroj	kvaker'o'j
kvalifikaj	kvalifik'a'j
kvalifikas	kvalifik'as
kvalifiki	kvalifik'i
kvalifikis	kvalifik'is
kvalifiko	kvalifik'o
kvalifikoj	kvalifik'o'j
kvalifikojn	kvalifik'o'j'n
kvalifikon	kvalifik'o'n
kvalifikado	kvalifik'ad'o
kvalifikiĝas	kvalifik'iĝ'as
kvalifikiĝi	kvalifik'iĝ'i
kvalifikiĝis	kvalifik'iĝ'is
kvalifikiĝintoj	kvalifik'iĝ'int'o'j
kvalifikita	kvalifik'it'a
kvalifikitaj	kvalifik'it'a'j
kvalifikitajn	kvalifik'it'a'j'n
kvalifikitan	kvalifik'it'a'n
kvalita	kvalit'a
kvalitaj	kvalit'a'j
kvalitajn	kvalit'a'j'n
kvalitan	kvalit'a'n
kvalite	kvalit'e
kvalito	kvalit'o
kvalitoj	kvalit'o'j
kvalitojn	kvalit'o'j'n
kvaliton	kvalit'o'n
kvalitkontrolo	kvalit'kontrol'o
kvalitnormojn	kvalit'norm'o'j'n
kvalitosistemo	kvalit'o'sistem'o
kvankam	kvankam
kvankamfrazo	kvankam'fraz'o
kvanta	kvant'a
kvantaj	kvant'a'j
kvantajn	kvant'a'j'n
kvantan	kvant'a'n
kvante	kvant'e
kvanto	kvant'o
kvantoj	kvant'o'j
kvantojn	kvant'o'j'n
kvanton	kvant'o'n
kvanteefikoj	kvant'e'efik'o'j
kvanteefikeco	kvant'e'efik'ec'o
kvanteelektrodinamiko	kvant'e'elektr'o'dinamik'o
kvanteinformoj	kvant'e'inform'o'j
kvantekanalo	kvant'e'kanal'o
kvantekomputado	kvant'e'komput'ad'o
kvantekomputiko	kvant'e'komputik'o
kvantigas	kvant'ig'as
kvantigi	kvant'ig'i
kvantigado	kvant'ig'ad'o
kvantigita	kvant'ig'it'a
kvantigitaj	kvant'ig'it'a'j
kvantmekanika	kvant'mekanik'a
kvantmekanikaj	kvant'mekanik'a'j
kvantuma	kvantum'a
kvantumaj	kvantum'a'j
kvantumajn	kvantum'a'j'n
kvantuman	kvantum'a'n
kvantumoj	kvantum'o'j
kvantumbito	kvantum'bit'o
kvantumbitoj	kvantum'bit'o'j
kvantumbitojn	kvantum'bit'o'j'n
kvantuminsuleto	kvantum'insul'et'o
kvantuminsuletoj	kvantum'insul'et'o'j
kvantumkomputilo	kvantum'komput'il'o
kvantummeĥaniko	kvantum'meĥanik'o
kvantummekaniko	kvantum'mekanik'o
kvantumsistemo	kvantum'sistem'o
kvantumsistemoj	kvantum'sistem'o'j
kvantumteorio	kvantum'teori'o
kvar	kvar
kvara	kvar'a
kvaraj	kvar'a'j
kvaran	kvar'a'n
kvarcent	kvar'cent
kvardek	kvar'dek
kvare	kvar'e
kvarmil	kvar'mil
kvaro	kvar'o
kvaron	kvar'o'n
kvarajarcenta	kvar'a'jar'cent'a
kvaraklasa	kvar'a'klas'a
kvarangula	kvar'angul'a
kvarangulaj	kvar'angul'a'j
kvarangulan	kvar'angul'a'n
kvarangulo	kvar'angul'o
kvaranguloj	kvar'angul'o'j
kvarangulojn	kvar'angul'o'j'n
kvardeka	kvar'dek'a
kvardekaj	kvar'dek'a'j
kvardekdu	kvar'dek'du
kvardeko	kvar'dek'o
kvardekok	kvar'dek'ok
kvardekjara	kvar'dek'jar'a
kvardekjaraĝa	kvar'dek'jar'aĝ'a
kvardimensia	kvar'dimensi'a
kvaredra	kvar'edr'a
kvaredro	kvar'edr'o
kvaretaĝa	kvar'etaĝ'a
kvarflanka	kvar'flank'a
kvarfoje	kvar'foj'e
kvarhidrofurano	kvar'hidr'o'furan'o
kvarhora	kvar'hor'a
kvarjara	kvar'jar'a
kvarjaraj	kvar'jar'a'j
kvarjarajn	kvar'jar'a'j'n
kvarjaran	kvar'jar'a'n
kvarklorido	kvar'klor'id'o
kvarlatera	kvar'later'a
kvarlatero	kvar'later'o
kvarlingva	kvar'lingv'a
kvarmonata	kvar'monat'a
kvarobla	kvar'obl'a
kvaroblan	kvar'obl'a'n
kvaroble	kvar'obl'e
kvarona	kvar'on'a
kvarono	kvar'on'o
kvaronoj	kvar'on'o'j
kvaronojn	kvar'on'o'j'n
kvaronon	kvar'on'o'n
kvaronhora	kvar'on'hor'a
kvaronhoro	kvar'on'hor'o
kvaronhoron	kvar'on'hor'o'n
kvaronjara	kvar'on'jar'a
kvaronjare	kvar'on'jar'e
kvaronjaro	kvar'on'jar'o
kvaronjarcento	kvar'on'jar'cent'o
kvaropa	kvar'op'a
kvarope	kvar'op'e
kvaropo	kvar'op'o
kvaropoj	kvar'op'o'j
kvaropon	kvar'op'o'n
kvarparta	kvar'part'a
kvarpersona	kvar'person'a
kvarpieda	kvar'pied'a
kvarpiede	kvar'pied'e
kvarpieduloj	kvar'pied'ul'o'j
kvarrada	kvar'rad'a
kvarstela	kvar'stel'a
kvartaga	kvar'tag'a
kvarteto	kvar'tet'o
kvartetoj	kvar'tet'o'j
kvarteton	kvar'tet'o'n
kvarvoĉa	kvar'voĉ'a
kvaranteno	kvaranten'o
kvarantenon	kvaranten'o'n
kvarca	kvarc'a
kvarco	kvarc'o
kvarcon	kvarc'o'n
kvarkoj	kvark'o'j
kvarkojn	kvark'o'j'n
kvarto	kvart'o
kvartala	kvartal'a
kvartalaj	kvartal'a'j
kvartalo	kvartal'o
kvartaloj	kvartal'o'j
kvartalojn	kvartal'o'j'n
kvartalon	kvartal'o'n
kvasi	kvas'i
kvasto	kvast'o
kvastoj	kvast'o'j
kvaternara	kvaternar'a
kvazaroj	kvazar'o'j
kvazaŭ	kvazaŭ
kvazaŭa	kvazaŭ'a
kvazaŭaj	kvazaŭ'a'j
kvazaŭajn	kvazaŭ'a'j'n
kvazaŭan	kvazaŭ'a'n
kvazaŭe	kvazaŭ'e
kvazaŭpartikloj	kvazaŭ'partikl'o'j
kveras	kver'as
kverado	kver'ad'o
kverelas	kverel'as
kvereli	kverel'i
kverelis	kverel'is
kverelo	kverel'o
kvereloj	kverel'o'j
kverelojn	kverel'o'j'n
kverelon	kverel'o'n
kverelos	kverel'os
kverelu	kverel'u
kverelus	kverel'us
kverelado	kverel'ad'o
kvereladon	kverel'ad'o'n
kverelantaj	kverel'ant'a'j
kverelante	kverel'ant'e
kverelema	kverel'em'a
kverelemaj	kverel'em'a'j
kvereleto	kverel'et'o
kvereltemo	kverel'tem'o
kverka	kverk'a
kverkaj	kverk'a'j
kverko	kverk'o
kverkoj	kverk'o'j
kverkojn	kverk'o'j'n
kverkon	kverk'o'n
kverkaroj	kverk'ar'o'j
kvesto	kvest'o
kvestoro	kvestor'o
kvestoroj	kvestor'o'j
kvieta	kviet'a
kvietaj	kviet'a'j
kvietajn	kviet'a'j'n
kvietan	kviet'a'n
kvietas	kviet'as
kviete	kviet'e
kvietis	kviet'is
kvieto	kviet'o
kvieton	kviet'o'n
kvietu	kviet'u
kvieteco	kviet'ec'o
kvietecon	kviet'ec'o'n
kvietigas	kviet'ig'as
kvietigi	kviet'ig'i
kvietigis	kviet'ig'is
kvietiĝas	kviet'iĝ'as
kvietiĝi	kviet'iĝ'i
kvietiĝis	kviet'iĝ'is
kvietiĝu	kviet'iĝ'u
kvin	kvin
kvina	kvin'a
kvinaj	kvin'a'j
kvinan	kvin'a'n
kvincent	kvin'cent
kvindek	kvin'dek
kvine	kvin'e
kvino	kvin'o
kvinon	kvin'o'n
kvinses	kvin'ses
kvinaklasa	kvin'a'klas'a
kvinangula	kvin'angul'a
kvinangulo	kvin'angul'o
kvincento	kvin'cent'o
kvindeka	kvin'dek'a
kvindekaj	kvin'dek'a'j
kvindeko	kvin'dek'o
kvindekon	kvin'dek'o'n
kvindekjara	kvin'dek'jar'a
kvinetaĝa	kvin'etaĝ'a
kvinfoje	kvin'foj'e
kvinhora	kvin'hor'a
kvinjambo	kvin'jamb'o
kvinjara	kvin'jar'a
kvinjaraj	kvin'jar'a'j
kvinjaran	kvin'jar'a'n
kvinjarulo	kvin'jar'ul'o
kvinlingva	kvin'lingv'a
kvinmembra	kvin'membr'a
kvinminuta	kvin'minut'a
kvinnombraj	kvin'nombr'a'j
kvinobla	kvin'obl'a
kvinoble	kvin'obl'e
kvinoksido	kvin'oksid'o
kvinono	kvin'on'o
kvinonoj	kvin'on'o'j
kvinonojn	kvin'on'o'j'n
kvinonon	kvin'on'o'n
kvinope	kvin'op'e
kvinopo	kvin'op'o
kvinparta	kvin'part'a
kvinpetalo	kvin'petal'o
kvinpinta	kvin'pint'a
kvinstela	kvin'stel'a
kvintaga	kvin'tag'a
kvintona	kvin'ton'a
kvinto	kvint'o
kvintoj	kvint'o'j
kvinton	kvint'o'n
kvintesenco	kvintesenc'o
kvintesencon	kvintesenc'o'n
kvitancis	kvitanc'is
kvitanco	kvitanc'o
kvitancoj	kvitanc'o'j
kvitancon	kvitanc'o'n
kvizo	kviz'o
kvizoj	kviz'o'j
kvizojn	kviz'o'j'n
kvizon	kviz'o'n
kvociento	kvocient'o
kvocienton	kvocient'o'n
kvorumo	kvorum'o
kvorumon	kvorum'o'n
kvoto	kvot'o
kvotoj	kvot'o'j
kvotojn	kvot'o'j'n
kvoton	kvot'o'n