la	la
labirinta	labirint'a
labirinto	labirint'o
labirintoj	labirint'o'j
labirinton	labirint'o'n
labora	labor'a
laboraj	labor'a'j
laborajn	labor'a'j'n
laboran	labor'a'n
laboras	labor'as
labore	labor'e
labori	labor'i
laboris	labor'is
laboro	labor'o
laboroj	labor'o'j
laborojn	labor'o'j'n
laboron	labor'o'n
laboros	labor'os
laboru	labor'u
laborus	labor'us
laboradas	labor'ad'as
laboradi	labor'ad'i
laboradis	labor'ad'is
laborado	labor'ad'o
laboradon	labor'ad'o'n
laboradu	labor'ad'u
laboraĵo	labor'aĵ'o
laboraĵoj	labor'aĵ'o'j
laboraĵojn	labor'aĵ'o'j'n
laboraĵon	labor'aĵ'o'n
laboraktiva	labor'aktiv'a
laboraktivaj	labor'aktiv'a'j
laboraktivan	labor'aktiv'a'n
laboranta	labor'ant'a
laborantaj	labor'ant'a'j
laborantajn	labor'ant'a'j'n
laborantan	labor'ant'a'n
laborantas	labor'ant'as
laborante	labor'ant'e
laboranto	labor'ant'o
laborantoj	labor'ant'o'j
laborantojn	labor'ant'o'j'n
laboranton	labor'ant'o'n
laborantaro	labor'ant'ar'o
laborantaron	labor'ant'ar'o'n
laborantarano	labor'ant'ar'an'o
laborantaranoj	labor'ant'ar'an'o'j
laborĉambro	labor'ĉambr'o
laborĉambron	labor'ĉambr'o'n
labordaŭro	labor'daŭr'o
labordivido	labor'divid'o
labordividon	labor'divid'o'n
labordonanto	labor'don'ant'o
labordonantoj	labor'don'ant'o'j
laboreblecoj	labor'ebl'ec'o'j
laboregas	labor'eg'as
laboregi	labor'eg'i
laboregis	labor'eg'is
laborego	labor'eg'o
laboregon	labor'eg'o'n
laboreja	labor'ej'a
laborejaj	labor'ej'a'j
laboreje	labor'ej'e
laborejen	labor'ej'e'n
laborejo	labor'ej'o
laborejoj	labor'ej'o'j
laborejojn	labor'ej'o'j'n
laborejon	labor'ej'o'n
laborejĉikanado	labor'ej'ĉikan'ad'o
laborema	labor'em'a
laboremaj	labor'em'a'j
laboreman	labor'em'a'n
laboremas	labor'em'as
laboremo	labor'em'o
laboremon	labor'em'o'n
laborestro	labor'estr'o
laboreto	labor'et'o
laboretoso	labor'etos'o
laboretoson	labor'etos'o'n
laborfluo	labor'flu'o
laborforta	labor'fort'a
laborforto	labor'fort'o
laborfortoj	labor'fort'o'j
laborfortojn	labor'fort'o'j'n
laborforton	labor'fort'o'n
laborgrupo	labor'grup'o
laborgrupoj	labor'grup'o'j
laborgrupojn	labor'grup'o'j'n
laborgrupon	labor'grup'o'n
laborhoroj	labor'hor'o'j
laborhorojn	labor'hor'o'j'n
laboriga	labor'ig'a
laborigas	labor'ig'as
laborigi	labor'ig'i
laborigis	labor'ig'is
laborigo	labor'ig'o
laborilo	labor'il'o
laboriloj	labor'il'o'j
laborilojn	labor'il'o'j'n
laborinta	labor'int'a
laborintaj	labor'int'a'j
laborinte	labor'int'e
laborintensa	labor'intens'a
laborintensaj	labor'intens'a'j
laborisma	labor'ism'a
laborista	labor'ist'a
laboristaj	labor'ist'a'j
laboristajn	labor'ist'a'j'n
laboristan	labor'ist'a'n
laboristo	labor'ist'o
laboristoj	labor'ist'o'j
laboristojn	labor'ist'o'j'n
laboriston	labor'ist'o'n
laboristaklasa	labor'ist'a'klas'a
laboristaklasaj	labor'ist'a'klas'a'j
laboristara	labor'ist'ar'a
laboristaraj	labor'ist'ar'a'j
laboristaro	labor'ist'ar'o
laboristaron	labor'ist'ar'o'n
laboristino	labor'ist'in'o
laboristinoj	labor'ist'in'o'j
laboristpartio	labor'ist'parti'o
laboristregistaro	labor'ist'reg'ist'ar'o
laborita	labor'it'a
laboritaj	labor'it'a'j
laborkampo	labor'kamp'o
laborkampoj	labor'kamp'o'j
laborkantoj	labor'kant'o'j
laborkapabla	labor'kapabl'a
laborkapablaj	labor'kapabl'a'j
laborkapablo	labor'kapabl'o
laborkapablon	labor'kapabl'o'n
laborkondiĉoj	labor'kondiĉ'o'j
laborkondiĉojn	labor'kondiĉ'o'j'n
laborkontenteco	labor'kontent'ec'o
laborkontrakto	labor'kontrakt'o
laborkontraktoj	labor'kontrakt'o'j
laborkontrakton	labor'kontrakt'o'n
laborkosto	labor'kost'o
laborkostoj	labor'kost'o'j
laborkunsido	labor'kun'sid'o
laborkunsidoj	labor'kun'sid'o'j
laborkunuloj	labor'kun'ul'o'j
laborkvanto	labor'kvant'o
laborkvanton	labor'kvant'o'n
laborlikvaĵo	labor'likv'aĵ'o
laborlingvo	labor'lingv'o
laborlingvoj	labor'lingv'o'j
laborlingvojn	labor'lingv'o'j'n
laborlingvon	labor'lingv'o'n
laborloko	labor'lok'o
laborlokoj	labor'lok'o'j
laborlokojn	labor'lok'o'j'n
laborlokon	labor'lok'o'n
labormaniulo	labor'mani'ul'o
labormaniero	labor'manier'o
labormanieron	labor'manier'o'n
labormanko	labor'mank'o
labormedio	labor'medi'o
labormedion	labor'medi'o'n
labormemoro	labor'memor'o
labormerkato	labor'merkat'o
labormerkatoj	labor'merkat'o'j
labormerkaton	labor'merkat'o'n
labormetodo	labor'metod'o
labormetodoj	labor'metod'o'j
laborpago	labor'pag'o
laborpagon	labor'pag'o'n
laborpeco	labor'pec'o
laborpecon	labor'pec'o'n
laborplano	labor'plan'o
laborplanoj	labor'plan'o'j
laborplanon	labor'plan'o'n
laborposteno	labor'posten'o
laborpostenoj	labor'posten'o'j
laborpostenojn	labor'posten'o'j'n
laborpostenon	labor'posten'o'n
laborpraktikadoj	labor'praktik'ad'o'j
laborproduktiveco	labor'produkt'iv'ec'o
laborrenkontiĝo	labor'renkont'iĝ'o
laborrenkontiĝoj	labor'renkont'iĝ'o'j
laborrenkontiĝojn	labor'renkont'iĝ'o'j'n
laborrenkontiĝon	labor'renkont'iĝ'o'n
laborrilata	labor'rilat'a
laborrilataj	labor'rilat'a'j
laborrilaton	labor'rilat'o'n
laborsano	labor'san'o
laborsemajno	labor'semajn'o
laborserĉantoj	labor'serĉ'ant'o'j
laborsindikatoj	labor'sindikat'o'j
laborspaco	labor'spac'o
laborstilo	labor'stil'o
laborstreso	labor'stres'o
laborŝancoj	labor'ŝanc'o'j
laborŝancojn	labor'ŝanc'o'j'n
labortablo	labor'tabl'o
labortablon	labor'tabl'o'n
labortago	labor'tag'o
labortagoj	labor'tag'o'j
labortagon	labor'tag'o'n
labortaskoj	labor'task'o'j
labortempo	labor'temp'o
labortempon	labor'temp'o'n
laborula	labor'ul'a
laborulaj	labor'ul'a'j
laborulo	labor'ul'o
laboruloj	labor'ul'o'j
laborulojn	labor'ul'o'j'n
laborvivo	labor'viv'o
laborvivon	labor'viv'o'n
laboratoria	laboratori'a
laboratoriaj	laboratori'a'j
laboratorian	laboratori'a'n
laboratorie	laboratori'e
laboratorio	laboratori'o
laboratorioj	laboratori'o'j
laboratoriojn	laboratori'o'j'n
laboratorion	laboratori'o'n
laca	lac'a
lacaj	lac'a'j
lacajn	lac'a'j'n
lacan	lac'a'n
lacas	lac'as
lace	lac'e
lacis	lac'is
laco	lac'o
lacon	lac'o'n
laceco	lac'ec'o
lacecon	lac'ec'o'n
lacega	lac'eg'a
lacegaj	lac'eg'a'j
lacegas	lac'eg'as
lacegis	lac'eg'is
lacego	lac'eg'o
laciga	lac'ig'a
lacigaj	lac'ig'a'j
lacigan	lac'ig'a'n
lacigas	lac'ig'as
lacige	lac'ig'e
lacigi	lac'ig'i
lacigis	lac'ig'is
lacigita	lac'ig'it'a
lacigitaj	lac'ig'it'a'j
lacigite	lac'ig'it'e
laciĝas	lac'iĝ'as
laciĝi	lac'iĝ'i
laciĝis	lac'iĝ'is
laciĝo	lac'iĝ'o
laciĝon	lac'iĝ'o'n
laciĝos	lac'iĝ'os
laciĝintaj	lac'iĝ'int'a'j
laciĝinte	lac'iĝ'int'e
lacerto	lacert'o
lacertoj	lacert'o'j
lacertojn	lacert'o'j'n
lacerton	lacert'o'n
laĉas	laĉ'as
laĉi	laĉ'i
laĉis	laĉ'is
laĉo	laĉ'o
laĉoj	laĉ'o'j
laĉojn	laĉ'o'j'n
laĉon	laĉ'o'n
laĉita	laĉ'it'a
laĉitaj	laĉ'it'a'j
lada	lad'a
ladaj	lad'a'j
ladan	lad'a'n
lado	lad'o
ladoj	lad'o'j
ladon	lad'o'n
ladskatolo	lad'skatol'o
ladskatoloj	lad'skatol'o'j
ladskatolojn	lad'skatol'o'j'n
ladskatolon	lad'skatol'o'n
lafaj	laf'a'j
lafo	laf'o
lafoj	laf'o'j
lafon	laf'o'n
laftorentoj	laf'torent'o'j
laga	lag'a
lagaj	lag'a'j
lago	lag'o
lagoj	lag'o'j
lagojn	lag'o'j'n
lagon	lag'o'n
lagbordo	lag'bord'o
lageta	lag'et'a
lageto	lag'et'o
lagetoj	lag'et'o'j
lagetojn	lag'et'o'j'n
lageton	lag'et'o'n
lagobordo	lag'o'bord'o
lagodistrikto	lag'o'distrikt'o
lagopo	lagop'o
lagopoj	lagop'o'j
lagro	lagr'o
lagroj	lagr'o'j
laguna	lagun'a
laguno	lagun'o
lagunoj	lagun'o'j
lagunon	lagun'o'n
laika	laik'a
laikaj	laik'a'j
laikajn	laik'a'j'n
laikan	laik'a'n
laiko	laik'o
laikoj	laik'o'j
laikojn	laik'o'j'n
laikaro	laik'ar'o
laikeco	laik'ec'o
laikismo	laik'ism'o
laikuloj	laik'ul'o'j
laikularo	laik'ul'ar'o
lake	lak'e
lako	lak'o
lakoj	lak'o'j
lakon	lak'o'n
lakaĵoj	lak'aĵ'o'j
lakita	lak'it'a
lakitaj	lak'it'a'j
lakota	lak'ot'a
laktavolo	lak'tavol'o
lakeo	lake'o
lakeoj	lake'o'j
lakeojn	lake'o'j'n
lakona	lakon'a
lakonaj	lakon'a'j
lakone	lakon'e
lakoneco	lakon'ec'o
lakonio	lakon'i'o
lakso	laks'o
lakson	laks'o'n
laksigilo	laks'ig'il'o
laksigiloj	laks'ig'il'o'j
lakta	lakt'a
laktaj	lakt'a'j
laktan	lakt'a'n
lakte	lakt'e
lakto	lakt'o
lakton	lakt'o'n
laktado	lakt'ad'o
laktaĵoj	lakt'aĵ'o'j
laktaĵojn	lakt'aĵ'o'j'n
laktaĵfabriko	lakt'aĵ'fabrik'o
laktata	lakt'at'a
laktato	lakt'at'o
lakteca	lakt'ec'a
laktisto	lakt'ist'o
laktofarmado	lakt'o'farm'ad'o
laktoglandoj	lakt'o'gland'o'j
laktoproduktoj	lakt'o'produkt'o'j
laktoproduktado	lakt'o'produkt'ad'o
laktoproduktadon	lakt'o'produkt'ad'o'n
laktosuko	lakt'o'suk'o
laktosukon	lakt'o'suk'o'n
laktozo	lakt'oz'o
laktozon	lakt'oz'o'n
laktuko	laktuk'o
laktukon	laktuk'o'n
lakuno	lakun'o
lakunoj	lakun'o'j
lama	lam'a
lamaj	lam'a'j
laman	lam'a'n
lamas	lam'as
lame	lam'e
lami	lam'i
lamis	lam'is
lamo	lam'o
lamoj	lam'o'j
lamanta	lam'ant'a
lamante	lam'ant'e
lambastono	lam'baston'o
lambastonoj	lam'baston'o'j
lambastonojn	lam'baston'o'j'n
lambastonon	lam'baston'o'n
lamulo	lam'ul'o
lamao	lama'o
lamaoj	lama'o'j
lamaismo	lama'ism'o
lamanidoj	laman'id'o'j
lamena	lamen'a
lameno	lamen'o
lamenoj	lamen'o'j
lamenaro	lamen'ar'o
lameneroj	lamen'er'o'j
lamenigita	lamen'ig'it'a
lamenigitaj	lamen'ig'it'a'j
lamenligno	lamen'lign'o
lamenta	lament'a
lamentas	lament'as
lamente	lament'e
lamenti	lament'i
lamentis	lament'is
lamento	lament'o
lamentoj	lament'o'j
lamentojn	lament'o'j'n
lamenton	lament'o'n
lamentado	lament'ad'o
lamentadoj	lament'ad'o'j
lamentadon	lament'ad'o'n
lamentante	lament'ant'e
lamio	lami'o
lamiacoj	lami'ac'o'j
lampa	lamp'a
lampo	lamp'o
lampoj	lamp'o'j
lampojn	lamp'o'j'n
lampon	lamp'o'n
lampeto	lamp'et'o
lampetoj	lamp'et'o'j
lampeton	lamp'et'o'n
lamplumo	lamp'lum'o
lampiro	lampir'o
lampiroj	lampir'o'j
lana	lan'a
lanaj	lan'a'j
lanajn	lan'a'j'n
lanan	lan'a'n
lane	lan'e
lano	lan'o
lanoj	lan'o'j
lanon	lan'o'n
lanco	lanc'o
lancoj	lanc'o'j
lancojn	lanc'o'j'n
lancon	lanc'o'n
lancistoj	lanc'ist'o'j
lancopinto	lanc'o'pint'o
lanceloto	lancelot'o
lanĉa	lanĉ'a
lanĉas	lanĉ'as
lanĉi	lanĉ'i
lanĉis	lanĉ'is
lanĉo	lanĉ'o
lanĉoj	lanĉ'o'j
lanĉojn	lanĉ'o'j'n
lanĉon	lanĉ'o'n
lanĉos	lanĉ'os
lanĉu	lanĉ'u
lanĉus	lanĉ'us
lanĉado	lanĉ'ad'o
lanĉanta	lanĉ'ant'a
lanĉante	lanĉ'ant'e
lanĉejo	lanĉ'ej'o
lanĉiĝis	lanĉ'iĝ'is
lanĉiĝo	lanĉ'iĝ'o
lanĉilo	lanĉ'il'o
lanĉiloj	lanĉ'il'o'j
lanĉita	lanĉ'it'a
lanĉitaj	lanĉ'it'a'j
lanĉitajn	lanĉ'it'a'j'n
lanĉitan	lanĉ'it'a'n
lanĉite	lanĉ'it'e
lanĉoveturilo	lanĉ'o'vetur'il'o
lanĉoveturiloj	lanĉ'o'vetur'il'o'j
lanĉota	lanĉ'ot'a
lanĉplatformo	lanĉ'platform'o
landa	land'a
landaj	land'a'j
landajn	land'a'j'n
landan	land'a'n
lande	land'e
landen	land'e'n
lando	land'o
landoj	land'o'j
landojn	land'o'j'n
landon	land'o'n
landano	land'an'o
landanoj	land'an'o'j
landaro	land'ar'o
landaveraĝo	land'averaĝ'o
landestro	land'estr'o
landeto	land'et'o
landinterna	land'intern'a
landinternaj	land'intern'a'j
landinterno	land'intern'o
landinternon	land'intern'o'n
landlima	land'lim'a
landlimaj	land'lim'a'j
landlimajn	land'lim'a'j'n
landliman	land'lim'a'n
landlimas	land'lim'as
landlimo	land'lim'o
landlimoj	land'lim'o'j
landlimojn	land'lim'o'j'n
landlimon	land'lim'o'n
landnomo	land'nom'o
landnomoj	land'nom'o'j
landonomo	land'o'nom'o
landonomoj	land'o'nom'o'j
landonomojn	land'o'nom'o'j'n
landonomon	land'o'nom'o'n
landoparto	land'o'part'o
landopartoj	land'o'part'o'j
landparto	land'part'o
landpartoj	land'part'o'j
landsinkado	land'sink'ad'o
landvojo	land'voj'o
langa	lang'a
lange	lang'e
lango	lang'o
langoj	lang'o'j
langojn	lang'o'j'n
langon	lang'o'n
langopinto	lang'o'pint'o
langvedoko	langvedok'o
langvora	langvor'a
langvoro	langvor'o
lanio	lani'o
lanioj	lani'o'j
lanta	lant'a
lante	lant'e
lanti	lant'i
lantanidoj	lantan'id'o'j
lanterna	lantern'a
lanternaj	lantern'a'j
lanterno	lantern'o
lanternoj	lantern'o'j
lanternojn	lantern'o'j'n
lanternon	lantern'o'n
lanternetoj	lantern'et'o'j
lanuga	lanug'a
lanugaj	lanug'a'j
lanugo	lanug'o
lanugoj	lanug'o'j
lanugon	lanug'o'n
lanugaĵo	lanug'aĵ'o
lanugeca	lanug'ec'a
laosa	laos'a
laoso	laos'o
lapo	lap'o
lapitoj	lapit'o'j
laplaca	laplac'a
laplace	laplac'e
lapona	lapon'a
lapono	lapon'o
lara	lar'a
laraj	lar'a'j
laran	lar'a'n
lare	lar'e
lardo	lard'o
lardon	lard'o'n
larĝa	larĝ'a
larĝaj	larĝ'a'j
larĝajn	larĝ'a'j'n
larĝan	larĝ'a'n
larĝas	larĝ'as
larĝe	larĝ'e
larĝo	larĝ'o
larĝoj	larĝ'o'j
larĝon	larĝ'o'n
larĝasence	larĝ'a'senc'e
larĝbaza	larĝ'baz'a
larĝbenda	larĝ'bend'a
larĝbendaj	larĝ'bend'a'j
larĝbendan	larĝ'bend'a'n
larĝbendo	larĝ'bend'o
larĝeco	larĝ'ec'o
larĝecon	larĝ'ec'o'n
larĝega	larĝ'eg'a
larĝfoliaj	larĝ'foli'a'j
larĝigas	larĝ'ig'as
larĝigi	larĝ'ig'i
larĝigis	larĝ'ig'is
larĝigita	larĝ'ig'it'a
larĝigitaj	larĝ'ig'it'a'j
larĝiĝas	larĝ'iĝ'as
larĝiĝis	larĝ'iĝ'is
larĝkategorioj	larĝ'kategori'o'j
larĝkategoriojn	larĝ'kategori'o'j'n
larĝkorpaj	larĝ'korp'a'j
larĝspektra	larĝ'spektr'a
larĝŝultra	larĝ'ŝultr'a
lariko	larik'o
laringa	laring'a
laringo	laring'o
larma	larm'a
larmas	larm'as
larme	larm'e
larmi	larm'i
larmis	larm'is
larmo	larm'o
larmoj	larm'o'j
larmojn	larm'o'j'n
larmon	larm'o'n
larmante	larm'ant'e
larmiga	larm'ig'a
larmigan	larm'ig'a'n
larmoplenaj	larm'o'plen'a'j
larva	larv'a
larvo	larv'o
larvoj	larv'o'j
larvojn	larv'o'j'n
lasas	las'as
lasi	las'i
lasis	las'is
lasos	las'os
lasu	las'u
lasus	las'us
lasadis	las'ad'is
lasado	las'ad'o
lasanta	las'ant'a
lasante	las'ant'e
lasata	las'at'a
lasataj	las'at'a'j
lasinta	las'int'a
lasinte	las'int'e
lasita	las'it'a
lasitaj	las'it'a'j
lasitajn	las'it'a'j'n
lasitan	las'it'a'n
lasite	las'it'e
lasao	lasa'o
lasciva	lasciv'a
lasera	laser'a
laseraj	laser'a'j
laserajn	laser'a'j'n
laseran	laser'a'n
lasero	laser'o
laseroj	laser'o'j
laserojn	laser'o'j'n
laseron	laser'o'n
laserdisko	laser'disk'o
lasta	last'a
lastaj	last'a'j
lastajn	last'a'j'n
lastan	last'a'n
laste	last'e
lastafoje	last'a'foj'e
lastajare	last'a'jar'e
lastamomente	last'a'moment'e
lastanokte	last'a'nokt'e
lastasemajne	last'a'semajn'e
lastatage	last'a'tag'e
lastatempa	last'a'temp'a
lastatempaj	last'a'temp'a'j
lastatempajn	last'a'temp'a'j'n
lastatempan	last'a'temp'a'n
lastatempe	last'a'temp'e
lastavice	last'a'vic'e
lastfoje	last'foj'e
lastjara	last'jar'a
lastjaraj	last'jar'a'j
lastjare	last'jar'e
lastminuta	last'minut'a
lastminute	last'minut'e
lastmomente	last'moment'e
lastmonate	last'monat'e
lastnokte	last'nokt'e
lastsemajne	last'semajn'e
lastsomere	last'somer'e
lasttempe	last'temp'e
lastvice	last'vic'e
late	lat'e
lato	lat'o
latoj	lat'o'j
latbarilo	lat'bar'il'o
latekso	lateks'o
latenta	latent'a
latentaj	latent'a'j
latentajn	latent'a'j'n
latentan	latent'a'n
latenteco	latent'ec'o
latentecon	latent'ec'o'n
lateran	later'a'n
latero	later'o
lateroj	later'o'j
laterojn	later'o'j'n
lateron	later'o'n
laterala	lateral'a
lateralaj	lateral'a'j
lateralajn	lateral'a'j'n
lateralan	lateral'a'n
laterale	lateral'e
laterana	lateran'a
laterano	lateran'o
latio	lati'o
latina	latin'a
latinaj	latin'a'j
latinajn	latin'a'j'n
latinan	latin'a'n
latine	latin'e
latino	latin'o
latinoj	latin'o'j
latinon	latin'o'n
latinaĵo	latin'aĵ'o
latinaĵoj	latin'aĵ'o'j
latinamerika	latin'amerik'a
latinamerikaj	latin'amerik'a'j
latinamerikajn	latin'amerik'a'j'n
latinamerikan	latin'amerik'a'n
latinameriko	latin'amerik'o
latinamerikon	latin'amerik'o'n
latinamerikano	latin'amerik'an'o
latinamerikanoj	latin'amerik'an'o'j
latindevena	latin'de'ven'a
latindevenaj	latin'de'ven'a'j
latinida	latin'id'a
latinidaj	latin'id'a'j
latinidajn	latin'id'a'j'n
latinidan	latin'id'a'n
latiniga	latin'ig'a
latinigo	latin'ig'o
latinigita	latin'ig'it'a
latinisto	latin'ist'o
latinistoj	latin'ist'o'j
latinlingva	latin'lingv'a
latinlingvaj	latin'lingv'a'j
latinlingvan	latin'lingv'a'n
latinlingve	latin'lingv'e
latiso	latis'o
latitudo	latitud'o
latitudoj	latitud'o'j
latitudon	latitud'o'n
latrino	latrin'o
latrinoj	latrin'o'j
latuna	latun'a
latunaj	latun'a'j
latunajn	latun'a'j'n
latunan	latun'a'n
latuno	latun'o
latunon	latun'o'n
latva	latv'a
latvaj	latv'a'j
latvan	latv'a'n
latvoj	latv'o'j
latvia	latv'i'a
latvio	latv'i'o
latvion	latv'i'o'n
laŭ	laŭ
laŭa	laŭ'a
laŭas	laŭ'as
laŭe	laŭ'e
laŭu	laŭ'u
laŭaserte	laŭ'asert'e
laŭaspekte	laŭ'aspekt'e
laŭbezone	laŭ'bezon'e
laŭbilde	laŭ'bild'e
laŭcela	laŭ'cel'a
laŭcelaj	laŭ'cel'a'j
laŭcelajn	laŭ'cel'a'j'n
laŭcelan	laŭ'cel'a'n
laŭcele	laŭ'cel'e
laŭdeve	laŭ'dev'e
laŭdezire	laŭ'dezir'e
laŭdifine	laŭ'difin'e
laŭdira	laŭ'dir'a
laŭdiraj	laŭ'dir'a'j
laŭdire	laŭ'dir'e
laŭeble	laŭ'ebl'e
laŭenhave	laŭ'en'hav'e
laŭenspeza	laŭ'en'spez'a
laŭfakte	laŭ'fakt'e
laŭflankantaj	laŭ'flank'ant'a'j
laŭflankita	laŭ'flank'it'a
laŭflue	laŭ'flu'e
laŭforme	laŭ'form'e
laŭgrada	laŭ'grad'a
laŭgradan	laŭ'grad'a'n
laŭgrade	laŭ'grad'e
laŭguste	laŭ'gust'e
laŭhazarde	laŭ'hazard'e
laŭigas	laŭ'ig'as
laŭintence	laŭ'intenc'e
laŭiras	laŭ'ir'as
laŭiri	laŭ'ir'i
laŭiris	laŭ'ir'is
laŭirante	laŭ'ir'ant'e
laŭjure	laŭ'jur'e
laŭkonstitucie	laŭ'konstituci'e
laŭkulpa	laŭ'kulp'a
laŭkutime	laŭ'kutim'e
laŭlanda	laŭ'land'a
laŭlarĝe	laŭ'larĝ'e
laŭlegende	laŭ'legend'e
laŭleĝa	laŭ'leĝ'a
laŭleĝaj	laŭ'leĝ'a'j
laŭleĝajn	laŭ'leĝ'a'j'n
laŭleĝan	laŭ'leĝ'a'n
laŭleĝe	laŭ'leĝ'e
laŭleĝeco	laŭ'leĝ'ec'o
laŭleĝecon	laŭ'leĝ'ec'o'n
laŭleĝigi	laŭ'leĝ'ig'i
laŭlitera	laŭ'liter'a
laŭliteran	laŭ'liter'a'n
laŭlitere	laŭ'liter'e
laŭlonga	laŭ'long'a
laŭlongaj	laŭ'long'a'j
laŭlongan	laŭ'long'a'n
laŭlonge	laŭ'long'e
laŭmende	laŭ'mend'e
laŭmerite	laŭ'merit'e
laŭmezura	laŭ'mezur'a
laŭmezuraj	laŭ'mezur'a'j
laŭmezuran	laŭ'mezur'a'n
laŭmezure	laŭ'mezur'e
laŭmoda	laŭ'mod'a
laŭmodaj	laŭ'mod'a'j
laŭmodan	laŭ'mod'a'n
laŭmode	laŭ'mod'e
laŭnature	laŭ'natur'e
laŭnecese	laŭ'neces'e
laŭnome	laŭ'nom'e
laŭnombre	laŭ'nombr'e
laŭnorme	laŭ'norm'e
laŭnormigita	laŭ'norm'ig'it'a
laŭokaza	laŭ'okaz'a
laŭokaze	laŭ'okaz'e
laŭorde	laŭ'ord'e
laŭpaŝa	laŭ'paŝ'a
laŭpaŝaj	laŭ'paŝ'a'j
laŭpaŝan	laŭ'paŝ'a'n
laŭpaŝe	laŭ'paŝ'e
laŭpeta	laŭ'pet'a
laŭpete	laŭ'pet'e
laŭplaĉe	laŭ'plaĉ'e
laŭplana	laŭ'plan'a
laŭplanaj	laŭ'plan'a'j
laŭplanajn	laŭ'plan'a'j'n
laŭplanan	laŭ'plan'a'n
laŭplane	laŭ'plan'e
laŭpove	laŭ'pov'e
laŭprincipe	laŭ'princip'e
laŭprofesie	laŭ'profesi'e
laŭprograma	laŭ'program'a
laŭrajta	laŭ'rajt'a
laŭrajte	laŭ'rajt'e
laŭraporte	laŭ'raport'e
laŭregula	laŭ'regul'a
laŭregule	laŭ'regul'e
laŭsence	laŭ'senc'e
laŭsezona	laŭ'sezon'a
laŭsezonaj	laŭ'sezon'a'j
laŭsezonajn	laŭ'sezon'a'j'n
laŭsezonan	laŭ'sezon'a'n
laŭsezone	laŭ'sezon'e
laŭsone	laŭ'son'e
laŭstadie	laŭ'stadi'e
laŭstatute	laŭ'statut'e
laŭstile	laŭ'stil'e
laŭsupoze	laŭ'supoz'e
laŭŝajne	laŭ'ŝajn'e
laŭtaksa	laŭ'taks'a
laŭtaksaj	laŭ'taks'a'j
laŭtaksan	laŭ'taks'a'n
laŭtakse	laŭ'taks'e
laŭtempa	laŭ'temp'a
laŭtempe	laŭ'temp'e
laŭtradicie	laŭ'tradici'e
laŭvente	laŭ'vent'e
laŭvere	laŭ'ver'e
laŭvica	laŭ'vic'a
laŭvican	laŭ'vic'a'n
laŭvice	laŭ'vic'e
laŭvide	laŭ'vid'e
laŭvoje	laŭ'voj'e
laŭvola	laŭ'vol'a
laŭvolaj	laŭ'vol'a'j
laŭvolajn	laŭ'vol'a'j'n
laŭvolan	laŭ'vol'a'n
laŭvole	laŭ'vol'e
laŭvorta	laŭ'vort'a
laŭvortaj	laŭ'vort'a'j
laŭvortajn	laŭ'vort'a'j'n
laŭvortan	laŭ'vort'a'n
laŭvorte	laŭ'vort'e
laŭbo	laŭb'o
laŭda	laŭd'a
laŭdaj	laŭd'a'j
laŭdajn	laŭd'a'j'n
laŭdan	laŭd'a'n
laŭdas	laŭd'as
laŭde	laŭd'e
laŭdi	laŭd'i
laŭdis	laŭd'is
laŭdo	laŭd'o
laŭdoj	laŭd'o'j
laŭdojn	laŭd'o'j'n
laŭdon	laŭd'o'n
laŭdos	laŭd'os
laŭdu	laŭd'u
laŭdus	laŭd'us
laŭdado	laŭd'ad'o
laŭdanta	laŭd'ant'a
laŭdantaj	laŭd'ant'a'j
laŭdante	laŭd'ant'e
laŭdata	laŭd'at'a
laŭdataj	laŭd'at'a'j
laŭdinda	laŭd'ind'a
laŭdindaj	laŭd'ind'a'j
laŭdindan	laŭd'ind'a'n
laŭdinde	laŭd'ind'e
laŭdita	laŭd'it'a
laŭditaj	laŭd'it'a'j
laŭra	laŭr'a
laŭro	laŭr'o
laŭroj	laŭr'o'j
laŭretera	laŭr'eter'a
laŭrila	laŭr'il'a
laŭrokrono	laŭr'o'kron'o
laŭreato	laŭreat'o
laŭreatoj	laŭreat'o'j
laŭrenca	laŭrenc'a
laŭrenco	laŭrenc'o
laŭta	laŭt'a
laŭtaj	laŭt'a'j
laŭtajn	laŭt'a'j'n
laŭtan	laŭt'a'n
laŭtas	laŭt'as
laŭte	laŭt'e
laŭtavoĉe	laŭt'a'voĉ'e
laŭteco	laŭt'ec'o
laŭtecon	laŭt'ec'o'n
laŭtega	laŭt'eg'a
laŭtege	laŭt'eg'e
laŭtema	laŭt'em'a
laŭtemaj	laŭt'em'a'j
laŭteme	laŭt'em'e
laŭtigis	laŭt'ig'is
laŭtlegas	laŭt'leg'as
laŭtlegi	laŭt'leg'i
laŭtlegis	laŭt'leg'is
laŭtlegu	laŭt'leg'u
laŭtlegado	laŭt'leg'ad'o
laŭtlegita	laŭt'leg'it'a
laŭtlegitaj	laŭt'leg'it'a'j
laŭtoregilo	laŭt'o'reg'il'o
laŭtparolilo	laŭt'parol'il'o
laŭtparoliloj	laŭt'parol'il'o'j
laŭtparolilojn	laŭt'parol'il'o'j'n
laŭtparolilon	laŭt'parol'il'o'n
laŭtvoĉe	laŭt'voĉ'e
laŭtvoĉeco	laŭt'voĉ'ec'o
lava	lav'a
lavas	lav'as
lavi	lav'i
lavis	lav'is
lavo	lav'o
lavon	lav'o'n
lavos	lav'os
lavu	lav'u
lavado	lav'ad'o
lavadoj	lav'ad'o'j
lavadon	lav'ad'o'n
lavaĵon	lav'aĵ'o'n
lavanta	lav'ant'a
lavante	lav'ant'e
lavata	lav'at'a
lavataj	lav'at'a'j
lavejo	lav'ej'o
lavejon	lav'ej'o'n
lavilo	lav'il'o
laviloj	lav'il'o'j
lavinte	lav'int'e
lavistino	lav'ist'in'o
lavita	lav'it'a
lavitaj	lav'it'a'j
lavitan	lav'it'a'n
lavitaĵojn	lav'it'aĵ'o'j'n
lavmaŝino	lav'maŝin'o
lavmaŝinoj	lav'maŝin'o'j
lavmaŝinon	lav'maŝin'o'n
lavotaĵo	lav'ot'aĵ'o
lavujo	lav'uj'o
lavujoj	lav'uj'o'j
lavujon	lav'uj'o'n
lavurso	lav'urs'o
lavursoj	lav'urs'o'j
lavango	lavang'o
lavangoj	lavang'o'j
lavangon	lavang'o'n
lavenda	lavend'a
lavendo	lavend'o
lazo	laz'o
lazaro	lazar'o
lazareto	lazaret'o
lazura	lazur'a
lazuraj	lazur'a'j
lazuro	lazur'o
leciono	lecion'o
lecionoj	lecion'o'j
lecionojn	lecion'o'j'n
lecionon	lecion'o'n
lecitino	lecitin'o
leda	led'a
ledaj	led'a'j
ledajn	led'a'j'n
ledan	led'a'n
ledo	led'o
ledoj	led'o'j
ledojn	led'o'j'n
ledon	led'o'n
ledeca	led'ec'a
ledkolora	led'kolor'a
lega	leg'a
legas	leg'as
lege	leg'e
legi	leg'i
legis	leg'is
lego	leg'o
legoj	leg'o'j
legon	leg'o'n
legos	leg'os
legu	leg'u
legus	leg'us
legadas	leg'ad'as
legadi	leg'ad'i
legadis	leg'ad'is
legado	leg'ad'o
legadoj	leg'ad'o'j
legadon	leg'ad'o'n
legaĵo	leg'aĵ'o
legaĵoj	leg'aĵ'o'j
legaĵojn	leg'aĵ'o'j'n
legaĵon	leg'aĵ'o'n
leganta	leg'ant'a
legantaj	leg'ant'a'j
legantan	leg'ant'a'n
legantas	leg'ant'as
legante	leg'ant'e
leganto	leg'ant'o
legantoj	leg'ant'o'j
legantojn	leg'ant'o'j'n
leganton	leg'ant'o'n
legantaro	leg'ant'ar'o
legantaron	leg'ant'ar'o'n
legantinoj	leg'ant'in'o'j
legebla	leg'ebl'a
legeblaj	leg'ebl'a'j
legeblajn	leg'ebl'a'j'n
legeblan	leg'ebl'a'n
legeblas	leg'ebl'as
legeble	leg'ebl'e
legeblis	leg'ebl'is
legebleco	leg'ebl'ec'o
legeblecon	leg'ebl'ec'o'n
legejo	leg'ej'o
legejoj	leg'ej'o'j
legejon	leg'ej'o'n
legema	leg'em'a
legemo	leg'em'o
legiĝas	leg'iĝ'as
legiĝis	leg'iĝ'is
legilo	leg'il'o
legiloj	leg'il'o'j
leginda	leg'ind'a
legindaj	leg'ind'a'j
legindajn	leg'ind'a'j'n
legindan	leg'ind'a'n
legindas	leg'ind'as
leginta	leg'int'a
legintaj	leg'int'a'j
leginte	leg'int'e
legintoj	leg'int'o'j
legita	leg'it'a
legitaj	leg'it'a'j
legitajn	leg'it'a'j'n
legitan	leg'it'a'n
legite	leg'it'e
legolibro	leg'o'libr'o
legolibroj	leg'o'libr'o'j
legopovo	leg'o'pov'o
legopovon	leg'o'pov'o'n
legoscio	leg'o'sci'o
legosignoj	leg'o'sign'o'j
legonta	leg'ont'a
legontoj	leg'ont'o'j
legontojn	leg'ont'o'j'n
legota	leg'ot'a
legacio	legaci'o
legala	legal'a
legalulo	legal'ul'o
legata	legat'a
legataj	legat'a'j
legato	legat'o
legatoj	legat'o'j
legenda	legend'a
legendaj	legend'a'j
legendajn	legend'a'j'n
legendan	legend'a'n
legende	legend'e
legendo	legend'o
legendoj	legend'o'j
legendojn	legend'o'j'n
legendon	legend'o'n
legio	legi'o
legioj	legi'o'j
legiojn	legi'o'j'n
legion	legi'o'n
legianoj	legi'an'o'j
legitima	legitim'a
legitimaj	legitim'a'j
legitimajn	legitim'a'j'n
legitiman	legitim'a'n
legitimas	legitim'as
legitime	legitim'e
legitimi	legitim'i
legitimis	legitim'is
legitimado	legitim'ad'o
legitimeco	legitim'ec'o
legitimecon	legitim'ec'o'n
legitimilo	legitim'il'o
legitimiloj	legitim'il'o'j
legitimilon	legitim'il'o'n
legoma	legom'a
legomaj	legom'a'j
legoman	legom'a'n
legomo	legom'o
legomoj	legom'o'j
legomojn	legom'o'j'n
legomon	legom'o'n
legomĝardeno	legom'ĝarden'o
legomĝardenoj	legom'ĝarden'o'j
legomĝardenon	legom'ĝarden'o'n
legomkultivado	legom'kultiv'ad'o
legomstufaĵo	legom'stuf'aĵ'o
leĝa	leĝ'a
leĝaj	leĝ'a'j
leĝajn	leĝ'a'j'n
leĝan	leĝ'a'n
leĝe	leĝ'e
legho	leĝ'o
leĝo	leĝ'o
leĝoj	leĝ'o'j
leĝojn	leĝ'o'j'n
leĝon	leĝ'o'n
legharo	leĝ'ar'o
leĝaro	leĝ'ar'o
leĝaroj	leĝ'ar'o'j
leĝaron	leĝ'ar'o'n
leĝdona	leĝ'don'a
leĝdonaj	leĝ'don'a'j
leĝdonajn	leĝ'don'a'j'n
leĝdonan	leĝ'don'a'n
leĝdoni	leĝ'don'i
leĝdonis	leĝ'don'is
leĝdono	leĝ'don'o
leĝdonado	leĝ'don'ad'o
leĝdonanto	leĝ'don'ant'o
leĝdonantoj	leĝ'don'ant'o'j
leĝdonantojn	leĝ'don'ant'o'j'n
leĝeco	leĝ'ec'o
leĝfarado	leĝ'far'ad'o
leĝigi	leĝ'ig'i
leĝigis	leĝ'ig'is
leĝigo	leĝ'ig'o
leĝigon	leĝ'ig'o'n
leĝigita	leĝ'ig'it'a
leĝisto	leĝ'ist'o
leĝodona	leĝ'o'don'a
leĝofara	leĝ'o'far'a
leĝofaranto	leĝ'o'far'ant'o
leĝoprojekto	leĝ'o'projekt'o
leĝopropono	leĝ'o'propon'o
leĝoproponon	leĝ'o'propon'o'n
leĝotekstoj	leĝ'o'tekst'o'j
leĝprojekto	leĝ'projekt'o
leĝprojekton	leĝ'projekt'o'n
leĝpropono	leĝ'propon'o
leĝproponoj	leĝ'propon'o'j
leĝproponon	leĝ'propon'o'n
leĝrompinto	leĝ'romp'int'o
leĝrompintoj	leĝ'romp'int'o'j
leĝrompintojn	leĝ'romp'int'o'j'n
leĝsistemo	leĝ'sistem'o
leĝsistemon	leĝ'sistem'o'n
leĝera	leĝer'a
leĝeraj	leĝer'a'j
leĝeran	leĝer'a'n
leĝere	leĝer'e
lekas	lek'as
leki	lek'i
lekis	lek'is
leku	lek'u
lekado	lek'ad'o
lekante	lek'ant'e
lekanto	lek'ant'o
lekante	lekant'e
lekanto	lekant'o
lekanteto	lekant'et'o
lekantetoj	lekant'et'o'j
lekcias	lekci'as
lekciis	lekci'is
lekcio	lekci'o
lekcioj	lekci'o'j
lekciojn	lekci'o'j'n
lekcion	lekci'o'n
lekciisto	lekci'ist'o
leksemo	leksem'o
leksemoj	leksem'o'j
leksika	leksik'a
leksikaj	leksik'a'j
leksikan	leksik'a'n
leksike	leksik'e
leksiko	leksik'o
leksikon	leksik'o'n
leksikologio	leksik'olog'i'o
leksikografo	leksikograf'o
leksikografoj	leksikograf'o'j
leksikografia	leksikograf'i'a
leksikografio	leksikograf'i'o
leksikono	leksikon'o
leksikonoj	leksikon'o'j
leksikonon	leksikon'o'n
lektoro	lektor'o
lemo	lem'o
lemon	lem'o'n
lena	len'a
leno	len'o
lenoj	len'o'j
lenojn	len'o'j'n
lenon	len'o'n
lenina	lenin'a
lenino	lenin'o
leninismo	lenin'ism'o
leninpremio	lenin'premi'o
leningrada	leningrad'a
leningrado	leningrad'o
lenso	lens'o
lensoj	lens'o'j
lensojn	lens'o'j'n
lenson	lens'o'n
lento	lent'o
lentoj	lent'o'j
lentojn	lent'o'j'n
lentuga	lentug'a
lentugoj	lentug'o'j
lentugojn	lentug'o'j'n
leona	leon'a
leonan	leon'a'n
leono	leon'o
leonoj	leon'o'j
leonojn	leon'o'j'n
leonon	leon'o'n
leondanco	leon'danc'o
leonido	leon'id'o
leonidoj	leon'id'o'j
leonino	leon'in'o
leoninoj	leon'in'o'j
leoninon	leon'in'o'n
leonkapo	leon'kap'o
leonkoro	leon'kor'o
leonardo	leonard'o
leontodo	leontod'o
leontodoj	leontod'o'j
leoparda	leopard'a
leopardo	leopard'o
leopardoj	leopard'o'j
leopoldo	leopold'o
lepidopteroj	lepidopter'o'j
lepora	lepor'a
leporo	lepor'o
leporoj	lepor'o'j
leporojn	lepor'o'j'n
leporon	lepor'o'n
leporeto	lepor'et'o
leporhundoj	lepor'hund'o'j
leporlipon	lepor'lip'o'n
lepro	lepr'o
leprulo	lepr'ul'o
lepruloj	lepr'ul'o'j
leprulojn	lepr'ul'o'j'n
leptonoj	lepton'o'j
lerna	lern'a
lernaj	lern'a'j
lernajn	lern'a'j'n
lernan	lern'a'n
lernas	lern'as
lerni	lern'i
lernis	lern'is
lerno	lern'o
lernon	lern'o'n
lernos	lern'os
lernu	lern'u
lernus	lern'us
lernadas	lern'ad'as
lernadi	lern'ad'i
lernadis	lern'ad'is
lernado	lern'ad'o
lernadoj	lern'ad'o'j
lernadon	lern'ad'o'n
lernanta	lern'ant'a
lernantaj	lern'ant'a'j
lernantajn	lern'ant'a'j'n
lernantan	lern'ant'a'n
lernante	lern'ant'e
lernanto	lern'ant'o
lernantoj	lern'ant'o'j
lernantojn	lern'ant'o'j'n
lernanton	lern'ant'o'n
lernantaro	lern'ant'ar'o
lernantino	lern'ant'in'o
lernantinoj	lern'ant'in'o'j
lernantinojn	lern'ant'in'o'j'n
lernata	lern'at'a
lernataj	lern'at'a'j
lernebla	lern'ebl'a
lerneblaj	lern'ebl'a'j
lerneblan	lern'ebl'a'n
lerneblas	lern'ebl'as
lernebleco	lern'ebl'ec'o
lerneja	lern'ej'a
lernejaj	lern'ej'a'j
lernejajn	lern'ej'a'j'n
lernejan	lern'ej'a'n
lerneje	lern'ej'e
lernejen	lern'ej'e'n
lernejo	lern'ej'o
lernejoj	lern'ej'o'j
lernejojn	lern'ej'o'j'n
lernejon	lern'ej'o'n
lernejana	lern'ej'an'a
lernejano	lern'ej'an'o
lernejanoj	lern'ej'an'o'j
lernejanojn	lern'ej'an'o'j'n
lernejanino	lern'ej'an'in'o
lernejestro	lern'ej'estr'o
lernejestroj	lern'ej'estr'o'j
lernejinfanoj	lern'ej'infan'o'j
lernejtemaro	lern'ej'tem'ar'o
lernema	lern'em'a
lernemaj	lern'em'a'j
lernemo	lern'em'o
lernenda	lern'end'a
lernendaj	lern'end'a'j
lernendan	lern'end'a'n
lernigas	lern'ig'as
lernigi	lern'ig'i
lernigis	lern'ig'is
lernigos	lern'ig'os
lernigu	lern'ig'u
lernilo	lern'il'o
lerniloj	lern'il'o'j
lernilojn	lern'il'o'j'n
lernilon	lern'il'o'n
lerninda	lern'ind'a
lernindaj	lern'ind'a'j
lerninta	lern'int'a
lernintaj	lern'int'a'j
lerninte	lern'int'e
lerninto	lern'int'o
lernintoj	lern'int'o'j
lernita	lern'it'a
lernitaj	lern'it'a'j
lernitajn	lern'it'a'j'n
lernitan	lern'it'a'n
lernite	lern'it'e
lernoĉambro	lern'o'ĉambr'o
lernoĉambroj	lern'o'ĉambr'o'j
lernohoroj	lern'o'hor'o'j
lernojaro	lern'o'jar'o
lernojaroj	lern'o'jar'o'j
lernojaron	lern'o'jar'o'n
lernolibro	lern'o'libr'o
lernolibroj	lern'o'libr'o'j
lernolibrojn	lern'o'libr'o'j'n
lernolibron	lern'o'libr'o'n
lernomaterialo	lern'o'material'o
lernomaterialoj	lern'o'material'o'j
lernotempo	lern'o'temp'o
lernobjekto	lern'objekt'o
lernobjektoj	lern'objekt'o'j
lernobjektojn	lern'objekt'o'j'n
lernota	lern'ot'a
lerta	lert'a
lertaj	lert'a'j
lertajn	lert'a'j'n
lertan	lert'a'n
lertas	lert'as
lerte	lert'e
lertis	lert'is
lerto	lert'o
lertoj	lert'o'j
lerton	lert'o'n
lertaĵo	lert'aĵ'o
lertaĵoj	lert'aĵ'o'j
lertaĵojn	lert'aĵ'o'j'n
lerteco	lert'ec'o
lertecoj	lert'ec'o'j
lertecojn	lert'ec'o'j'n
lertecon	lert'ec'o'n
lertega	lert'eg'a
lertulo	lert'ul'o
lertuloj	lert'ul'o'j
lesba	lesb'a
lesbaj	lesb'a'j
lesbajn	lesb'a'j'n
lesbo	lesb'o
lesboj	lesb'o'j
lesbanino	lesb'an'in'o
lesbaninoj	lesb'an'in'o'j
lesbia	lesbia
lesivas	lesiv'as
lesivi	lesiv'i
lesivo	lesiv'o
lesivoj	lesiv'o'j
lesivon	lesiv'o'n
lesivado	lesiv'ad'o
lesoto	lesot'o
letargio	letargi'o
letera	leter'a
leteraj	leter'a'j
leteras	leter'as
letere	leter'e
leteri	leter'i
leteris	leter'is
letero	leter'o
leteroj	leter'o'j
leterojn	leter'o'j'n
leteron	leter'o'n
leteros	leter'os
leteru	leter'u
leteramikojn	leter'amik'o'j'n
leteraro	leter'ar'o
letereto	leter'et'o
leteretojn	leter'et'o'j'n
letereton	leter'et'o'n
leterkesto	leter'kest'o
leterkeston	leter'kest'o'n
leterkolomboj	leter'kolomb'o'j
leterportisto	leter'port'ist'o
leŭkemio	leŭkemi'o
leŭkocitoj	leŭkocit'o'j
leŭsa	leŭs'a
leŭso	leŭs'o
leŭtenanto	leŭtenant'o
leŭtenantoj	leŭtenant'o'j
leŭtenanton	leŭtenant'o'n
leva	lev'a
levas	lev'as
levi	lev'i
levis	lev'is
levo	lev'o
levoj	lev'o'j
levojn	lev'o'j'n
levon	lev'o'n
levos	lev'os
levu	lev'u
levus	lev'us
levadis	lev'ad'is
levado	lev'ad'o
levanta	lev'ant'a
levantaj	lev'ant'a'j
levantan	lev'ant'a'n
levante	lev'ant'e
levata	lev'at'a
levataj	lev'at'a'j
levetis	lev'et'is
levigi	lev'ig'i
leviĝas	lev'iĝ'as
leviĝi	lev'iĝ'i
leviĝis	lev'iĝ'is
levigho	lev'iĝ'o
leviĝo	lev'iĝ'o
leviĝoj	lev'iĝ'o'j
leviĝon	lev'iĝ'o'n
leviĝos	lev'iĝ'os
leviĝu	lev'iĝ'u
leviĝus	lev'iĝ'us
leviĝadis	lev'iĝ'ad'is
leviĝado	lev'iĝ'ad'o
leviĝanta	lev'iĝ'ant'a
leviĝantaj	lev'iĝ'ant'a'j
leviĝantan	lev'iĝ'ant'a'n
leviĝante	lev'iĝ'ant'e
leviĝinta	lev'iĝ'int'a
leviĝinte	lev'iĝ'int'e
levilo	lev'il'o
leviloj	lev'il'o'j
levilojn	lev'il'o'j'n
levilon	lev'il'o'n
levilforto	lev'il'fort'o
levilforton	lev'il'fort'o'n
levinta	lev'int'a
levinte	lev'int'e
levita	lev'it'a
levitaj	lev'it'a'j
levitajn	lev'it'a'j'n
levitan	lev'it'a'n
levite	lev'it'e
levponto	lev'pont'o
levantenia	levanten'i'a
levantenio	levanten'i'o
levidoj	levid'o'j
levitacio	levitaci'o
lezas	lez'as
lezi	lez'i
lezis	lez'is
lezo	lez'o
lezoj	lez'o'j
lezojn	lez'o'j'n
lezon	lez'o'n
lezita	lez'it'a
lezitaj	lez'it'a'j
li	li
lia	li'a
liaj	li'a'j
liajn	li'a'j'n
lian	li'a'n
lie	li'e
lin	li'n
lio	li'o
lioj	li'o'j
lion	li'o'n
liaflanke	li'a'flank'e
liaopinie	li'a'opini'e
liatempe	li'a'temp'e
liana	lian'a
liano	lian'o
lianoj	lian'o'j
libana	liban'a
libanaj	liban'a'j
libanan	liban'a'n
libano	liban'o
libanon	liban'o'n
libananoj	liban'an'o'j
libelo	libel'o
libeloj	libel'o'j
libelojn	libel'o'j'n
libera	liber'a
liberaj	liber'a'j
liberajn	liber'a'j'n
liberan	liber'a'n
liberas	liber'as
libere	liber'e
liberi	liber'i
libero	liber'o
liberoj	liber'o'j
liberojn	liber'o'j'n
liberon	liber'o'n
liberos	liber'os
liberafolio	liber'a'foli'o
liberaera	liber'aer'a
liberaeraj	liber'aer'a'j
liberalira	liber'al'ir'a
liberaliraj	liber'al'ir'a'j
libereca	liber'ec'a
liberecaj	liber'ec'a'j
libereco	liber'ec'o
liberecoj	liber'ec'o'j
liberecojn	liber'ec'o'j'n
liberecon	liber'ec'o'n
liberecana	liber'ec'an'a
liberecanaj	liber'ec'an'a'j
liberecanoj	liber'ec'an'o'j
liberecbatalo	liber'ec'batal'o
liberflua	liber'flu'a
liberiga	liber'ig'a
liberigaj	liber'ig'a'j
liberigan	liber'ig'a'n
liberigas	liber'ig'as
liberigi	liber'ig'i
liberigis	liber'ig'is
liberigo	liber'ig'o
liberigon	liber'ig'o'n
liberigos	liber'ig'os
liberigu	liber'ig'u
liberigus	liber'ig'us
liberigado	liber'ig'ad'o
liberiganta	liber'ig'ant'a
liberigantan	liber'ig'ant'a'n
liberigante	liber'ig'ant'e
liberiganto	liber'ig'ant'o
liberigantoj	liber'ig'ant'o'j
liberigata	liber'ig'at'a
liberigataj	liber'ig'at'a'j
liberiginte	liber'ig'int'e
liberigita	liber'ig'it'a
liberigitaj	liber'ig'it'a'j
liberigitajn	liber'ig'it'a'j'n
liberigitan	liber'ig'it'a'n
liberigite	liber'ig'it'e
liberiĝas	liber'iĝ'as
liberiĝi	liber'iĝ'i
liberiĝis	liber'iĝ'is
liberigho	liber'iĝ'o
liberiĝo	liber'iĝ'o
liberiĝon	liber'iĝ'o'n
liberiĝos	liber'iĝ'os
liberiĝu	liber'iĝ'u
liberiĝus	liber'iĝ'us
liberiĝinta	liber'iĝ'int'a
liberiĝinte	liber'iĝ'int'e
liberkomerca	liber'komerc'a
liberkomercan	liber'komerc'a'n
libermerkata	liber'merkat'a
libermerkataj	liber'merkat'a'j
libermerkato	liber'merkat'o
liberpensado	liber'pens'ad'o
liberpensulo	liber'pens'ul'o
liberpensuloj	liber'pens'ul'o'j
liberprogramaraj	liber'program'ar'a'j
libersendaj	liber'send'a'j
liberstaranta	liber'star'ant'a
liberstarantaj	liber'star'ant'a'j
liberstila	liber'stil'a
liberŝtato	liber'ŝtat'o
libertempa	liber'temp'a
libertempaj	liber'temp'a'j
libertempajn	liber'temp'a'j'n
libertempas	liber'temp'as
libertempe	liber'temp'e
libertempi	liber'temp'i
libertempis	liber'temp'is
libertempo	liber'temp'o
libertempon	liber'temp'o'n
liberulo	liber'ul'o
liberuloj	liber'ul'o'j
libervivaj	liber'viv'a'j
libervola	liber'vol'a
libervolaj	liber'vol'a'j
libervolajn	liber'vol'a'j'n
libervolan	liber'vol'a'n
libervole	liber'vol'e
libervolo	liber'vol'o
libervolisma	liber'vol'ism'a
libervolismaj	liber'vol'ism'a'j
libervolistoj	liber'vol'ist'o'j
liberala	liberal'a
liberalaj	liberal'a'j
liberalajn	liberal'a'j'n
liberalan	liberal'a'n
liberale	liberal'e
liberalarta	liberal'art'a
liberaldemokratoj	liberal'demokrat'o'j
liberaligi	liberal'ig'i
liberaligo	liberal'ig'o
liberaligon	liberal'ig'o'n
liberalisma	liberal'ism'a
liberalismo	liberal'ism'o
liberalismon	liberal'ism'o'n
liberalulo	liberal'ul'o
liberaluloj	liberal'ul'o'j
liberalulojn	liberal'ul'o'j'n
liberia	liberi'a
liberio	liberi'o
libertarianoj	libertarian'o'j
libertarianisma	libertarian'ism'a
libertarianismo	libertarian'ism'o
libertinoj	libertin'o'j
libido	libid'o
libra	libr'a
libraj	libr'a'j
libre	libr'e
libro	libr'o
libroj	libr'o'j
librojn	libr'o'j'n
libron	libr'o'n
libraro	libr'ar'o
libraron	libr'ar'o'n
librejo	libr'ej'o
librejoj	libr'ej'o'j
librejon	libr'ej'o'n
libreto	libr'et'o
libretoj	libr'et'o'j
libretojn	libr'et'o'j'n
libreton	libr'et'o'n
libristo	libr'ist'o
libroapogiloj	libr'o'apog'il'o'j
librobretoj	libr'o'bret'o'j
librobretaro	libr'o'bret'ar'o
librobutiko	libr'o'butik'o
libroeldonado	libr'o'el'don'ad'o
librofine	libr'o'fin'e
librofoiro	libr'o'foir'o
libroforma	libr'o'form'a
libroforme	libr'o'form'e
libroformo	libr'o'form'o
librokolekto	libr'o'kolekt'o
librolegado	libr'o'leg'ad'o
librolegilo	libr'o'leg'il'o
librolingvo	libr'o'lingv'o
librolisto	libr'o'list'o
libromerkato	libr'o'merkat'o
libromondo	libr'o'mond'o
libropremion	libr'o'premi'o'n
librorecenzoj	libr'o'recenz'o'j
librorecenzojn	libr'o'recenz'o'j'n
libroserio	libr'o'seri'o
libroservo	libr'o'serv'o
libroservoj	libr'o'serv'o'j
libroservon	libr'o'serv'o'n
libroŝranko	libr'o'ŝrank'o
libroŝrankoj	libr'o'ŝrank'o'j
librotenado	libr'o'ten'ad'o
librotenadon	libr'o'ten'ad'o'n
librotenisto	libr'o'ten'ist'o
librotitolo	libr'o'titol'o
librovendejo	libr'o'vend'ej'o
librovendejoj	libr'o'vend'ej'o'j
librovendejon	libr'o'vend'ej'o'n
librovendisto	libr'o'vend'ist'o
librovendistoj	libr'o'vend'ist'o'j
lica	lic'a
licaj	lic'a'j
licas	lic'as
lice	lic'e
licea	lice'a
liceo	lice'o
liceoj	lice'o'j
liceon	lice'o'n
liceano	lice'an'o
liceanoj	lice'an'o'j
licencas	licenc'as
licenci	licenc'i
licencis	licenc'is
licenco	licenc'o
licencoj	licenc'o'j
licencojn	licenc'o'j'n
licencon	licenc'o'n
licencado	licenc'ad'o
licencadon	licenc'ad'o'n
licencita	licenc'it'a
licencitaj	licenc'it'a'j
licencito	licenc'it'o
licencitoj	licenc'it'o'j
licencio	licenci'o
licencion	licenci'o'n
licenciulo	licenci'ul'o
lida	lid'a
lide	lid'e
lido	lid'o
lidoj	lid'o'j
lidojn	lid'o'j'n
lidia	lid'i'a
lidian	lid'i'a'n
lidio	lid'i'o
lidia	lidia
lidja	lidja
lieĝo	lieĝ'o
lieno	lien'o
lienon	lien'o'n
lifta	lift'a
lifto	lift'o
liftoj	lift'o'j
liftojn	lift'o'j'n
lifton	lift'o'n
liga	lig'a
ligaj	lig'a'j
ligajn	lig'a'j'n
ligan	lig'a'n
ligas	lig'as
lige	lig'e
ligi	lig'i
ligis	lig'is
ligo	lig'o
ligoj	lig'o'j
ligojn	lig'o'j'n
ligon	lig'o'n
ligos	lig'os
ligu	lig'u
ligus	lig'us
ligado	lig'ad'o
ligadoj	lig'ad'o'j
ligadojn	lig'ad'o'j'n
ligadon	lig'ad'o'n
ligaĵo	lig'aĵ'o
ligaĵoj	lig'aĵ'o'j
ligano	lig'an'o
liganoj	lig'an'o'j
liganta	lig'ant'a
ligantaj	lig'ant'a'j
ligantajn	lig'ant'a'j'n
ligantan	lig'ant'a'n
ligante	lig'ant'e
liganto	lig'ant'o
ligata	lig'at'a
ligataj	lig'at'a'j
ligfinaĵo	lig'fin'aĵ'o
ligfinaĵon	lig'fin'aĵ'o'n
ligiĝas	lig'iĝ'as
ligiĝi	lig'iĝ'i
ligiĝis	lig'iĝ'is
ligiĝo	lig'iĝ'o
ligilo	lig'il'o
ligiloj	lig'il'o'j
ligilojn	lig'il'o'j'n
ligilon	lig'il'o'n
liginta	lig'int'a
liginte	lig'int'e
ligita	lig'it'a
ligitaj	lig'it'a'j
ligitajn	lig'it'a'j'n
ligitan	lig'it'a'n
ligite	lig'it'e
ligiteco	lig'it'ec'o
ligitecon	lig'it'ec'o'n
liglinioj	lig'lini'o'j
ligloko	lig'lok'o
liglokon	lig'lok'o'n
ligoenergio	lig'o'energi'o
ligokonkurso	lig'o'konkurs'o
ligamento	ligament'o
ligamentoj	ligament'o'j
ligaturo	ligatur'o
ligaturoj	ligatur'o'j
ligna	lign'a
lignaj	lign'a'j
lignajn	lign'a'j'n
lignan	lign'a'n
ligno	lign'o
lignoj	lign'o'j
lignojn	lign'o'j'n
lignon	lign'o'n
lignaĵo	lign'aĵ'o
lignaĵoj	lign'aĵ'o'j
lignaĵojn	lign'aĵ'o'j'n
lignaĵon	lign'aĵ'o'n
lignaĵisto	lign'aĵ'ist'o
lignaĵistoj	lign'aĵ'ist'o'j
ligneca	lign'ec'a
lignecaj	lign'ec'a'j
ligneroj	lign'er'o'j
lignino	lign'in'o
lignoĉipsoj	lign'o'ĉips'o'j
lignofajro	lign'o'fajr'o
lignogravuro	lign'o'gravur'o
lignogravurado	lign'o'gravur'ad'o
lignogravuraĵo	lign'o'gravur'aĵ'o
lignogravuraĵoj	lign'o'gravur'aĵ'o'j
lignohakisto	lign'o'hak'ist'o
lignohakiston	lign'o'hak'ist'o'n
lignokarbo	lign'o'karb'o
lignokarbon	lign'o'karb'o'n
lignopeco	lign'o'pec'o
lignopecoj	lign'o'pec'o'j
lignopecon	lign'o'pec'o'n
lignoplantoj	lign'o'plant'o'j
lignoprilaboro	lign'o'pri'labor'o
lignoproduktado	lign'o'produkt'ad'o
lignoŝuoj	lign'o'ŝu'o'j
lignoŝuojn	lign'o'ŝu'o'j'n
lignotabulo	lign'o'tabul'o
lignotabuloj	lign'o'tabul'o'j
ligurio	liguri'o
liĥtenŝtejna	liĥtenŝtejn'a
liĥtenŝtejno	liĥtenŝtejn'o
lika	lik'a
likas	lik'as
like	lik'e
liki	lik'i
likis	lik'is
liko	lik'o
likon	lik'o'n
likanta	lik'ant'a
likita	lik'it'a
likitaj	lik'it'a'j
likaono	likaon'o
likeno	liken'o
likenoj	liken'o'j
likio	liki'o
likopeno	likopen'o
liktoroj	liktor'o'j
likva	likv'a
likvaj	likv'a'j
likvajn	likv'a'j'n
likvan	likv'a'n
likvo	likv'o
likvoj	likv'o'j
likvon	likv'o'n
likvakristala	likv'a'kristal'a
likvaĵa	likv'aĵ'a
likvaĵo	likv'aĵ'o
likvaĵoj	likv'aĵ'o'j
likvaĵojn	likv'aĵ'o'j'n
likvaĵon	likv'aĵ'o'n
likvigita	likv'ig'it'a
likvokristala	likv'o'kristal'a
likvokristalaj	likv'o'kristal'a'j
likvida	likvid'a
likvidas	likvid'as
likvidi	likvid'i
likvidis	likvid'is
likvido	likvid'o
likvidon	likvid'o'n
likvidado	likvid'ad'o
likvideco	likvid'ec'o
likvidecon	likvid'ec'o'n
likvidita	likvid'it'a
likviditaj	likvid'it'a'j
likvoro	likvor'o
likvoroj	likvor'o'j
likvoron	likvor'o'n
lila	lil'a
lilaj	lil'a'j
lilia	lili'a
lilio	lili'o
lilioj	lili'o'j
liliputa	liliput'a
liliputo	liliput'o
lima	lim'a
limaj	lim'a'j
liman	lim'a'n
limas	lim'as
lime	lim'e
limi	lim'i
limis	lim'is
limo	lim'o
limoj	lim'o'j
limojn	lim'o'j'n
limon	lim'o'n
limado	lim'ad'o
limadon	lim'ad'o'n
limanta	lim'ant'a
limantaj	lim'ant'a'j
limante	lim'ant'e
limcirkonstancoj	lim'cirkonstanc'o'j
limdato	lim'dat'o
limdatoj	lim'dat'o'j
limdaton	lim'dat'o'n
limgardistoj	lim'gard'ist'o'j
limiga	lim'ig'a
limigaj	lim'ig'a'j
limigajn	lim'ig'a'j'n
limigan	lim'ig'a'n
limigas	lim'ig'as
limigi	lim'ig'i
limigis	lim'ig'is
limigo	lim'ig'o
limigoj	lim'ig'o'j
limigojn	lim'ig'o'j'n
limigon	lim'ig'o'n
limigos	lim'ig'os
limigu	lim'ig'u
limigus	lim'ig'us
limigado	lim'ig'ad'o
limiganta	lim'ig'ant'a
limigantaj	lim'ig'ant'a'j
limigantajn	lim'ig'ant'a'j'n
limigante	lim'ig'ant'e
limigata	lim'ig'at'a
limigataj	lim'ig'at'a'j
limigita	lim'ig'it'a
limigitaj	lim'ig'it'a'j
limigitajn	lim'ig'it'a'j'n
limigitan	lim'ig'it'a'n
limigite	lim'ig'it'e
limiĝas	lim'iĝ'as
limiĝi	lim'iĝ'i
limiĝis	lim'iĝ'is
limita	lim'it'a
limitaj	lim'it'a'j
limkontroloj	lim'kontrol'o'j
limlinio	lim'lini'o
limregiono	lim'region'o
limregionoj	lim'region'o'j
limŝtono	lim'ŝton'o
limŝtonoj	lim'ŝton'o'j
limtavolo	lim'tavol'o
limtempo	lim'temp'o
limtransirejoj	lim'trans'ir'ej'o'j
limtuŝas	lim'tuŝ'as
limvaloro	lim'valor'o
limako	limak'o
limakoj	limak'o'j
limakon	limak'o'n
limba	limb'a
limbo	limb'o
limburga	limburg'a
limburgo	limburg'o
limeso	limes'o
limfaj	limf'a'j
limfo	limf'o
limfganglioj	limf'gangli'o'j
limfoida	limf'oid'a
limfocitoj	limfocit'o'j
limoĝio	limoĝ'i'o
limonado	limonad'o
limonadon	limonad'o'n
limuzino	limuzin'o
limuzinon	limuzin'o'n
lina	lin'a
linan	lin'a'n
line	lin'e
lino	lin'o
linoj	lin'o'j
linon	lin'o'n
linaĵo	lin'aĵ'o
linoleo	lin'ole'o
linĉi	linĉ'i
linĉado	linĉ'ad'o
lindisfarne	lindisfarne
linea	line'a
lineo	line'o
lineoj	line'o'j
lineon	line'o'n
lineara	linear'a
linearaj	linear'a'j
linearajn	linear'a'j'n
linearan	linear'a'n
lineare	linear'e
lineareco	linear'ec'o
linearregreso	linear'regres'o
lingala	lingal'a
lingva	lingv'a
lingvaj	lingv'a'j
lingvajn	lingv'a'j'n
lingvan	lingv'a'n
lingve	lingv'e
lingvo	lingv'o
lingvoj	lingv'o'j
lingvojn	lingv'o'j'n
lingvon	lingv'o'n
lingvaĵa	lingv'aĵ'a
lingvaĵe	lingv'aĵ'e
lingvajho	lingv'aĵ'o
lingvaĵo	lingv'aĵ'o
lingvaĵoj	lingv'aĵ'o'j
lingvaĵojn	lingv'aĵ'o'j'n
lingvaĵon	lingv'aĵ'o'n
lingvanoj	lingv'an'o'j
lingvaro	lingv'ar'o
lingvaroj	lingv'ar'o'j
lingvaron	lingv'ar'o'n
lingvemuloj	lingv'em'ul'o'j
lingvista	lingv'ist'a
lingvisto	lingv'ist'o
lingvistoj	lingv'ist'o'j
lingvistojn	lingv'ist'o'j'n
lingviston	lingv'ist'o'n
lingvistika	lingv'ist'ik'a
lingvistikaj	lingv'ist'ik'a'j
lingvistikajn	lingv'ist'ik'a'j'n
lingvistikan	lingv'ist'ik'a'n
lingvistike	lingv'ist'ik'e
lingvistiko	lingv'ist'ik'o
lingvistikon	lingv'ist'ik'o'n
lingvodefendantoj	lingv'o'defend'ant'o'j
lingvodiverseco	lingv'o'divers'ec'o
lingvoekzamenoj	lingv'o'ekzamen'o'j
lingvoelementoj	lingv'o'element'o'j
lingvoevoluo	lingv'o'evolu'o
lingvofamilio	lingv'o'famili'o
lingvofamilioj	lingv'o'famili'o'j
lingvogrupo	lingv'o'grup'o
lingvogrupoj	lingv'o'grup'o'j
lingvohelpanto	lingv'o'help'ant'o
lingvohelpantoj	lingv'o'help'ant'o'j
lingvoilo	lingv'o'il'o
lingvoinstruado	lingv'o'instru'ad'o
lingvoinstruisto	lingv'o'instru'ist'o
lingvoinstruistoj	lingv'o'instru'ist'o'j
lingvokapablo	lingv'o'kapabl'o
lingvokapabloj	lingv'o'kapabl'o'j
lingvokapablon	lingv'o'kapabl'o'n
lingvokomunumo	lingv'o'komun'um'o
lingvokomunumoj	lingv'o'komun'um'o'j
lingvokono	lingv'o'kon'o
lingvokonojn	lingv'o'kon'o'j'n
lingvokonon	lingv'o'kon'o'n
lingvokontakto	lingv'o'kontakt'o
lingvokurso	lingv'o'kurs'o
lingvokursoj	lingv'o'kurs'o'j
lingvokursojn	lingv'o'kurs'o'j'n
lingvolernado	lingv'o'lern'ad'o
lingvolernadon	lingv'o'lern'ad'o'n
lingvolernantoj	lingv'o'lern'ant'o'j
lingvolernejo	lingv'o'lern'ej'o
lingvomorto	lingv'o'mort'o
lingvonivelo	lingv'o'nivel'o
lingvonivelon	lingv'o'nivel'o'n
lingvonomoj	lingv'o'nom'o'j
lingvoparoj	lingv'o'par'o'j
lingvoplanado	lingv'o'plan'ad'o
lingvopolitika	lingv'o'politik'a
lingvopolitikaj	lingv'o'politik'a'j
lingvopolitiko	lingv'o'politik'o
lingvopolitikoj	lingv'o'politik'o'j
lingvopolitikon	lingv'o'politik'o'n
lingvoproblemo	lingv'o'problem'o
lingvoproblemoj	lingv'o'problem'o'j
lingvoproblemon	lingv'o'problem'o'n
lingvoprojekto	lingv'o'projekt'o
lingvoprojektoj	lingv'o'projekt'o'j
lingvoregionoj	lingv'o'region'o'j
lingvoscio	lingv'o'sci'o
lingvosciojn	lingv'o'sci'o'j'n
lingvoscion	lingv'o'sci'o'n
lingvoscienca	lingv'o'scienc'a
lingvoscienco	lingv'o'scienc'o
lingvosciencon	lingv'o'scienc'o'n
lingvosciencistoj	lingv'o'scienc'ist'o'j
lingvosento	lingv'o'sent'o
lingvosistemo	lingv'o'sistem'o
lingvoŝanĝiĝo	lingv'o'ŝanĝ'iĝ'o
lingvotesta	lingv'o'test'a
lingvotestado	lingv'o'test'ad'o
lingvouzo	lingv'o'uz'o
lingvouzon	lingv'o'uz'o'n
lingvouzado	lingv'o'uz'ad'o
lingvouzanto	lingv'o'uz'ant'o
lingvouzantoj	lingv'o'uz'ant'o'j
lingvafrankao	lingvafranka'o
linia	lini'a
liniaj	lini'a'j
liniajn	lini'a'j'n
linian	lini'a'n
linie	lini'e
linio	lini'o
linioj	lini'o'j
liniojn	lini'o'j'n
linion	lini'o'n
liniilo	lini'il'o
linko	link'o
linkoj	link'o'j
linkeo	linke'o
lintelo	lintel'o
linteloj	lintel'o'j
linuksa	linuks'a
linuksaj	linuks'a'j
linuksan	linuks'a'n
linukso	linuks'o
linukson	linuks'o'n
linuksokerno	linuks'o'kern'o
liona	lion'a
liono	lion'o
lipa	lip'a
lipo	lip'o
lipoj	lip'o'j
lipojn	lip'o'j'n
lipon	lip'o'n
liphara	lip'har'a
lipharoj	lip'har'o'j
lipharojn	lip'har'o'j'n
liphararo	lip'har'ar'o
lipido	lipid'o
lipidoj	lipid'o'j
lipidojn	lipid'o'j'n
liro	lir'o
liroj	lir'o'j
liron	lir'o'n
lirika	lirik'a
lirikaj	lirik'a'j
lirikajn	lirik'a'j'n
lirikan	lirik'a'n
liriko	lirik'o
lirikon	lirik'o'n
lirikaĵoj	lirik'aĵ'o'j
lirikeco	lirik'ec'o
lirikisto	lirik'ist'o
lirikistoj	lirik'ist'o'j
lista	list'a
listas	list'as
listo	list'o
listoj	list'o'j
listojn	list'o'j'n
liston	list'o'n
listigas	list'ig'as
listigi	list'ig'i
listigis	list'ig'is
listigo	list'ig'o
listigoj	list'ig'o'j
listigon	list'ig'o'n
listigos	list'ig'os
listigu	list'ig'u
listigado	list'ig'ad'o
listigante	list'ig'ant'e
listigita	list'ig'it'a
listigitaj	list'ig'it'a'j
listigitajn	list'ig'it'a'j'n
listigite	list'ig'it'e
listiĝas	list'iĝ'as
listita	list'it'a
listitaj	list'it'a'j
lita	lit'a
lite	lit'e
liten	lit'e'n
lito	lit'o
litoj	lit'o'j
litojn	lit'o'j'n
liton	lit'o'n
litaĵoj	lit'aĵ'o'j
litaĵon	lit'aĵ'o'n
litbenko	lit'benk'o
litĉambro	lit'ĉambr'o
liteto	lit'et'o
liteton	lit'et'o'n
litkovrilo	lit'kovr'il'o
litkovriloj	lit'kovr'il'o'j
litkovrilojn	lit'kovr'il'o'j'n
litkovrilon	lit'kovr'il'o'n
litoĉambro	lit'o'ĉambr'o
litotuko	lit'o'tuk'o
litotukoj	lit'o'tuk'o'j
litotukojn	lit'o'tuk'o'j'n
littuko	lit'tuk'o
littukoj	lit'tuk'o'j
littukojn	lit'tuk'o'j'n
littukon	lit'tuk'o'n
litanio	litani'o
litanioj	litani'o'j
litanion	litani'o'n
litera	liter'a
litere	liter'e
litero	liter'o
literoj	liter'o'j
literojn	liter'o'j'n
literon	liter'o'n
literaro	liter'ar'o
literaron	liter'ar'o'n
literkombino	liter'kombin'o
liternomoj	liter'nom'o'j
litertipo	liter'tip'o
litertipoj	liter'tip'o'j
literuma	liter'um'a
literumaj	liter'um'a'j
literumas	liter'um'as
literumi	liter'um'i
literumis	liter'um'is
literumo	liter'um'o
literumoj	liter'um'o'j
literumojn	liter'um'o'j'n
literumon	liter'um'o'n
literumado	liter'um'ad'o
literumadon	liter'um'ad'o'n
literumilo	liter'um'il'o
literumilon	liter'um'il'o'n
literumita	liter'um'it'a
literumitaj	liter'um'it'a'j
literatoroj	literator'o'j
literatura	literatur'a
literaturaj	literatur'a'j
literaturajn	literatur'a'j'n
literaturan	literatur'a'n
literature	literatur'e
literaturo	literatur'o
literaturoj	literatur'o'j
literaturojn	literatur'o'j'n
literaturon	literatur'o'n
literaturaĵo	literatur'aĵ'o
literaturaĵoj	literatur'aĵ'o'j
literaturaĵojn	literatur'aĵ'o'j'n
literaturhistorio	literatur'histori'o
literaturisto	literatur'ist'o
literaturistoj	literatur'ist'o'j
literaturrecenzistoj	literatur'recenz'ist'o'j
literaturscienco	literatur'scienc'o
literaturteorio	literatur'teori'o
literaturuloj	literatur'ul'o'j
litia	liti'a
litio	liti'o
litografio	litograf'i'o
litorino	litorin'o
litosfero	litosfer'o
litova	litov'a
litovaj	litov'a'j
litovajn	litov'a'j'n
litovan	litov'a'n
litove	litov'e
litovo	litov'o
litovoj	litov'o'j
litovia	litov'i'a
litoviaj	litov'i'a'j
litovio	litov'i'o
litovion	litov'i'o'n
litovujo	litov'uj'o
litro	litr'o
litroj	litr'o'j
litrojn	litr'o'j'n
litron	litr'o'n
liturgia	liturgi'a
liturgiaj	liturgi'a'j
liturgiajn	liturgi'a'j'n
liturgian	liturgi'a'n
liturgie	liturgi'e
liturgio	liturgi'o
liturgioj	liturgi'o'j
liturgion	liturgi'o'n
liuto	liut'o
liuton	liut'o'n
liva	liv'a
live	liv'e
liven	liv'e'n
livoj	liv'o'j
livera	liver'a
liveras	liver'as
liveri	liver'i
liveris	liver'is
livero	liver'o
liveron	liver'o'n
liveros	liver'os
liveru	liver'u
liverus	liver'us
liverado	liver'ad'o
liveradon	liver'ad'o'n
liveraĵo	liver'aĵ'o
liveraĵoj	liver'aĵ'o'j
liveraĵon	liver'aĵ'o'n
liveranta	liver'ant'a
liverantaj	liver'ant'a'j
liverante	liver'ant'e
liveranto	liver'ant'o
liverantoj	liver'ant'o'j
liverata	liver'at'a
liverataj	liver'at'a'j
liveriĝis	liver'iĝ'is
liverita	liver'it'a
liveritaj	liver'it'a'j
liveritajn	liver'it'a'j'n
liveritan	liver'it'a'n
liverite	liver'it'e
liverpolo	liverpol'o
livia	livi'a
livio	livi'o
livonio	livon'i'o
livreo	livre'o
lizipo	lizip'o
lobaj	lob'a'j
lobo	lob'o
loboj	lob'o'j
lobojn	lob'o'j'n
lobon	lob'o'n
lobias	lobi'as
lobio	lobi'o
lobiado	lobi'ad'o
lobiadon	lobi'ad'o'n
lobiistoj	lobi'ist'o'j
lode	lod'e
lodo	lod'o
loga	log'a
logan	log'a'n
logas	log'as
loge	log'e
logi	log'i
logis	log'is
logo	log'o
logon	log'o'n
logos	log'os
logaĵo	log'aĵ'o
logaĵoj	log'aĵ'o'j
logaĵon	log'aĵ'o'n
logante	log'ant'e
logata	log'at'a
logilo	log'il'o
logilon	log'il'o'n
logita	log'it'a
logitaj	log'it'a'j
loglibro	log'libr'o
logaritma	logaritm'a
logaritmo	logaritm'o
logika	logik'a
logikaj	logik'a'j
logikajn	logik'a'j'n
logikan	logik'a'n
logikas	logik'as
logike	logik'e
logiko	logik'o
logikoj	logik'o'j
logikon	logik'o'n
logikeco	logik'ec'o
logikecon	logik'ec'o'n
logikisto	logik'ist'o
logikistoj	logik'ist'o'j
loglano	loglan'o
logoo	logo'o
logogramoj	logogram'o'j
logopediisto	logopedi'ist'o
logoso	logos'o
loĝa	loĝ'a
loĝaj	loĝ'a'j
loĝas	loĝ'as
loĝi	loĝ'i
loĝis	loĝ'is
loĝo	loĝ'o
loĝos	loĝ'os
loĝu	loĝ'u
loĝus	loĝ'us
loĝadis	loĝ'ad'is
loĝado	loĝ'ad'o
loĝadon	loĝ'ad'o'n
loĝanta	loĝ'ant'a
loĝantaj	loĝ'ant'a'j
loĝantajn	loĝ'ant'a'j'n
loĝantan	loĝ'ant'a'n
loĝante	loĝ'ant'e
loĝanto	loĝ'ant'o
loĝantoj	loĝ'ant'o'j
loĝantojn	loĝ'ant'o'j'n
loĝanton	loĝ'ant'o'n
loĝantara	loĝ'ant'ar'a
loĝantaro	loĝ'ant'ar'o
loĝantaroj	loĝ'ant'ar'o'j
loĝantarojn	loĝ'ant'ar'o'j'n
loĝantaron	loĝ'ant'ar'o'n
loĝantarcentroj	loĝ'ant'ar'centr'o'j
loĝantargrupoj	loĝ'ant'ar'grup'o'j
loĝantarkresko	loĝ'ant'ar'kresk'o
loĝantarkreskon	loĝ'ant'ar'kresk'o'n
loĝantino	loĝ'ant'in'o
loĝata	loĝ'at'a
loĝataj	loĝ'at'a'j
loĝatajn	loĝ'at'a'j'n
loĝatan	loĝ'at'a'n
loĝdenso	loĝ'dens'o
loĝdensoj	loĝ'dens'o'j
loĝdoma	loĝ'dom'a
loĝdomaj	loĝ'dom'a'j
loĝdomo	loĝ'dom'o
loĝdomoj	loĝ'dom'o'j
loĝdomojn	loĝ'dom'o'j'n
loĝdomon	loĝ'dom'o'n
loĝebla	loĝ'ebl'a
loĝeblaj	loĝ'ebl'a'j
loĝeblan	loĝ'ebl'a'n
loĝeja	loĝ'ej'a
loĝejaj	loĝ'ej'a'j
loĝejo	loĝ'ej'o
loĝejoj	loĝ'ej'o'j
loĝejojn	loĝ'ej'o'j'n
loĝejon	loĝ'ej'o'n
loĝejaro	loĝ'ej'ar'o
loĝejaroj	loĝ'ej'ar'o'j
loĝiga	loĝ'ig'a
loĝigas	loĝ'ig'as
loĝigi	loĝ'ig'i
loĝigis	loĝ'ig'is
loĝigo	loĝ'ig'o
loĝigon	loĝ'ig'o'n
loĝigita	loĝ'ig'it'a
loĝigitaj	loĝ'ig'it'a'j
loĝinta	loĝ'int'a
loĝintaj	loĝ'int'a'j
loĝita	loĝ'it'a
loĝitaj	loĝ'it'a'j
loĝitajn	loĝ'it'a'j'n
loĝitan	loĝ'it'a'n
loĝkondiĉoj	loĝ'kondiĉ'o'j
loĝkonstruaĵoj	loĝ'konstru'aĵ'o'j
loĝkvartala	loĝ'kvartal'a
loĝkvartalo	loĝ'kvartal'o
loĝkvartaloj	loĝ'kvartal'o'j
loĝkvartalojn	loĝ'kvartal'o'j'n
loĝlando	loĝ'land'o
loĝlernejo	loĝ'lern'ej'o
loĝlernejoj	loĝ'lern'ej'o'j
loĝloko	loĝ'lok'o
loĝlokoj	loĝ'lok'o'j
loĝlokojn	loĝ'lok'o'j'n
loĝlokon	loĝ'lok'o'n
loĝoĉambro	loĝ'o'ĉambr'o
loĝregiono	loĝ'region'o
loĝurbo	loĝ'urb'o
loĝio	loĝi'o
loĝioj	loĝi'o'j
loĝion	loĝi'o'n
loĝistika	loĝistik'a
loĝistikaj	loĝistik'a'j
loĝistikajn	loĝistik'a'j'n
loĝistikan	loĝistik'a'n
loĝistike	loĝistik'e
loĝistiko	loĝistik'o
loĝistikon	loĝistik'o'n
lojala	lojal'a
lojalaj	lojal'a'j
lojalajn	lojal'a'j'n
lojalan	lojal'a'n
lojale	lojal'e
lojalo	lojal'o
lojaleco	lojal'ec'o
lojalecoj	lojal'ec'o'j
lojalecojn	lojal'ec'o'j'n
lojalecon	lojal'ec'o'n
lojaluloj	lojal'ul'o'j
loĵbano	loĵban'o
loĵbanon	loĵban'o'n
loĵbanistoj	loĵban'ist'o'j
loka	lok'a
lokaj	lok'a'j
lokajn	lok'a'j'n
lokan	lok'a'n
lokas	lok'as
loke	lok'e
loki	lok'i
lokis	lok'is
loko	lok'o
lokoj	lok'o'j
lokojn	lok'o'j'n
lokon	lok'o'n
loku	lok'u
lokus	lok'us
lokaadministraciaj	lok'a'administraci'a'j
lokado	lok'ad'o
lokadon	lok'ad'o'n
lokaĵigado	lok'aĵ'ig'ad'o
lokano	lok'an'o
lokanoj	lok'an'o'j
lokanojn	lok'an'o'j'n
lokante	lok'ant'e
lokata	lok'at'a
lokataj	lok'at'a'j
loketo	lok'et'o
lokigas	lok'ig'as
lokigi	lok'ig'i
lokigis	lok'ig'is
lokigo	lok'ig'o
lokigon	lok'ig'o'n
lokigita	lok'ig'it'a
lokigitaj	lok'ig'it'a'j
lokiĝas	lok'iĝ'as
lokiĝi	lok'iĝ'i
lokiĝis	lok'iĝ'is
lokiĝo	lok'iĝ'o
lokiĝon	lok'iĝ'o'n
lokita	lok'it'a
lokitaj	lok'it'a'j
loknomo	lok'nom'o
loknomoj	lok'nom'o'j
loknomojn	lok'nom'o'j'n
lokonomo	lok'o'nom'o
lokposedaĵo	lok'posed'aĵ'o
lokposedaĵon	lok'posed'aĵ'o'n
loktrova	lok'trov'a
lokulo	lok'ul'o
lokuloj	lok'ul'o'j
lokulojn	lok'ul'o'j'n
lokala	lokal'a
lokalaj	lokal'a'j
lokalo	lokal'o
lokaloj	lokal'o'j
lokalojn	lokal'o'j'n
lokalon	lokal'o'n
lokalizas	lokaliz'as
lokalizi	lokaliz'i
lokalizis	lokaliz'is
lokalizo	lokaliz'o
lokalizon	lokaliz'o'n
lokalizado	lokaliz'ad'o
lokalizante	lokaliz'ant'e
lokalizilo	lokaliz'il'o
lokalizita	lokaliz'it'a
lokalizitaj	lokaliz'it'a'j
lokalizitajn	lokaliz'it'a'j'n
lokalizitan	lokaliz'it'a'n
lokaŭto	lokaŭt'o
lokio	loki'o
lokomobilo	lokomobil'o
lokomobilon	lokomobil'o'n
lokomotivo	lokomotiv'o
lokomotivoj	lokomotiv'o'j
lokomotivojn	lokomotiv'o'j'n
lokomotivon	lokomotiv'o'n
lokucio	lokuci'o
lokuso	lokus'o
lokusoj	lokus'o'j
lokusto	lokust'o
lokustoj	lokust'o'j
lola	lol'a
lolo	lol'o
lombarda	lombard'a
lombardaj	lombard'a'j
lombardi	lombard'i
lombardo	lombard'o
lombardoj	lombard'o'j
lombardio	lombard'i'o
lombardujo	lombard'uj'o
londona	london'a
londonaj	london'a'j
londono	london'o
londonon	london'o'n
londonanoj	london'an'o'j
longa	long'a
longaj	long'a'j
longajn	long'a'j'n
longan	long'a'n
longas	long'as
longe	long'e
longis	long'is
longo	long'o
longoj	long'o'j
longojn	long'o'j'n
longon	long'o'n
longus	long'us
longakura	long'a'kur'a
longatempa	long'a'temp'a
longatempan	long'a'temp'a'n
longatempe	long'a'temp'e
longbeka	long'bek'a
longdaŭra	long'daŭr'a
longdaŭraj	long'daŭr'a'j
longdaŭrajn	long'daŭr'a'j'n
longdaŭran	long'daŭr'a'n
longdaŭre	long'daŭr'e
longdaŭranta	long'daŭr'ant'a
longdaŭrantaj	long'daŭr'ant'a'j
longdaŭrantan	long'daŭr'ant'a'n
longdistanca	long'distanc'a
longdistancaj	long'distanc'a'j
longdistancajn	long'distanc'a'j'n
longdistancan	long'distanc'a'n
longdistance	long'distanc'e
longdistanco	long'distanc'o
longdistancoj	long'distanc'o'j
longdistancojn	long'distanc'o'j'n
longedaŭra	long'e'daŭr'a
longedaŭraj	long'e'daŭr'a'j
longedaŭrajn	long'e'daŭr'a'j'n
longedaŭran	long'e'daŭr'a'n
longeviva	long'e'viv'a
longevivaj	long'e'viv'a'j
longeca	long'ec'a
longecaj	long'ec'a'j
longecajn	long'ec'a'j'n
longecan	long'ec'a'n
longeco	long'ec'o
longecoj	long'ec'o'j
longecon	long'ec'o'n
longega	long'eg'a
longegaj	long'eg'a'j
longegan	long'eg'a'n
longege	long'eg'e
longeta	long'et'a
longforma	long'form'a
longformaj	long'form'a'j
longformajn	long'form'a'j'n
longforman	long'form'a'n
longhara	long'har'a
longharaj	long'har'a'j
longigas	long'ig'as
longigi	long'ig'i
longigo	long'ig'o
longigita	long'ig'it'a
longiĝas	long'iĝ'as
longiĝis	long'iĝ'is
longjara	long'jar'a
longjaraj	long'jar'a'j
longjaran	long'jar'a'n
longkruraj	long'krur'a'j
longmanika	long'manik'a
longmemoro	long'memor'o
longperspektiva	long'perspektiv'a
longperspektivaj	long'perspektiv'a'j
longperspektivajn	long'perspektiv'a'j'n
longperspektivan	long'perspektiv'a'n
longsilaboj	long'silab'o'j
longŝnuro	long'ŝnur'o
longtempa	long'temp'a
longtempaj	long'temp'a'j
longtempan	long'temp'a'n
longtempe	long'temp'e
longulo	long'ul'o
longviva	long'viv'a
longviveco	long'viv'ec'o
longvivecon	long'viv'ec'o'n
longvivuloj	long'viv'ul'o'j
longvokalo	long'vokal'o
longvokaloj	long'vokal'o'j
longvokalojn	long'vokal'o'j'n
longvokalon	long'vokal'o'n
longvosta	long'vost'a
longvostaj	long'vost'a'j
longituda	longitud'a
longitudaj	longitud'a'j
longitudan	longitud'a'n
longitudo	longitud'o
longitudoj	longitud'o'j
longitudon	longitud'o'n
longobarda	longobard'a
longobardoj	longobard'o'j
lordo	lord'o
lordoj	lord'o'j
lordĉambro	lord'ĉambr'o
lordino	lord'in'o
lordkanceliero	lord'kancelier'o
lorno	lorn'o
lornoj	lorn'o'j
lornon	lorn'o'n
loto	lot'o
loton	lot'o'n
lotus	lot'us
lotado	lot'ad'o
lotumado	lot'um'ad'o
lotario	lotari'o
loterio	loteri'o
loterioj	loteri'o'j
loterion	loteri'o'n
lotusa	lotus'a
lotusaj	lotus'a'j
lotuso	lotus'o
lotusoj	lotus'o'j
lotusflora	lotus'flor'a
lotusfloro	lotus'flor'o
lotusfloroj	lotus'flor'o'j
loveno	loven'o
luan	lu'a'n
luas	lu'as
lui	lu'i
luis	lu'is
luo	lu'o
luon	lu'o'n
luos	lu'os
luado	lu'ad'o
luadon	lu'ad'o'n
luanto	lu'ant'o
luantoj	lu'ant'o'j
luantojn	lu'ant'o'j'n
ludonas	lu'don'as
ludoni	lu'don'i
ludonis	lu'don'is
luebla	lu'ebl'a
lueblaj	lu'ebl'a'j
luigi	lu'ig'i
luigis	lu'ig'is
luiganto	lu'ig'ant'o
luigantoj	lu'ig'ant'o'j
luigita	lu'ig'it'a
luita	lu'it'a
luitaj	lu'it'a'j
lupago	lu'pag'o
lupagoj	lu'pag'o'j
lupagon	lu'pag'o'n
lupreni	lu'pren'i
luprenis	lu'pren'is
luprezo	lu'prez'o
luprezon	lu'prez'o'n
luando	luand'o
luaro	luar'o
luarlandoj	luar'land'o'j
lubeko	lubek'o
lubrika	lubrik'a
lubrikas	lubrik'as
lubriki	lubrik'i
lubrikado	lubrik'ad'o
lubrikadon	lubrik'ad'o'n
lubrikaĵo	lubrik'aĵ'o
lubrikaĵoj	lubrik'aĵ'o'j
lubrikaĵon	lubrik'aĵ'o'n
lucerno	lucern'o
lucia	luci'a
lucian	luci'a'n
lucio	luci'o
luciano	lucian'o
lucida	lucid'a
lucidaj	lucid'a'j
lucifero	lucifer'o
luda	lud'a
ludaj	lud'a'j
ludan	lud'a'n
ludas	lud'as
lude	lud'e
ludi	lud'i
ludis	lud'is
ludo	lud'o
ludoj	lud'o'j
ludojn	lud'o'j'n
ludon	lud'o'n
ludos	lud'os
ludu	lud'u
ludus	lud'us
ludadis	lud'ad'is
ludado	lud'ad'o
ludadoj	lud'ad'o'j
ludadon	lud'ad'o'n
ludanta	lud'ant'a
ludantaj	lud'ant'a'j
ludantajn	lud'ant'a'j'n
ludantan	lud'ant'a'n
ludante	lud'ant'e
ludanto	lud'ant'o
ludantoj	lud'ant'o'j
ludantojn	lud'ant'o'j'n
ludanton	lud'ant'o'n
ludareo	lud'are'o
ludarto	lud'art'o
ludarton	lud'art'o'n
ludata	lud'at'a
ludataj	lud'at'a'j
ludatan	lud'at'a'n
luddezajno	lud'dezajn'o
ludebla	lud'ebl'a
ludeblaj	lud'ebl'a'j
ludejo	lud'ej'o
ludejoj	lud'ej'o'j
ludejon	lud'ej'o'n
ludema	lud'em'a
ludemaj	lud'em'a'j
ludeme	lud'em'e
ludemo	lud'em'o
ludestro	lud'estr'o
ludigas	lud'ig'as
ludiĝas	lud'iĝ'as
ludiĝis	lud'iĝ'is
ludila	lud'il'a
ludilo	lud'il'o
ludiloj	lud'il'o'j
ludilojn	lud'il'o'j'n
ludilon	lud'il'o'n
ludilvendejo	lud'il'vend'ej'o
ludinta	lud'int'a
ludinventistoj	lud'invent'ist'o'j
ludisto	lud'ist'o
ludistoj	lud'ist'o'j
ludistojn	lud'ist'o'j'n
ludita	lud'it'a
luditaj	lud'it'a'j
luditan	lud'it'a'n
ludite	lud'it'e
ludkampo	lud'kamp'o
ludkampon	lud'kamp'o'n
ludkartoj	lud'kart'o'j
ludkartojn	lud'kart'o'j'n
ludkonzolo	lud'konzol'o
ludkonzoloj	lud'konzol'o'j
ludmaniero	lud'manier'o
ludmaŝino	lud'maŝin'o
ludmondo	lud'mond'o
ludotablo	lud'o'tabl'o
ludoteorio	lud'o'teori'o
ludpeco	lud'pec'o
ludpecoj	lud'pec'o'j
ludpecon	lud'pec'o'n
ludperiodo	lud'period'o
ludtabulo	lud'tabul'o
ludmila	ludmila
ludoviko	ludovik'o
ludovikon	ludovik'o'n
luisa	luis'a
luiso	luis'o
luka	luk'a
luke	luk'e
luko	luk'o
lukoj	luk'o'j
lukon	luk'o'n
lukano	lukan'o
lukrecio	lukreci'o
luksa	luks'a
luksaj	luks'a'j
luksajn	luks'a'j'n
luksan	luks'a'n
lukse	luks'e
lukso	luks'o
luksoj	luks'o'j
lukson	luks'o'n
luksaĵo	luks'aĵ'o
luksaĵoj	luks'aĵ'o'j
luksaĵojn	luks'aĵ'o'j'n
luksaŭtoj	luks'aŭt'o'j
lukskvalita	luks'kvalit'a
lukskvalitaj	luks'kvalit'a'j
luksemburga	luksemburg'a
luksemburgaj	luksemburg'a'j
luksemburgo	luksemburg'o
luksemburgia	luksemburg'i'a
luksemburgio	luksemburg'i'o
luksemburgion	luksemburg'i'o'n
luksoro	luksor'o
lukta	lukt'a
luktaj	lukt'a'j
luktas	lukt'as
lukte	lukt'e
lukti	lukt'i
luktis	lukt'is
lukto	lukt'o
luktoj	lukt'o'j
luktojn	lukt'o'j'n
lukton	lukt'o'n
luktos	lukt'os
luktu	lukt'u
luktadis	lukt'ad'is
luktado	lukt'ad'o
luktadon	lukt'ad'o'n
luktanta	lukt'ant'a
luktantaj	lukt'ant'a'j
luktante	lukt'ant'e
luktanto	lukt'ant'o
luktantoj	lukt'ant'o'j
luktarto	lukt'art'o
luktartoj	lukt'art'o'j
luktarton	lukt'art'o'n
luktisto	lukt'ist'o
luktistoj	lukt'ist'o'j
luktoarto	lukt'o'art'o
luktosporto	lukt'o'sport'o
luktosportoj	lukt'o'sport'o'j
lula	lul'a
lulas	lul'as
luli	lul'i
lulis	lul'is
lulu	lul'u
lulilo	lul'il'o
luliloj	lul'il'o'j
lulilon	lul'il'o'n
lulkanto	lul'kant'o
lulkantoj	lul'kant'o'j
lulkanton	lul'kant'o'n
luma	lum'a
lumaj	lum'a'j
lumajn	lum'a'j'n
luman	lum'a'n
lumas	lum'as
lume	lum'e
lumi	lum'i
lumis	lum'is
lumo	lum'o
lumoj	lum'o'j
lumojn	lum'o'j'n
lumon	lum'o'n
lumu	lum'u
lumanta	lum'ant'a
lumantaj	lum'ant'a'j
lumantajn	lum'ant'a'j'n
lumantan	lum'ant'a'n
lumante	lum'ant'e
lumbildoj	lum'bild'o'j
lumbildojn	lum'bild'o'j'n
lumdiodo	lum'diod'o
lumdiodoj	lum'diod'o'j
lumdisko	lum'disk'o
lumdiskoj	lum'disk'o'j
lumeco	lum'ec'o
lumecon	lum'ec'o'n
lumeliganta	lum'el'ig'ant'a
lumeligantaj	lum'el'ig'ant'a'j
lumenergio	lum'energi'o
lumetis	lum'et'is
lumeto	lum'et'o
lumetoj	lum'et'o'j
lumeton	lum'et'o'n
lumfolio	lum'foli'o
lumfonto	lum'font'o
lumfontoj	lum'font'o'j
lumfonton	lum'font'o'n
lumigas	lum'ig'as
lumigi	lum'ig'i
lumigis	lum'ig'is
lumigo	lum'ig'o
lumigon	lum'ig'o'n
lumigu	lum'ig'u
lumigado	lum'ig'ad'o
lumiganta	lum'ig'ant'a
lumigante	lum'ig'ant'e
lumigata	lum'ig'at'a
lumigataj	lum'ig'at'a'j
lumigilo	lum'ig'il'o
lumigiloj	lum'ig'il'o'j
lumigita	lum'ig'it'a
lumigitaj	lum'ig'it'a'j
lumigitajn	lum'ig'it'a'j'n
lumigitan	lum'ig'it'a'n
lumiĝas	lum'iĝ'as
lumiĝis	lum'iĝ'is
lumilo	lum'il'o
lumiloj	lum'il'o'j
lumilojn	lum'il'o'j'n
lumindustrio	lum'industri'o
lumintenso	lum'intens'o
lumjaroj	lum'jar'o'j
lumĵetilo	lum'ĵet'il'o
lumĵetiloj	lum'ĵet'il'o'j
lumĵetilojn	lum'ĵet'il'o'j'n
lumkondiĉoj	lum'kondiĉ'o'j
lumondoj	lum'ond'o'j
lumradio	lum'radi'o
lumradioj	lum'radi'o'j
lumrapido	lum'rapid'o
lumrapideco	lum'rapid'ec'o
lumsabro	lum'sabr'o
lumsentema	lum'sent'em'a
lumsentemaj	lum'sent'em'a'j
lumsignaloj	lum'signal'o'j
lumtrabo	lum'trab'o
lumtubo	lum'tub'o
lumtuboj	lum'tub'o'j
lumtura	lum'tur'a
lumturo	lum'tur'o
lumturoj	lum'tur'o'j
lumba	lumb'a
lumbaj	lumb'a'j
lumbo	lumb'o
lumbon	lumb'o'n
lumbaĵo	lumb'aĵ'o
lumbriko	lumbrik'o
lumbrikoj	lumbrik'o'j
luna	lun'a
lunaj	lun'a'j
lunajn	lun'a'j'n
lunan	lun'a'n
luno	lun'o
lunoj	lun'o'j
lunojn	lun'o'j'n
lunon	lun'o'n
lunarko	lun'ark'o
lunarkon	lun'ark'o'n
lunbrilo	lun'bril'o
lunfazoj	lun'faz'o'j
lunkuko	lun'kuk'o
lunkukoj	lun'kuk'o'j
lunkukojn	lun'kuk'o'j'n
lunluma	lun'lum'a
lunlumo	lun'lum'o
lunorbito	lun'orbit'o
lunsuna	lun'sun'a
lunsurfaco	lun'surfac'o
lunĉi	lunĉ'i
lunĉo	lunĉ'o
lunĉon	lunĉ'o'n
lunda	lund'a
lunde	lund'e
lundo	lund'o
lundoj	lund'o'j
lundon	lund'o'n
lupa	lup'a
lupan	lup'a'n
lupe	lup'e
lupo	lup'o
lupoj	lup'o'j
lupojn	lup'o'j'n
lupon	lup'o'n
lupeo	lupe'o
lupeon	lupe'o'n
lupino	lupin'o
lupolo	lupol'o
lupolon	lupol'o'n
lupuso	lupus'o
lustro	lustr'o
lustroj	lustr'o'j
lustron	lustr'o'n
lutas	lut'as
luti	lut'i
lutado	lut'ad'o
lutaĵo	lut'aĵ'o
lutaĵon	lut'aĵ'o'n
lutita	lut'it'a
lutera	luter'a
luteraj	luter'a'j
luteran	luter'a'n
lutero	luter'o
luteron	luter'o'n
luterana	luter'an'a
luteranaj	luter'an'a'j
luterano	luter'an'o
luteranoj	luter'an'o'j
luteranismo	luter'an'ism'o
lutermano	luterman'o
lutro	lutr'o
lutroj	lutr'o'j
luzerno	luzern'o
luzono	luzon'o