macojn	mac'o'j'n
maciso	macis'o
maĉas	maĉ'as
maĉi	maĉ'i
maĉis	maĉ'is
maĉo	maĉ'o
maĉon	maĉ'o'n
maĉado	maĉ'ad'o
maĉante	maĉ'ant'e
maĉeto	maĉ'et'o
maĉetoj	maĉ'et'o'j
maĉgumo	maĉ'gum'o
maĉgumon	maĉ'gum'o'n
maĉeto	maĉet'o
maĉetoj	maĉet'o'j
maĉupikĉuo	maĉupikĉu'o
madagaskara	madagaskar'a
madagaskaraj	madagaskar'a'j
madagaskaro	madagaskar'o
madejro	madejr'o
madono	madon'o
madonoj	madon'o'j
madonon	madon'o'n
madrigaloj	madrigal'o'j
mafia	mafi'a
mafiaj	mafi'a'j
mafio	mafi'o
mafioj	mafi'o'j
mafion	mafi'o'n
mago	mag'o
magoj	mag'o'j
magazeno	magazen'o
magazenoj	magazen'o'j
magazenojn	magazen'o'j'n
magazenon	magazen'o'n
magazine	magazin'e
magazino	magazin'o
magazinoj	magazin'o'j
magazinojn	magazin'o'j'n
magazinon	magazin'o'n
magdalena	magdalen'a
magdaleno	magdalen'o
magdeburgo	magdeburg'o
magelana	magelan'a
magelano	magelan'o
magia	magi'a
magiaj	magi'a'j
magiajn	magi'a'j'n
magian	magi'a'n
magie	magi'e
magio	magi'o
magion	magi'o'n
magiaĵojn	magi'aĵ'o'j'n
magiaĵon	magi'aĵ'o'n
magiiloj	magi'il'o'j
magiisto	magi'ist'o
magiistoj	magi'ist'o'j
magiiston	magi'ist'o'n
magiulino	magi'ul'in'o
magistra	magistr'a
magistran	magistr'a'n
magistro	magistr'o
magistroj	magistr'o'j
magistrojn	magistr'o'j'n
magistron	magistr'o'n
magistriĝis	magistr'iĝ'is
magistrato	magistrat'o
magistratoj	magistrat'o'j
magistratojn	magistrat'o'j'n
magistratano	magistrat'an'o
magistratanoj	magistrat'an'o'j
maglevo	maglev'o
magma	magm'a
magmaj	magm'a'j
magmo	magm'o
magnato	magnat'o
magnatoj	magnat'o'j
magneta	magnet'a
magnetaj	magnet'a'j
magnetajn	magnet'a'j'n
magnetan	magnet'a'n
magnete	magnet'e
magneto	magnet'o
magnetoj	magnet'o'j
magnetojn	magnet'o'j'n
magneton	magnet'o'n
magnetado	magnet'ad'o
magnetigo	magnet'ig'o
magnetigon	magnet'ig'o'n
magnetigita	magnet'ig'it'a
magnetismo	magnet'ism'o
magnetismon	magnet'ism'o'n
magnetito	magnetit'o
magnetofono	magnetofon'o
magnetofonoj	magnetofon'o'j
magnetofonon	magnetofon'o'n
magnetosfero	magnetosfer'o
magnetrono	magnetron'o
magnezia	magnezi'a
magnezio	magnezi'o
magnezion	magnezi'o'n
magnitudo	magnitud'o
magnolia	magnoli'a
magnolio	magnoli'o
magnolioj	magnoli'o'j
magra	magr'a
magraj	magr'a'j
magran	magr'a'n
magrebaj	magreb'a'j
magrebo	magreb'o
maĝango	maĝang'o
maĝangon	maĝang'o'n
mahabarato	mahabarat'o
mahagono	mahagon'o
mahajana	mahajan'a
mahajanaj	mahajan'a'j
mahajano	mahajan'o
mahometo	mahomet'o
mahometana	mahomet'an'a
mahometanaj	mahomet'an'a'j
mahometano	mahomet'an'o
mahometanoj	mahomet'an'o'j
maĥo	maĥ'o
maiza	maiz'a
maizaj	maiz'a'j
maizan	maiz'a'n
maizo	maiz'o
maizoj	maiz'o'j
maizojn	maiz'o'j'n
maizon	maiz'o'n
maizfaruno	maiz'farun'o
maizsiropo	maiz'sirop'o
maja	maj'a
majaj	maj'a'j
majan	maj'a'n
maje	maj'e
majo	maj'o
majon	maj'o'n
majojunio	maj'o'juni'o
majaa	maja'a
majaaj	maja'a'j
majaoj	maja'o'j
majenca	majenc'a
majenco	majenc'o
majesta	majest'a
majestaj	majest'a'j
majestajn	majest'a'j'n
majestan	majest'a'n
majestas	majest'as
majeste	majest'e
majesto	majest'o
majeston	majest'o'n
majesteco	majest'ec'o
majestecon	majest'ec'o'n
majno	majn'o
majonezo	majonez'o
majonezon	majonez'o'n
majora	major'a
majoraj	major'a'j
majoro	major'o
majoroj	major'o'j
majoron	major'o'n
majorino	major'in'o
majoratulo	majorat'ul'o
majoritata	majoritat'a
majoritataj	majoritat'a'j
majoritate	majoritat'e
majoritato	majoritat'o
majoritaton	majoritat'o'n
majoto	majot'o
majstra	majstr'a
majstraj	majstr'a'j
majstrajn	majstr'a'j'n
majstran	majstr'a'n
majstras	majstr'as
majstre	majstr'e
majstri	majstr'i
majstris	majstr'is
majstro	majstr'o
majstroj	majstr'o'j
majstrojn	majstr'o'j'n
majstron	majstr'o'n
majstrado	majstr'ad'o
majstradon	majstr'ad'o'n
majstraĵo	majstr'aĵ'o
majstraĵoj	majstr'aĵ'o'j
majstraĵon	majstr'aĵ'o'n
majstreco	majstr'ec'o
majstrecon	majstr'ec'o'n
majstrino	majstr'in'o
majstroverko	majstr'o'verk'o
majstroverkoj	majstr'o'verk'o'j
majuskla	majuskl'a
majusklaj	majuskl'a'j
majuskle	majuskl'e
majusklo	majuskl'o
majuskloj	majuskl'o'j
majusklojn	majuskl'o'j'n
majusklon	majuskl'o'n
maĵora	maĵor'a
maĵoraj	maĵor'a'j
maĵoran	maĵor'a'n
maĵoro	maĵor'o
makao	maka'o
makabeoj	makabe'o'j
makabra	makabr'a
makabran	makabr'a'n
makako	makak'o
makakoj	makak'o'j
makaronioj	makaroni'o'j
makaroniojn	makaroni'o'j'n
makedona	makedon'a
makedonaj	makedon'a'j
makedonajn	makedon'a'j'n
makedonan	makedon'a'n
makedono	makedon'o
makedonoj	makedon'o'j
makedonojn	makedon'o'j'n
makedonio	makedon'i'o
makedonion	makedon'i'o'n
makedonujo	makedon'uj'o
makiavelo	makiavel'o
makintoŝo	makintoŝ'o
makintoŝoj	makintoŝ'o'j
makiso	makis'o
makisanoj	makis'an'o'j
makleristo	makler'ist'o
makleristoj	makler'ist'o'j
makroo	makro'o
makrooj	makro'o'j
makroojn	makro'o'j'n
makroekonomia	makro'ekonomi'a
makroekonomiaj	makro'ekonomi'a'j
makroekonomio	makro'ekonomi'o
makrokosmo	makro'kosm'o
makromolekuloj	makro'molekul'o'j
makrosocio	makro'soci'o
makrofagoj	makrofag'o'j
makropsio	makropsi'o
maksimo	maksim'o
maksimoj	maksim'o'j
maksimojn	maksim'o'j'n
maksimon	maksim'o'n
maksimiliano	maksimilian'o
maksimuma	maksimum'a
maksimumaj	maksimum'a'j
maksimumajn	maksimum'a'j'n
maksimuman	maksimum'a'n
maksimume	maksimum'e
maksimumo	maksimum'o
maksimumoj	maksimum'o'j
maksimumon	maksimum'o'n
maksimumigas	maksimum'ig'as
maksimumigi	maksimum'ig'i
maksimumigado	maksimum'ig'ad'o
maksimumigante	maksimum'ig'ant'e
maksimumigita	maksimum'ig'it'a
maksimumnombro	maksimum'nombr'o
makula	makul'a
makulaj	makul'a'j
makulan	makul'a'n
makulas	makul'as
makuli	makul'i
makulis	makul'is
makulo	makul'o
makuloj	makul'o'j
makulojn	makul'o'j'n
makulon	makul'o'n
makulado	makul'ad'o
makuleca	makul'ec'a
makulego	makul'eg'o
makulegoj	makul'eg'o'j
makuleto	makul'et'o
makuletoj	makul'et'o'j
makuletojn	makul'et'o'j'n
makuleton	makul'et'o'n
makuleteco	makul'et'ec'o
makulhieno	makul'hien'o
makulhienoj	makul'hien'o'j
makulita	makul'it'a
makulitaj	makul'it'a'j
makulitajn	makul'it'a'j'n
makulitan	makul'it'a'n
makzelo	makzel'o
makzeloj	makzel'o'j
makzelojn	makzel'o'j'n
makzelon	makzel'o'n
mala	mal'a
malaj	mal'a'j
malajn	mal'a'j'n
malan	mal'a'n
malantau	mal'antaŭ
malantaŭ	mal'antaŭ
male	mal'e
malkiel	mal'kiel
malo	mal'o
maloj	mal'o'j
malon	mal'o'n
malplej	mal'plej
malpli	mal'pli
malsuper	mal'super
maltro	mal'tro
malabunda	mal'abund'a
malabundaj	mal'abund'a'j
malabundajn	mal'abund'a'j'n
malabundan	mal'abund'a'n
malabundas	mal'abund'as
malabunde	mal'abund'e
malabundo	mal'abund'o
malabundoj	mal'abund'o'j
malabundeco	mal'abund'ec'o
maladekvata	mal'adekvat'a
malafabla	mal'afabl'a
malafablaj	mal'afabl'a'j
malafablajn	mal'afabl'a'j'n
malafablan	mal'afabl'a'n
malafable	mal'afabl'e
malagnoskas	mal'agnosk'as
malagnoski	mal'agnosk'i
malagnoskis	mal'agnosk'is
malagrabla	mal'agrabl'a
malagrablaj	mal'agrabl'a'j
malagrablajn	mal'agrabl'a'j'n
malagrablan	mal'agrabl'a'n
malagrable	mal'agrabl'e
malagrablaĵo	mal'agrabl'aĵ'o
malagrablaĵoj	mal'agrabl'aĵ'o'j
malagrablaĵojn	mal'agrabl'aĵ'o'j'n
malagrablaĵon	mal'agrabl'aĵ'o'n
malakcelas	mal'akcel'as
malakceli	mal'akcel'i
malakceliĝo	mal'akcel'iĝ'o
malakceliĝon	mal'akcel'iĝ'o'n
malakceptas	mal'akcept'as
malakcepti	mal'akcept'i
malakceptis	mal'akcept'is
malakcepto	mal'akcept'o
malakceptoj	mal'akcept'o'j
malakcepton	mal'akcept'o'n
malakceptos	mal'akcept'os
malakceptu	mal'akcept'u
malakceptus	mal'akcept'us
malakceptante	mal'akcept'ant'e
malakceptata	mal'akcept'at'a
malakceptebla	mal'akcept'ebl'a
malakceptita	mal'akcept'it'a
malakceptitaj	mal'akcept'it'a'j
malakorda	mal'akord'a
malakordas	mal'akord'as
malakordo	mal'akord'o
malakordoj	mal'akord'o'j
malakordojn	mal'akord'o'j'n
malakordon	mal'akord'o'n
malakra	mal'akr'a
malakraj	mal'akr'a'j
malakran	mal'akr'a'n
malakre	mal'akr'e
malakreco	mal'akr'ec'o
malakrigas	mal'akr'ig'as
malakrigi	mal'akr'ig'i
malakriĝis	mal'akr'iĝ'is
malaktiva	mal'aktiv'a
malaktive	mal'aktiv'e
malaktivigas	mal'aktiv'ig'as
malaktivigi	mal'aktiv'ig'i
malaktivigo	mal'aktiv'ig'o
malaktivigita	mal'aktiv'ig'it'a
malaktuala	mal'aktual'a
malaliĝis	mal'al'iĝ'is
malalta	mal'alt'a
malaltaj	mal'alt'a'j
malaltajn	mal'alt'a'j'n
malaltan	mal'alt'a'n
malaltas	mal'alt'as
malalte	mal'alt'e
malalten	mal'alt'e'n
malalto	mal'alt'o
malaltaĵajn	mal'alt'aĵ'a'j'n
malaltaĵo	mal'alt'aĵ'o
malaltaĵoj	mal'alt'aĵ'o'j
malaltdenseca	mal'alt'dens'ec'a
malaltebenaĵaj	mal'alt'eben'aĵ'a'j
malaltebenaĵo	mal'alt'eben'aĵ'o
malaltebenaĵoj	mal'alt'eben'aĵ'o'j
malaltebenaĵon	mal'alt'eben'aĵ'o'n
malaltenergio	mal'alt'energi'o
malaltfrekvenco	mal'alt'frekvenc'o
malaltfrekvencoj	mal'alt'frekvenc'o'j
malaltigas	mal'alt'ig'as
malaltigi	mal'alt'ig'i
malaltigis	mal'alt'ig'is
malaltigo	mal'alt'ig'o
malaltigon	mal'alt'ig'o'n
malaltigos	mal'alt'ig'os
malaltigu	mal'alt'ig'u
malaltigado	mal'alt'ig'ad'o
malaltigante	mal'alt'ig'ant'e
malaltigita	mal'alt'ig'it'a
malaltigitaj	mal'alt'ig'it'a'j
malaltiĝas	mal'alt'iĝ'as
malaltiĝi	mal'alt'iĝ'i
malaltiĝis	mal'alt'iĝ'is
malaltiĝo	mal'alt'iĝ'o
malaltiĝon	mal'alt'iĝ'o'n
malaltiĝos	mal'alt'iĝ'os
malaltkarbona	mal'alt'karbon'a
malaltkosta	mal'alt'kost'a
malaltkostaj	mal'alt'kost'a'j
malaltkostajn	mal'alt'kost'a'j'n
malaltkostan	mal'alt'kost'a'n
malaltkreska	mal'alt'kresk'a
malaltkvalita	mal'alt'kvalit'a
malaltkvalitaj	mal'alt'kvalit'a'j
malaltmotoraj	mal'alt'motor'a'j
malaltnivela	mal'alt'nivel'a
malaltnivelaj	mal'alt'nivel'a'j
malaltprema	mal'alt'prem'a
malaltpremaj	mal'alt'prem'a'j
malaltranga	mal'alt'rang'a
malaltrangaj	mal'alt'rang'a'j
malaltrapideca	mal'alt'rapid'ec'a
malaltrapidecan	mal'alt'rapid'ec'a'n
malaltsalajraj	mal'alt'salajr'a'j
malaltstatura	mal'alt'statur'a
malalttensia	mal'alt'tensi'a
malalttensiaj	mal'alt'tensi'a'j
malama	mal'am'a
malamas	mal'am'as
malame	mal'am'e
malami	mal'am'i
malamis	mal'am'is
malamo	mal'am'o
malamoj	mal'am'o'j
malamojn	mal'am'o'j'n
malamon	mal'am'o'n
malamos	mal'am'os
malamu	mal'am'u
malamus	mal'am'us
malamante	mal'am'ant'e
malamanto	mal'am'ant'o
malamata	mal'am'at'a
malamataj	mal'am'at'a'j
malamatan	mal'am'at'a'n
malamegas	mal'am'eg'as
malamegis	mal'am'eg'is
malamego	mal'am'eg'o
malaminda	mal'am'ind'a
malambigua	mal'ambigu'a
malambiguaj	mal'ambigu'a'j
malambiguan	mal'ambigu'a'n
malambigue	mal'ambigu'e
malambiguigi	mal'ambigu'ig'i
malambiguigo	mal'ambigu'ig'o
malamika	mal'amik'a
malamikaj	mal'amik'a'j
malamikajn	mal'amik'a'j'n
malamikan	mal'amik'a'n
malamikas	mal'amik'as
malamike	mal'amik'e
malamiko	mal'amik'o
malamikoj	mal'amik'o'j
malamikojn	mal'amik'o'j'n
malamikon	mal'amik'o'n
malamikaro	mal'amik'ar'o
malamikaron	mal'amik'ar'o'n
malamikeco	mal'amik'ec'o
malamikecoj	mal'amik'ec'o'j
malamikecojn	mal'amik'ec'o'j'n
malamikecon	mal'amik'ec'o'n
malamikiĝis	mal'amik'iĝ'is
malamikino	mal'amik'in'o
malampleksa	mal'ampleks'a
malantaua	mal'antaŭ'a
malantaŭa	mal'antaŭ'a
malantaŭaj	mal'antaŭ'a'j
malantaŭajn	mal'antaŭ'a'j'n
malantaŭan	mal'antaŭ'a'n
malantaue	mal'antaŭ'e
malantaŭe	mal'antaŭ'e
malantauen	mal'antaŭ'e'n
malantaŭen	mal'antaŭ'e'n
malantaŭo	mal'antaŭ'o
malantaŭon	mal'antaŭ'o'n
malantaŭu	mal'antaŭ'u
malantaŭeniras	mal'antaŭ'e'n'ir'as
malantaŭeniri	mal'antaŭ'e'n'ir'i
malantaŭeniris	mal'antaŭ'e'n'ir'is
malantaŭenirita	mal'antaŭ'e'n'ir'it'a
malantaŭeniritaj	mal'antaŭ'e'n'ir'it'a'j
malaperas	mal'aper'as
malaperi	mal'aper'i
malaperis	mal'aper'is
malapero	mal'aper'o
malaperoj	mal'aper'o'j
malaperon	mal'aper'o'n
malaperos	mal'aper'os
malaperu	mal'aper'u
malaperus	mal'aper'us
malaperadis	mal'aper'ad'is
malaperado	mal'aper'ad'o
malaperanta	mal'aper'ant'a
malaperantaj	mal'aper'ant'a'j
malaperante	mal'aper'ant'e
malaperigas	mal'aper'ig'as
malaperigi	mal'aper'ig'i
malaperigis	mal'aper'ig'is
malaperigo	mal'aper'ig'o
malaperinta	mal'aper'int'a
malaperintaj	mal'aper'int'a'j
malaperintajn	mal'aper'int'a'j'n
malaperintan	mal'aper'int'a'n
malaperintoj	mal'aper'int'o'j
malaperita	mal'aper'it'a
malaperonta	mal'aper'ont'a
malapogi	mal'apog'i
malaprobas	mal'aprob'as
malaprobe	mal'aprob'e
malaprobi	mal'aprob'i
malaprobis	mal'aprob'is
malaprobo	mal'aprob'o
malaproboj	mal'aprob'o'j
malaprobon	mal'aprob'o'n
malaprobus	mal'aprob'us
malaprobado	mal'aprob'ad'o
malaprobante	mal'aprob'ant'e
malaprobinda	mal'aprob'ind'a
malaprobita	mal'aprob'it'a
malaprobitaj	mal'aprob'it'a'j
malarmado	mal'arm'ad'o
malarmadon	mal'arm'ad'o'n
malatenta	mal'atent'a
malatentas	mal'atent'as
malatenti	mal'atent'i
malatentis	mal'atent'is
malatento	mal'atent'o
malatentigas	mal'atent'ig'as
malatentigi	mal'atent'ig'i
malatentigita	mal'atent'ig'it'a
malatentigitaj	mal'atent'ig'it'a'j
malatentoeraro	mal'atent'o'erar'o
malatentoeraron	mal'atent'o'erar'o'n
malatesta	mal'atest'a
malavantaĝa	mal'avantaĝ'a
malavantaĝaj	mal'avantaĝ'a'j
malavantaĝe	mal'avantaĝ'e
malavantaĝo	mal'avantaĝ'o
malavantaĝoj	mal'avantaĝ'o'j
malavantaĝojn	mal'avantaĝ'o'j'n
malavantaĝon	mal'avantaĝ'o'n
malavara	mal'avar'a
malavaraj	mal'avar'a'j
malavarajn	mal'avar'a'j'n
malavaran	mal'avar'a'n
malavaras	mal'avar'as
malavare	mal'avar'e
malavaro	mal'avar'o
malavareco	mal'avar'ec'o
malavarecon	mal'avar'ec'o'n
malbaras	mal'bar'as
malbari	mal'bar'i
malbaris	mal'bar'is
malbarado	mal'bar'ad'o
malbarita	mal'bar'it'a
malbaritaj	mal'bar'it'a'j
malbela	mal'bel'a
malbelaj	mal'bel'a'j
malbelajn	mal'bel'a'j'n
malbelan	mal'bel'a'n
malbelas	mal'bel'as
malbele	mal'bel'e
malbelo	mal'bel'o
malbeleco	mal'bel'ec'o
malbelecon	mal'bel'ec'o'n
malbelega	mal'bel'eg'a
malbelegaj	mal'bel'eg'a'j
malbeligas	mal'bel'ig'as
malbeligis	mal'bel'ig'is
malbelulo	mal'bel'ul'o
malbenas	mal'ben'as
malbeni	mal'ben'i
malbenis	mal'ben'is
malbeno	mal'ben'o
malbenoj	mal'ben'o'j
malbenojn	mal'ben'o'j'n
malbenon	mal'ben'o'n
malbenos	mal'ben'os
malbenu	mal'ben'u
malbenante	mal'ben'ant'e
malbeninda	mal'ben'ind'a
malbenita	mal'ben'it'a
malbenitaj	mal'ben'it'a'j
malbenitan	mal'ben'it'a'n
malbloki	mal'blok'i
malbona	mal'bon'a
malbonaj	mal'bon'a'j
malbonajn	mal'bon'a'j'n
malbonan	mal'bon'a'n
malbonas	mal'bon'as
malbone	mal'bon'e
malbonis	mal'bon'is
malbono	mal'bon'o
malbonoj	mal'bon'o'j
malbonojn	mal'bon'o'j'n
malbonon	mal'bon'o'n
malbonaĵo	mal'bon'aĵ'o
malbonaĵoj	mal'bon'aĵ'o'j
malbonaĵojn	mal'bon'aĵ'o'j'n
malbonaĵon	mal'bon'aĵ'o'n
malbonaŭdaj	mal'bon'aŭd'a'j
malbonaŭgura	mal'bon'aŭgur'a
malbonaŭguraj	mal'bon'aŭgur'a'j
malbonaŭguran	mal'bon'aŭgur'a'n
malboneco	mal'bon'ec'o
malbonecon	mal'bon'ec'o'n
malbonega	mal'bon'eg'a
malbonegaj	mal'bon'eg'a'j
malbonege	mal'bon'eg'e
malbonfama	mal'bon'fam'a
malbonfaroj	mal'bon'far'o'j
malbonfarantoj	mal'bon'far'ant'o'j
malbonfarta	mal'bon'fart'a
malbonfartas	mal'bon'fart'as
malbonfarto	mal'bon'fart'o
malbonfarton	mal'bon'fart'o'n
malbongusta	mal'bon'gust'a
malbonhumora	mal'bon'humor'a
malbonhumore	mal'bon'humor'e
malbonigas	mal'bon'ig'as
malbonigi	mal'bon'ig'i
malbonigis	mal'bon'ig'is
malboniĝas	mal'bon'iĝ'as
malboniĝi	mal'bon'iĝ'i
malboniĝis	mal'bon'iĝ'is
malboniĝo	mal'bon'iĝ'o
malboniĝos	mal'bon'iĝ'os
malboniĝanta	mal'bon'iĝ'ant'a
malbonintenca	mal'bon'intenc'a
malbonkaza	mal'bon'kaz'a
malbonkonduta	mal'bon'kondut'a
malbonkora	mal'bon'kor'a
malbonkvalita	mal'bon'kvalit'a
malbonkvalitaj	mal'bon'kvalit'a'j
malbonkvalitan	mal'bon'kvalit'a'n
malbonodora	mal'bon'odor'a
malbonodoraj	mal'bon'odor'a'j
malbonodoran	mal'bon'odor'a'n
malbonodoras	mal'bon'odor'as
malbonodoris	mal'bon'odor'is
malbonodoro	mal'bon'odor'o
malbonsorta	mal'bon'sort'a
malbonŝanca	mal'bon'ŝanc'a
malbonŝancaj	mal'bon'ŝanc'a'j
malbonŝance	mal'bon'ŝanc'e
malbonŝanco	mal'bon'ŝanc'o
malbonŝancoj	mal'bon'ŝanc'o'j
malbonŝancon	mal'bon'ŝanc'o'n
malbonŝanculo	mal'bon'ŝanc'ul'o
malbonulo	mal'bon'ul'o
malbonuloj	mal'bon'ul'o'j
malbonulojn	mal'bon'ul'o'j'n
malbonulon	mal'bon'ul'o'n
malbonvaro	mal'bon'var'o
malbonvaron	mal'bon'var'o'n
malbonvola	mal'bon'vol'a
malbonvolaj	mal'bon'vol'a'j
malbrila	mal'bril'a
malbrilaj	mal'bril'a'j
malbrile	mal'bril'e
malbutonumis	mal'buton'um'is
malbutonumita	mal'buton'um'it'a
malcedema	mal'ced'em'a
malcentra	mal'centr'a
malcentraj	mal'centr'a'j
malcentrigo	mal'centr'ig'o
malcentrigita	mal'centr'ig'it'a
malcentralizi	mal'centraliz'i
malcentralizo	mal'centraliz'o
malcentralizado	mal'centraliz'ad'o
malcentralizita	mal'centraliz'it'a
malcentralizitaj	mal'centraliz'it'a'j
malcerta	mal'cert'a
malcertaj	mal'cert'a'j
malcertas	mal'cert'as
malcerte	mal'cert'e
malcerteco	mal'cert'ec'o
malcertecon	mal'cert'ec'o'n
malĉasta	mal'ĉast'a
malĉasteco	mal'ĉast'ec'o
malĉeestas	mal'ĉe'est'as
malĉeestis	mal'ĉe'est'is
malĉeesto	mal'ĉe'est'o
malĉefa	mal'ĉef'a
malĉefaj	mal'ĉef'a'j
malĉefan	mal'ĉef'a'n
malĉifri	mal'ĉifr'i
malĉifrilo	mal'ĉifr'il'o
malĉifriloj	mal'ĉifr'il'o'j
maldankemo	mal'dank'em'o
maldaŭrigas	mal'daŭr'ig'as
maldaŭrigi	mal'daŭr'ig'i
maldaŭrigis	mal'daŭr'ig'is
maldaŭrigado	mal'daŭr'ig'ad'o
maldaŭrigante	mal'daŭr'ig'ant'e
maldaŭrigita	mal'daŭr'ig'it'a
maldaŭrigitaj	mal'daŭr'ig'it'a'j
maldeca	mal'dec'a
maldecaj	mal'dec'a'j
maldecajn	mal'dec'a'j'n
maldecan	mal'dec'a'n
maldecas	mal'dec'as
maldece	mal'dec'e
maldeco	mal'dec'o
maldekstra	mal'dekstr'a
maldekstraj	mal'dekstr'a'j
maldekstrajn	mal'dekstr'a'j'n
maldekstran	mal'dekstr'a'n
maldekstre	mal'dekstr'e
maldekstren	mal'dekstr'e'n
maldekstro	mal'dekstr'o
maldekstron	mal'dekstr'o'n
maldekstraflanka	mal'dekstr'a'flank'a
maldekstraflanke	mal'dekstr'a'flank'e
maldekstramana	mal'dekstr'a'man'a
maldekstramanaj	mal'dekstr'a'man'a'j
maldekstramanan	mal'dekstr'a'man'a'n
maldekstrema	mal'dekstr'em'a
maldekstremaj	mal'dekstr'em'a'j
maldekstremajn	mal'dekstr'em'a'j'n
maldekstrisma	mal'dekstr'ism'a
maldekstrismo	mal'dekstr'ism'o
maldekstroplej	mal'dekstr'o'plej
maldekstrula	mal'dekstr'ul'a
maldekstrulo	mal'dekstr'ul'o
maldekstruloj	mal'dekstr'ul'o'j
maldekstrularo	mal'dekstr'ul'ar'o
maldekstrume	mal'dekstr'um'e
maldelikata	mal'delikat'a
maldelikataj	mal'delikat'a'j
maldelikatan	mal'delikat'a'n
maldelikate	mal'delikat'e
maldemokratia	mal'demokrati'a
maldensa	mal'dens'a
maldensaj	mal'dens'a'j
maldensajn	mal'dens'a'j'n
maldensan	mal'dens'a'n
maldense	mal'dens'e
maldensarbaro	mal'dens'arb'ar'o
maldensarbaroj	mal'dens'arb'ar'o'j
maldenseco	mal'dens'ec'o
maldensejo	mal'dens'ej'o
maldensigas	mal'dens'ig'as
maldensigi	mal'dens'ig'i
maldensigo	mal'dens'ig'o
maldiafana	mal'diafan'a
maldiafanaj	mal'diafan'a'j
maldigna	mal'dign'a
maldika	mal'dik'a
maldikaj	mal'dik'a'j
maldikajn	mal'dik'a'j'n
maldikan	mal'dik'a'n
maldikas	mal'dik'as
maldike	mal'dik'e
maldikega	mal'dik'eg'a
maldiketa	mal'dik'et'a
maldikiga	mal'dik'ig'a
maldikigita	mal'dik'ig'it'a
maldikiĝas	mal'dik'iĝ'as
maldikiĝi	mal'dik'iĝ'i
maldikiĝis	mal'dik'iĝ'is
maldikiĝo	mal'dik'iĝ'o
maldikiĝinta	mal'dik'iĝ'int'a
maldiligenta	mal'diligent'a
maldiligentaj	mal'diligent'a'j
maldiligentas	mal'diligent'as
maldiligente	mal'diligent'e
maldiligento	mal'diligent'o
maldiligenteco	mal'diligent'ec'o
maldiligentulo	mal'diligent'ul'o
maldiskreta	mal'diskret'a
maldolĉa	mal'dolĉ'a
maldolĉaj	mal'dolĉ'a'j
maldolĉan	mal'dolĉ'a'n
maldolĉe	mal'dolĉ'e
maldorma	mal'dorm'a
maldormaj	mal'dorm'a'j
maldormas	mal'dorm'as
maldormi	mal'dorm'i
maldormis	mal'dorm'is
maldormo	mal'dorm'o
maldormon	mal'dorm'o'n
maldormigo	mal'dorm'ig'o
maldungas	mal'dung'as
maldungi	mal'dung'i
maldungis	mal'dung'is
maldungo	mal'dung'o
maldungoj	mal'dung'o'j
maldungojn	mal'dung'o'j'n
maldungon	mal'dung'o'n
maldungos	mal'dung'os
maldungu	mal'dung'u
maldungado	mal'dung'ad'o
maldungiĝis	mal'dung'iĝ'is
maldungita	mal'dung'it'a
maldungitaj	mal'dung'it'a'j
malebena	mal'eben'a
malebenaj	mal'eben'a'j
malebla	mal'ebl'a
maleblaj	mal'ebl'a'j
maleblan	mal'ebl'a'n
maleblas	mal'ebl'as
maleble	mal'ebl'e
maleblo	mal'ebl'o
malebleco	mal'ebl'ec'o
maleblecon	mal'ebl'ec'o'n
malebligas	mal'ebl'ig'as
malebligi	mal'ebl'ig'i
malebligis	mal'ebl'ig'is
malebligo	mal'ebl'ig'o
malebligos	mal'ebl'ig'os
malebligu	mal'ebl'ig'u
malebligus	mal'ebl'ig'us
malebligante	mal'ebl'ig'ant'e
malebria	mal'ebri'a
malefika	mal'efik'a
malefikaj	mal'efik'a'j
malefike	mal'efik'e
malegala	mal'egal'a
malegalaj	mal'egal'a'j
malegale	mal'egal'e
malegaleco	mal'egal'ec'o
malegalecoj	mal'egal'ec'o'j
malegalecojn	mal'egal'ec'o'j'n
malegalecon	mal'egal'ec'o'n
malekonomia	mal'ekonomi'a
malekvilibra	mal'ekvilibr'a
malekvilibraj	mal'ekvilibr'a'j
malekvilibro	mal'ekvilibr'o
malekvilibroj	mal'ekvilibr'o'j
malekvilibron	mal'ekvilibr'o'n
malekzisto	mal'ekzist'o
malelasta	mal'elast'a
maleleganta	mal'elegant'a
malema	mal'em'a
malemas	mal'em'as
maleme	mal'em'e
malemo	mal'em'o
malemon	mal'em'o'n
malemigi	mal'em'ig'i
malenua	mal'enu'a
malenuaj	mal'enu'a'j
malespera	mal'esper'a
malesperaj	mal'esper'a'j
malesperan	mal'esper'a'n
malesperas	mal'esper'as
malespere	mal'esper'e
malesperi	mal'esper'i
malesperis	mal'esper'is
malespero	mal'esper'o
malesperon	mal'esper'o'n
malesperu	mal'esper'u
malesperiga	mal'esper'ig'a
malesperigis	mal'esper'ig'is
malestas	mal'est'as
malestis	mal'est'is
malesto	mal'est'o
maleston	mal'est'o'n
malestado	mal'est'ad'o
malestima	mal'estim'a
malestimaj	mal'estim'a'j
malestiman	mal'estim'a'n
malestimas	mal'estim'as
malestime	mal'estim'e
malestimi	mal'estim'i
malestimis	mal'estim'is
malestimo	mal'estim'o
malestimon	mal'estim'o'n
malestimu	mal'estim'u
malestimata	mal'estim'at'a
malestimataj	mal'estim'at'a'j
malestiminda	mal'estim'ind'a
malestimita	mal'estim'it'a
maletika	mal'etik'a
maletikaj	mal'etik'a'j
malfacila	mal'facil'a
malfacilaj	mal'facil'a'j
malfacilajn	mal'facil'a'j'n
malfacilan	mal'facil'a'n
malfacilas	mal'facil'as
malfacile	mal'facil'e
malfacili	mal'facil'i
malfacilis	mal'facil'is
malfacilo	mal'facil'o
malfaciloj	mal'facil'o'j
malfacilojn	mal'facil'o'j'n
malfacilon	mal'facil'o'n
malfacilos	mal'facil'os
malfacilus	mal'facil'us
malfacilaĵo	mal'facil'aĵ'o
malfacilaĵoj	mal'facil'aĵ'o'j
malfacilaĵojn	mal'facil'aĵ'o'j'n
malfacilaĵon	mal'facil'aĵ'o'n
malfacileco	mal'facil'ec'o
malfacilecoj	mal'facil'ec'o'j
malfacilecon	mal'facil'ec'o'n
malfacilega	mal'facil'eg'a
malfacilegas	mal'facil'eg'as
malfacilege	mal'facil'eg'e
malfaciligas	mal'facil'ig'as
malfaciligi	mal'facil'ig'i
malfaciligis	mal'facil'ig'is
malfaciligos	mal'facil'ig'os
malfaciligus	mal'facil'ig'us
malfaciligante	mal'facil'ig'ant'e
malfaciligita	mal'facil'ig'it'a
malfaciligitaj	mal'facil'ig'it'a'j
malfaciliĝas	mal'facil'iĝ'as
malfaciliĝis	mal'facil'iĝ'is
malfajna	mal'fajn'a
malfaldis	mal'fald'is
malfalsa	mal'fals'a
malfaras	mal'far'as
malfari	mal'far'i
malfavora	mal'favor'a
malfavoraj	mal'favor'a'j
malfavorajn	mal'favor'a'j'n
malfavoran	mal'favor'a'n
malfavoras	mal'favor'as
malfavore	mal'favor'e
malfavoris	mal'favor'is
malfavoro	mal'favor'o
malfavoron	mal'favor'o'n
malfavorata	mal'favor'at'a
malfavorataj	mal'favor'at'a'j
malfavoratajn	mal'favor'at'a'j'n
malfekunda	mal'fekund'a
malfekundaj	mal'fekund'a'j
malfekundeco	mal'fekund'ec'o
malfekundecon	mal'fekund'ec'o'n
malfelicha	mal'feliĉ'a
malfeliĉa	mal'feliĉ'a
malfeliĉaj	mal'feliĉ'a'j
malfeliĉajn	mal'feliĉ'a'j'n
malfeliĉan	mal'feliĉ'a'n
malfeliĉas	mal'feliĉ'as
malfeliche	mal'feliĉ'e
malfeliĉe	mal'feliĉ'e
malfelicho	mal'feliĉ'o
malfeliĉo	mal'feliĉ'o
malfeliĉoj	mal'feliĉ'o'j
malfeliĉojn	mal'feliĉ'o'j'n
malfeliĉon	mal'feliĉ'o'n
malfeliĉaĵoj	mal'feliĉ'aĵ'o'j
malfeliĉigas	mal'feliĉ'ig'as
malfeliĉigis	mal'feliĉ'ig'is
malfeliĉulo	mal'feliĉ'ul'o
malfeliĉuloj	mal'feliĉ'ul'o'j
malfeliĉulon	mal'feliĉ'ul'o'n
malferma	mal'ferm'a
malfermaj	mal'ferm'a'j
malfermajn	mal'ferm'a'j'n
malferman	mal'ferm'a'n
malfermas	mal'ferm'as
malferme	mal'ferm'e
malfermi	mal'ferm'i
malfermis	mal'ferm'is
malfermo	mal'ferm'o
malfermoj	mal'ferm'o'j
malfermon	mal'ferm'o'n
malfermos	mal'ferm'os
malfermu	mal'ferm'u
malfermus	mal'ferm'us
malfermado	mal'ferm'ad'o
malfermadon	mal'ferm'ad'o'n
malfermaĵo	mal'ferm'aĵ'o
malfermaĵoj	mal'ferm'aĵ'o'j
malfermaĵojn	mal'ferm'aĵ'o'j'n
malfermaĵon	mal'ferm'aĵ'o'n
malfermaĵsekvenco	mal'ferm'aĵ'sekvenc'o
malfermanta	mal'ferm'ant'a
malfermantaj	mal'ferm'ant'a'j
malfermante	mal'ferm'ant'e
malfermata	mal'ferm'at'a
malfermataj	mal'ferm'at'a'j
malfermcirkvita	mal'ferm'cirkvit'a
malfermebla	mal'ferm'ebl'a
malfermeco	mal'ferm'ec'o
malfermfonta	mal'ferm'font'a
malfermfontaj	mal'ferm'font'a'j
malfermfonteca	mal'ferm'font'ec'a
malfermfonteco	mal'ferm'font'ec'o
malfermfontecsoftvaro	mal'ferm'font'ec'softvar'o
malfermiĝas	mal'ferm'iĝ'as
malfermiĝi	mal'ferm'iĝ'i
malfermiĝis	mal'ferm'iĝ'is
malfermiĝo	mal'ferm'iĝ'o
malfermiĝon	mal'ferm'iĝ'o'n
malfermiĝos	mal'ferm'iĝ'os
malfermiĝu	mal'ferm'iĝ'u
malfermiĝado	mal'ferm'iĝ'ad'o
malfermiĝanta	mal'ferm'iĝ'ant'a
malfermiĝantaj	mal'ferm'iĝ'ant'a'j
malfermiĝante	mal'ferm'iĝ'ant'e
malferminta	mal'ferm'int'a
malferminte	mal'ferm'int'e
malfermita	mal'ferm'it'a
malfermitaj	mal'ferm'it'a'j
malfermitajn	mal'ferm'it'a'j'n
malfermitan	mal'ferm'it'a'n
malfermitas	mal'ferm'it'as
malfermite	mal'ferm'it'e
malfermiteco	mal'ferm'it'ec'o
malfermitecon	mal'ferm'it'ec'o'n
malfermitkoda	mal'ferm'it'kod'a
malfermiis	mal'fermi'is
malfidas	mal'fid'as
malfidi	mal'fid'i
malfidis	mal'fid'is
malfido	mal'fid'o
malfidoj	mal'fid'o'j
malfidojn	mal'fid'o'j'n
malfidon	mal'fid'o'n
malfidela	mal'fidel'a
malfidelaj	mal'fidel'a'j
malfidelan	mal'fidel'a'n
malfideleco	mal'fidel'ec'o
malfidelecon	mal'fidel'ec'o'n
malfiksi	mal'fiks'i
malfiksis	mal'fiks'is
malfiksiĝas	mal'fiks'iĝ'as
malfinia	mal'fini'a
malfiniaj	mal'fini'a'j
malfinie	mal'fini'e
malfinio	mal'fini'o
malfirma	mal'firm'a
malfirmaj	mal'firm'a'j
malfirman	mal'firm'a'n
malfirme	mal'firm'e
malfluso	mal'flus'o
malfono	mal'fon'o
malfonon	mal'fon'o'n
malfondi	mal'fond'i
malfondo	mal'fond'o
malfondon	mal'fond'o'n
malfondita	mal'fond'it'a
malformiĝo	mal'form'iĝ'o
malformaleco	mal'formal'ec'o
malforta	mal'fort'a
malfortaj	mal'fort'a'j
malfortajn	mal'fort'a'j'n
malfortan	mal'fort'a'n
malfortas	mal'fort'as
malforte	mal'fort'e
malforto	mal'fort'o
malfortoj	mal'fort'o'j
malfortojn	mal'fort'o'j'n
malforton	mal'fort'o'n
malfortaĵoj	mal'fort'aĵ'o'j
malfortaĵojn	mal'fort'aĵ'o'j'n
malforteco	mal'fort'ec'o
malfortecon	mal'fort'ec'o'n
malfortigas	mal'fort'ig'as
malfortigi	mal'fort'ig'i
malfortigis	mal'fort'ig'is
malfortigo	mal'fort'ig'o
malfortigon	mal'fort'ig'o'n
malfortigos	mal'fort'ig'os
malfortigus	mal'fort'ig'us
malfortigado	mal'fort'ig'ad'o
malfortigante	mal'fort'ig'ant'e
malfortigita	mal'fort'ig'it'a
malfortigitaj	mal'fort'ig'it'a'j
malfortigitan	mal'fort'ig'it'a'n
malfortiĝas	mal'fort'iĝ'as
malfortiĝi	mal'fort'iĝ'i
malfortiĝis	mal'fort'iĝ'is
malfortiĝo	mal'fort'iĝ'o
malfortiĝon	mal'fort'iĝ'o'n
malfortiĝos	mal'fort'iĝ'os
malfortiĝinta	mal'fort'iĝ'int'a
malfortulo	mal'fort'ul'o
malfortuloj	mal'fort'ul'o'j
malfortulojn	mal'fort'ul'o'j'n
malfortika	mal'fortik'a
malfortikaj	mal'fortik'a'j
malfortikeco	mal'fortik'ec'o
malfortikecon	mal'fortik'ec'o'n
malfreŝa	mal'freŝ'a
malfreŝaj	mal'freŝ'a'j
malfreŝan	mal'freŝ'a'n
malfrua	mal'fru'a
malfruaj	mal'fru'a'j
malfruajn	mal'fru'a'j'n
malfruan	mal'fru'a'n
malfruas	mal'fru'as
malfrue	mal'fru'e
malfrui	mal'fru'i
malfruis	mal'fru'is
malfruo	mal'fru'o
malfruoj	mal'fru'o'j
malfruon	mal'fru'o'n
malfruos	mal'fru'os
malfruu	mal'fru'u
malfrugotika	mal'fru'gotik'a
malfruigas	mal'fru'ig'as
malfruigi	mal'fru'ig'i
malfruigis	mal'fru'ig'is
malfruiĝas	mal'fru'iĝ'as
malfruiĝi	mal'fru'iĝ'i
malfruiĝis	mal'fru'iĝ'is
malfruiĝo	mal'fru'iĝ'o
malfruiĝon	mal'fru'iĝ'o'n
malfruiĝos	mal'fru'iĝ'os
malfruiĝu	mal'fru'iĝ'u
malfruiĝintoj	mal'fru'iĝ'int'o'j
malfrunokte	mal'fru'nokt'e
malfruvespere	mal'fru'vesper'e
malfunkcia	mal'funkci'a
malfunkciaj	mal'funkci'a'j
malfunkcias	mal'funkci'as
malfunkcio	mal'funkci'o
malfunkcioj	mal'funkci'o'j
malfunkcion	mal'funkci'o'n
malfunkciigas	mal'funkci'ig'as
malfunkciigi	mal'funkci'ig'i
malfunkciigis	mal'funkci'ig'is
malfunkciigo	mal'funkci'ig'o
malfunkciigado	mal'funkci'ig'ad'o
malfunkciigante	mal'funkci'ig'ant'e
malfunkciigita	mal'funkci'ig'it'a
malfunkciigitaj	mal'funkci'ig'it'a'j
malgaja	mal'gaj'a
malgajaj	mal'gaj'a'j
malgajajn	mal'gaj'a'j'n
malgajan	mal'gaj'a'n
malgajas	mal'gaj'as
malgaje	mal'gaj'e
malgajis	mal'gaj'is
malgajo	mal'gaj'o
malgajon	mal'gaj'o'n
malgajeco	mal'gaj'ec'o
malgajiga	mal'gaj'ig'a
malgajigas	mal'gaj'ig'as
malgajigis	mal'gaj'ig'is
malgajnas	mal'gajn'as
malgajni	mal'gajn'i
malgajnis	mal'gajn'is
malgajno	mal'gajn'o
malgajnon	mal'gajn'o'n
malgajnos	mal'gajn'os
malgajninto	mal'gajn'int'o
malgajnintoj	mal'gajn'int'o'j
malgeja	mal'gej'a
malglata	mal'glat'a
malglataj	mal'glat'a'j
malglatajn	mal'glat'a'j'n
malglatan	mal'glat'a'n
malglate	mal'glat'e
malglataĵoj	mal'glat'aĵ'o'j
malglataĵojn	mal'glat'aĵ'o'j'n
malgloro	mal'glor'o
malgracia	mal'graci'a
malgramatika	mal'gramatik'a
malgranda	mal'grand'a
malgrandaj	mal'grand'a'j
malgrandajn	mal'grand'a'j'n
malgrandan	mal'grand'a'n
malgrandas	mal'grand'as
malgrande	mal'grand'e
malgrando	mal'grand'o
malgrandazio	mal'grand'azi'o
malgrandeco	mal'grand'ec'o
malgrandecon	mal'grand'ec'o'n
malgrandega	mal'grand'eg'a
malgrandegaj	mal'grand'eg'a'j
malgrandegajn	mal'grand'eg'a'j'n
malgrandegan	mal'grand'eg'a'n
malgrandeguloj	mal'grand'eg'ul'o'j
malgrandetaj	mal'grand'et'a'j
malgrandigas	mal'grand'ig'as
malgrandigi	mal'grand'ig'i
malgrandigis	mal'grand'ig'is
malgrandigo	mal'grand'ig'o
malgrandigu	mal'grand'ig'u
malgrandigita	mal'grand'ig'it'a
malgrandigitaj	mal'grand'ig'it'a'j
malgrandiĝas	mal'grand'iĝ'as
malgrandiĝi	mal'grand'iĝ'i
malgrandiĝis	mal'grand'iĝ'is
malgrandiĝo	mal'grand'iĝ'o
malgrandiĝos	mal'grand'iĝ'os
malgrandkomercaj	mal'grand'komerc'a'j
malgrandkonata	mal'grand'kon'at'a
malgrandkonataj	mal'grand'kon'at'a'j
malgrandkvante	mal'grand'kvant'e
malgrandskala	mal'grand'skal'a
malgrandskalaj	mal'grand'skal'a'j
malgrandskalan	mal'grand'skal'a'n
malgrandskale	mal'grand'skal'e
malgrandulo	mal'grand'ul'o
malgranduloj	mal'grand'ul'o'j
malgrasa	mal'gras'a
malgrasaj	mal'gras'a'j
malgrasan	mal'gras'a'n
malgrasigo	mal'gras'ig'o
malgrasiĝis	mal'gras'iĝ'is
malgrava	mal'grav'a
malgravaj	mal'grav'a'j
malgravajn	mal'grav'a'j'n
malgravan	mal'grav'a'n
malgravas	mal'grav'as
malgrave	mal'grav'e
malgravaĵoj	mal'grav'aĵ'o'j
malgravigas	mal'grav'ig'as
malgravigi	mal'grav'ig'i
malgravigis	mal'grav'ig'is
malgravigante	mal'grav'ig'ant'e
malgravigita	mal'grav'ig'it'a
malĝentila	mal'ĝentil'a
malĝentilaj	mal'ĝentil'a'j
malĝentilajn	mal'ĝentil'a'j'n
malĝentilan	mal'ĝentil'a'n
malĝentilas	mal'ĝentil'as
malĝentile	mal'ĝentil'e
malĝentileco	mal'ĝentil'ec'o
malĝentilecon	mal'ĝentil'ec'o'n
malĝoja	mal'ĝoj'a
malĝojaj	mal'ĝoj'a'j
malĝojajn	mal'ĝoj'a'j'n
malĝojan	mal'ĝoj'a'n
malĝojas	mal'ĝoj'as
malĝoje	mal'ĝoj'e
malĝoji	mal'ĝoj'i
malĝojis	mal'ĝoj'is
malĝojo	mal'ĝoj'o
malĝojoj	mal'ĝoj'o'j
malĝojojn	mal'ĝoj'o'j'n
malĝojon	mal'ĝoj'o'n
malĝoju	mal'ĝoj'u
malĝojiga	mal'ĝoj'ig'a
malĝojigan	mal'ĝoj'ig'a'n
malĝojigas	mal'ĝoj'ig'as
malĝojigis	mal'ĝoj'ig'is
malĝojigita	mal'ĝoj'ig'it'a
malĝusta	mal'ĝust'a
malĝustaj	mal'ĝust'a'j
malĝustajn	mal'ĝust'a'j'n
malĝustan	mal'ĝust'a'n
malĝustas	mal'ĝust'as
malĝuste	mal'ĝust'e
malĝustabaze	mal'ĝust'a'baz'e
malĝustaĵojn	mal'ĝust'aĵ'o'j'n
malĝusteco	mal'ĝust'ec'o
malharmonia	mal'harmoni'a
malharmoniaj	mal'harmoni'a'j
malharmonio	mal'harmoni'o
malharmoniiga	mal'harmoni'ig'a
malhaste	mal'hast'e
malhaŭso	mal'haŭs'o
malhavas	mal'hav'as
malhavi	mal'hav'i
malhavis	mal'hav'is
malhavo	mal'hav'o
malhavos	mal'hav'os
malhavado	mal'hav'ad'o
malhavanta	mal'hav'ant'a
malhavantaj	mal'hav'ant'a'j
malhavante	mal'hav'ant'e
malhavebla	mal'hav'ebl'a
malhaveblaj	mal'hav'ebl'a'j
malhela	mal'hel'a
malhelaj	mal'hel'a'j
malhelajn	mal'hel'a'j'n
malhelan	mal'hel'a'n
malhelas	mal'hel'as
malhele	mal'hel'e
malhelis	mal'hel'is
malhelo	mal'hel'o
malhelon	mal'hel'o'n
malhelblua	mal'hel'blu'a
malhelbluaj	mal'hel'blu'a'j
malhelbluajn	mal'hel'blu'a'j'n
malhelbluan	mal'hel'blu'a'n
malhelbruna	mal'hel'brun'a
malhelbrunaj	mal'hel'brun'a'j
malhelbrunajn	mal'hel'brun'a'j'n
malhelbrunan	mal'hel'brun'a'n
malheleco	mal'hel'ec'o
malhelflava	mal'hel'flav'a
malhelgriza	mal'hel'griz'a
malhelgrizaj	mal'hel'griz'a'j
malhelgrizajn	mal'hel'griz'a'j'n
malhelgrizan	mal'hel'griz'a'n
malhelhaŭta	mal'hel'haŭt'a
malheligas	mal'hel'ig'as
malheligi	mal'hel'ig'i
malheligis	mal'hel'ig'is
malheligita	mal'hel'ig'it'a
malheliĝas	mal'hel'iĝ'as
malheliĝis	mal'hel'iĝ'is
malheliĝo	mal'hel'iĝ'o
malhelruĝa	mal'hel'ruĝ'a
malhelruĝaj	mal'hel'ruĝ'a'j
malhelverda	mal'hel'verd'a
malhelverdaj	mal'hel'verd'a'j
malhelviola	mal'hel'viol'a
malhelpa	mal'help'a
malhelpas	mal'help'as
malhelpi	mal'help'i
malhelpis	mal'help'is
malhelpo	mal'help'o
malhelpoj	mal'help'o'j
malhelpojn	mal'help'o'j'n
malhelpon	mal'help'o'n
malhelpos	mal'help'os
malhelpu	mal'help'u
malhelpus	mal'help'us
malhelpado	mal'help'ad'o
malhelpaĵo	mal'help'aĵ'o
malhelpaĵoj	mal'help'aĵ'o'j
malhelpanta	mal'help'ant'a
malhelpantaj	mal'help'ant'a'j
malhelpantan	mal'help'ant'a'n
malhelpante	mal'help'ant'e
malhelpata	mal'help'at'a
malhelpataj	mal'help'at'a'j
malhelpema	mal'help'em'a
malhelpinta	mal'help'int'a
malhelpita	mal'help'it'a
malhelpitaj	mal'help'it'a'j
malhoma	mal'hom'a
malhonesta	mal'honest'a
malhonestaj	mal'honest'a'j
malhonestan	mal'honest'a'n
malhoneste	mal'honest'e
malhonesto	mal'honest'o
malhonesteco	mal'honest'ec'o
malhonestecon	mal'honest'ec'o'n
malhonestulo	mal'honest'ul'o
malhonora	mal'honor'a
malhonoras	mal'honor'as
malhonore	mal'honor'e
malhonoro	mal'honor'o
malhonoron	mal'honor'o'n
malhonorigas	mal'honor'ig'as
malhonorita	mal'honor'it'a
malhumana	mal'human'a
malhumanaj	mal'human'a'j
malhumaneco	mal'human'ec'o
malhumila	mal'humil'a
malhumileco	mal'humil'ec'o
malimplice	mal'implic'e
malimpliki	mal'implik'i
malina	mal'in'a
malinaj	mal'in'a'j
malino	mal'in'o
malinoj	mal'in'o'j
malinda	mal'ind'a
malindaj	mal'ind'a'j
malindan	mal'ind'a'n
malinde	mal'ind'e
malindeco	mal'ind'ec'o
malinfektilo	mal'infekt'il'o
malinformado	mal'inform'ad'o
malinklino	mal'inklin'o
malinsisti	mal'insist'i
malinsistis	mal'insist'is
malinstigas	mal'instig'as
malinstigi	mal'instig'i
malinstigis	mal'instig'is
malinstigado	mal'instig'ad'o
malinstigante	mal'instig'ant'e
malinstigita	mal'instig'it'a
malinstigitaj	mal'instig'it'a'j
malintegriĝo	mal'integr'iĝ'o
malinteligenta	mal'inteligent'a
malintensigi	mal'intens'ig'i
malintensigita	mal'intens'ig'it'a
malintensigitaj	mal'intens'ig'it'a'j
malintensiĝas	mal'intens'iĝ'as
malintensiĝis	mal'intens'iĝ'is
malinteresa	mal'interes'a
malinteresaj	mal'interes'a'j
malintereso	mal'interes'o
maljuna	mal'jun'a
maljunaj	mal'jun'a'j
maljunajn	mal'jun'a'j'n
maljunan	mal'jun'a'n
maljunas	mal'jun'as
maljune	mal'jun'e
maljunaĝo	mal'jun'aĝ'o
maljunaĝon	mal'jun'aĝ'o'n
maljuneco	mal'jun'ec'o
maljunecon	mal'jun'ec'o'n
maljunega	mal'jun'eg'a
maljunegaj	mal'jun'eg'a'j
maljunegajn	mal'jun'eg'a'j'n
maljunegan	mal'jun'eg'a'n
maljuniga	mal'jun'ig'a
maljunigan	mal'jun'ig'a'n
maljuniĝas	mal'jun'iĝ'as
maljuniĝi	mal'jun'iĝ'i
maljuniĝis	mal'jun'iĝ'is
maljuniĝo	mal'jun'iĝ'o
maljuniĝon	mal'jun'iĝ'o'n
maljuniĝos	mal'jun'iĝ'os
maljuniĝado	mal'jun'iĝ'ad'o
maljuniĝanta	mal'jun'iĝ'ant'a
maljuniĝante	mal'jun'iĝ'ant'e
maljuniĝinta	mal'jun'iĝ'int'a
maljunula	mal'jun'ul'a
maljunulo	mal'jun'ul'o
maljunuloj	mal'jun'ul'o'j
maljunulojn	mal'jun'ul'o'j'n
maljunulon	mal'jun'ul'o'n
maljunulejo	mal'jun'ul'ej'o
maljunulejoj	mal'jun'ul'ej'o'j
maljunuleto	mal'jun'ul'et'o
maljunulino	mal'jun'ul'in'o
maljunulinoj	mal'jun'ul'in'o'j
maljunulinon	mal'jun'ul'in'o'n
maljusta	mal'just'a
maljustaj	mal'just'a'j
maljustajn	mal'just'a'j'n
maljustan	mal'just'a'n
maljustas	mal'just'as
maljuste	mal'just'e
maljusto	mal'just'o
maljustoj	mal'just'o'j
maljuston	mal'just'o'n
maljustaĵo	mal'just'aĵ'o
maljustaĵoj	mal'just'aĵ'o'j
maljustaĵojn	mal'just'aĵ'o'j'n
maljustaĵon	mal'just'aĵ'o'n
maljusteco	mal'just'ec'o
maljustecoj	mal'just'ec'o'j
maljustecojn	mal'just'ec'o'j'n
maljustecon	mal'just'ec'o'n
maljustulo	mal'just'ul'o
malkapabla	mal'kapabl'a
malkapablaj	mal'kapabl'a'j
malkapablas	mal'kapabl'as
malkapablo	mal'kapabl'o
malkapabloj	mal'kapabl'o'j
malkapablon	mal'kapabl'o'n
malkapabluloj	mal'kapabl'ul'o'j
malkapablulojn	mal'kapabl'ul'o'j'n
malkara	mal'kar'a
malkaraj	mal'kar'a'j
malkaran	mal'kar'a'n
malkare	mal'kar'e
malkaŝa	mal'kaŝ'a
malkaŝaj	mal'kaŝ'a'j
malkaŝajn	mal'kaŝ'a'j'n
malkaŝan	mal'kaŝ'a'n
malkaŝas	mal'kaŝ'as
malkashe	mal'kaŝ'e
malkaŝe	mal'kaŝ'e
malkaŝi	mal'kaŝ'i
malkaŝis	mal'kaŝ'is
malkaŝo	mal'kaŝ'o
malkaŝos	mal'kaŝ'os
malkaŝu	mal'kaŝ'u
malkaŝus	mal'kaŝ'us
malkaŝado	mal'kaŝ'ad'o
malkaŝante	mal'kaŝ'ant'e
malkaŝema	mal'kaŝ'em'a
malkaŝemo	mal'kaŝ'em'o
malkaŝiĝas	mal'kaŝ'iĝ'as
malkaŝiĝis	mal'kaŝ'iĝ'is
malkaŝita	mal'kaŝ'it'a
malkaŝitaj	mal'kaŝ'it'a'j
malklara	mal'klar'a
malklaraj	mal'klar'a'j
malklarajn	mal'klar'a'j'n
malklaran	mal'klar'a'n
malklaras	mal'klar'as
malklare	mal'klar'e
malklaris	mal'klar'is
malklareco	mal'klar'ec'o
malklarecoj	mal'klar'ec'o'j
malklarecon	mal'klar'ec'o'n
malklarigas	mal'klar'ig'as
malklarigi	mal'klar'ig'i
malklarigis	mal'klar'ig'is
malklarigo	mal'klar'ig'o
malklarigante	mal'klar'ig'ant'e
malklarigita	mal'klar'ig'it'a
malklarigitaj	mal'klar'ig'it'a'j
malklariĝis	mal'klar'iĝ'is
malklarkontura	mal'klar'kontur'a
malklarkonturaj	mal'klar'kontur'a'j
malklera	mal'kler'a
malkleraj	mal'kler'a'j
malklereco	mal'kler'ec'o
malklerecon	mal'kler'ec'o'n
malklerulo	mal'kler'ul'o
malkleruloj	mal'kler'ul'o'j
malkodado	mal'kod'ad'o
malkohera	mal'koher'a
malkoloniigado	mal'koloni'ig'ad'o
malkomforta	mal'komfort'a
malkomfortaj	mal'komfort'a'j
malkomfortan	mal'komfort'a'n
malkomforte	mal'komfort'e
malkomforto	mal'komfort'o
malkomforton	mal'komfort'o'n
malkompakta	mal'kompakt'a
malkompetenta	mal'kompetent'a
malkompetentaj	mal'kompetent'a'j
malkompleta	mal'komplet'a
malkompleza	mal'komplez'a
malkomplezaj	mal'komplez'a'j
malkomplika	mal'komplik'a
malkomponi	mal'kompon'i
malkomponado	mal'kompon'ad'o
malkomponaĵo	mal'kompon'aĵ'o
malkomponiĝas	mal'kompon'iĝ'as
malkomponiĝo	mal'kompon'iĝ'o
malkompreno	mal'kompren'o
malkomprenebla	mal'kompren'ebl'a
malkonata	mal'kon'at'a
malkonataj	mal'kon'at'a'j
malkonciza	mal'konciz'a
malkondamno	mal'kondamn'o
malkondamnita	mal'kondamn'it'a
malkonektas	mal'konekt'as
malkonekti	mal'konekt'i
malkonektis	mal'konekt'is
malkonektita	mal'konekt'it'a
malkonfesas	mal'konfes'as
malkonfesi	mal'konfes'i
malkonfesis	mal'konfes'is
malkonfeso	mal'konfes'o
malkonfida	mal'konfid'a
malkonfido	mal'konfid'o
malkonfidon	mal'konfid'o'n
malkonfirmi	mal'konfirm'i
malkonfirmis	mal'konfirm'is
malkongrua	mal'kongru'a
malkongruaj	mal'kongru'a'j
malkongruajn	mal'kongru'a'j'n
malkongruan	mal'kongru'a'n
malkongruas	mal'kongru'as
malkongruo	mal'kongru'o
malkonkordo	mal'konkord'o
malkonkordoj	mal'konkord'o'j
malkonkordon	mal'konkord'o'n
malkonsekvenca	mal'konsekvenc'a
malkonsekvencaj	mal'konsekvenc'a'j
malkonsekvencajn	mal'konsekvenc'a'j'n
malkonsekvence	mal'konsekvenc'e
malkonsentas	mal'konsent'as
malkonsenti	mal'konsent'i
malkonsentis	mal'konsent'is
malkonsento	mal'konsent'o
malkonsentoj	mal'konsent'o'j
malkonsentojn	mal'konsent'o'j'n
malkonsenton	mal'konsent'o'n
malkonsentuloj	mal'konsent'ul'o'j
malkonsilas	mal'konsil'as
malkonsili	mal'konsil'i
malkonsilis	mal'konsil'is
malkonstrua	mal'konstru'a
malkonstruas	mal'konstru'as
malkonstrui	mal'konstru'i
malkonstruis	mal'konstru'is
malkonstruo	mal'konstru'o
malkonstruon	mal'konstru'o'n
malkonstruado	mal'konstru'ad'o
malkonstruante	mal'konstru'ant'e
malkonstruigiloj	mal'konstru'ig'il'o'j
malkonstruita	mal'konstru'it'a
malkonstruitaj	mal'konstru'it'a'j
malkontenta	mal'kontent'a
malkontentaj	mal'kontent'a'j
malkontentan	mal'kontent'a'n
malkontentas	mal'kontent'as
malkontente	mal'kontent'e
malkontentis	mal'kontent'is
malkontento	mal'kontent'o
malkontentoj	mal'kontent'o'j
malkontenton	mal'kontent'o'n
malkontenteco	mal'kontent'ec'o
malkontentecon	mal'kontent'ec'o'n
malkontentiga	mal'kontent'ig'a
malkontentigas	mal'kontent'ig'as
malkontentigis	mal'kontent'ig'is
malkontentigita	mal'kontent'ig'it'a
malkontentiĝis	mal'kontent'iĝ'is
malkontentuloj	mal'kontent'ul'o'j
malkontinua	mal'kontinu'a
malkontinuaj	mal'kontinu'a'j
malkontinueco	mal'kontinu'ec'o
malkontinuecoj	mal'kontinu'ec'o'j
malkonvena	mal'konven'a
malkonvenaj	mal'konven'a'j
malkonvenajn	mal'konven'a'j'n
malkonvenan	mal'konven'a'n
malkonvene	mal'konven'e
malkorekta	mal'korekt'a
malkorektaj	mal'korekt'a'j
malkorekte	mal'korekt'e
malkosta	mal'kost'a
malkovras	mal'kovr'as
malkovri	mal'kovr'i
malkovris	mal'kovr'is
malkovro	mal'kovr'o
malkovroj	mal'kovr'o'j
malkovrojn	mal'kovr'o'j'n
malkovron	mal'kovr'o'n
malkovros	mal'kovr'os
malkovru	mal'kovr'u
malkovrus	mal'kovr'us
malkovrado	mal'kovr'ad'o
malkovradon	mal'kovr'ad'o'n
malkovraĵoj	mal'kovr'aĵ'o'j
malkovrante	mal'kovr'ant'e
malkovrataj	mal'kovr'at'a'j
malkovrigis	mal'kovr'ig'is
malkovriĝas	mal'kovr'iĝ'as
malkovriĝis	mal'kovr'iĝ'is
malkovrinta	mal'kovr'int'a
malkovrinte	mal'kovr'int'e
malkovrinto	mal'kovr'int'o
malkovrintoj	mal'kovr'int'o'j
malkovrintino	mal'kovr'int'in'o
malkovrita	mal'kovr'it'a
malkovritaj	mal'kovr'it'a'j
malkovritajn	mal'kovr'it'a'j'n
malkovritan	mal'kovr'it'a'n
malkovrite	mal'kovr'it'e
malkredas	mal'kred'as
malkredo	mal'kred'o
malkreska	mal'kresk'a
malkreskas	mal'kresk'as
malkreski	mal'kresk'i
malkreskis	mal'kresk'is
malkresko	mal'kresk'o
malkreskoj	mal'kresk'o'j
malkreskojn	mal'kresk'o'j'n
malkreskon	mal'kresk'o'n
malkreskos	mal'kresk'os
malkreskado	mal'kresk'ad'o
malkreskanta	mal'kresk'ant'a
malkreskantaj	mal'kresk'ant'a'j
malkreskantajn	mal'kresk'ant'a'j'n
malkreskantan	mal'kresk'ant'a'n
malkreskante	mal'kresk'ant'e
malkreskigas	mal'kresk'ig'as
malkreskinta	mal'kresk'int'a
malkreskintaj	mal'kresk'int'a'j
malkreskintan	mal'kresk'int'a'n
malkreskita	mal'kresk'it'a
malkreskitaj	mal'kresk'it'a'j
malkroĉis	mal'kroĉ'is
malkruta	mal'krut'a
malkrutaj	mal'krut'a'j
malkulmino	mal'kulmin'o
malkulminoj	mal'kulmin'o'j
malkulminon	mal'kulmin'o'n
malkune	mal'kun'e
malkunpremo	mal'kun'prem'o
malkuraĝa	mal'kuraĝ'a
malkuraĝaj	mal'kuraĝ'a'j
malkuraĝan	mal'kuraĝ'a'n
malkuraĝe	mal'kuraĝ'e
malkuraĝo	mal'kuraĝ'o
malkuraĝiga	mal'kuraĝ'ig'a
malkuraĝigas	mal'kuraĝ'ig'as
malkuraĝigi	mal'kuraĝ'ig'i
malkuraĝigis	mal'kuraĝ'ig'is
malkuraĝigo	mal'kuraĝ'ig'o
malkuraĝigita	mal'kuraĝ'ig'it'a
malkuraĝiĝis	mal'kuraĝ'iĝ'is
malkuraĝulo	mal'kuraĝ'ul'o
malkuraĝuloj	mal'kuraĝ'ul'o'j
malkutima	mal'kutim'a
malkutimaj	mal'kutim'a'j
malkutime	mal'kutim'e
malkutimeco	mal'kutim'ec'o
malkvieta	mal'kviet'a
malkvietaj	mal'kviet'a'j
malkvietan	mal'kviet'a'n
malkvietas	mal'kviet'as
malkviete	mal'kviet'e
malkvietis	mal'kviet'is
malkvieto	mal'kviet'o
malkvietiga	mal'kviet'ig'a
malkvietigas	mal'kviet'ig'as
malkvietigis	mal'kviet'ig'is
malkvietiĝis	mal'kviet'iĝ'is
malkvietiĝu	mal'kviet'iĝ'u
mallaborema	mal'labor'em'a
mallaboremaj	mal'labor'em'a'j
mallaboremas	mal'labor'em'as
mallaboremo	mal'labor'em'o
mallaboremon	mal'labor'em'o'n
mallaboremulo	mal'labor'em'ul'o
mallaboremuloj	mal'labor'em'ul'o'j
mallaboruloj	mal'labor'ul'o'j
mallarĝa	mal'larĝ'a
mallarĝaj	mal'larĝ'a'j
mallarĝajn	mal'larĝ'a'j'n
mallarĝan	mal'larĝ'a'n
mallarĝe	mal'larĝ'e
mallarĝeco	mal'larĝ'ec'o
mallarĝejo	mal'larĝ'ej'o
mallarĝejon	mal'larĝ'ej'o'n
mallarĝigas	mal'larĝ'ig'as
mallarĝigi	mal'larĝ'ig'i
mallarĝigis	mal'larĝ'ig'is
mallarĝigoj	mal'larĝ'ig'o'j
mallarĝigante	mal'larĝ'ig'ant'e
mallarĝigitaj	mal'larĝ'ig'it'a'j
mallarĝiĝas	mal'larĝ'iĝ'as
mallarĝiĝis	mal'larĝ'iĝ'is
mallaŭdas	mal'laŭd'as
mallaŭdi	mal'laŭd'i
mallaŭdis	mal'laŭd'is
mallaŭdo	mal'laŭd'o
mallaŭdon	mal'laŭd'o'n
mallaŭdu	mal'laŭd'u
mallaŭdinda	mal'laŭd'ind'a
mallaŭdita	mal'laŭd'it'a
mallaŭta	mal'laŭt'a
mallaŭtaj	mal'laŭt'a'j
mallaŭtajn	mal'laŭt'a'j'n
mallaŭtan	mal'laŭt'a'n
mallaŭte	mal'laŭt'e
mallaŭtigi	mal'laŭt'ig'i
mallaŭtigis	mal'laŭt'ig'is
mallaŭtigu	mal'laŭt'ig'u
mallaŭtiĝis	mal'laŭt'iĝ'is
mallerni	mal'lern'i
mallerta	mal'lert'a
mallertaj	mal'lert'a'j
mallertajn	mal'lert'a'j'n
mallertan	mal'lert'a'n
mallertas	mal'lert'as
mallerte	mal'lert'e
mallerto	mal'lert'o
mallerteco	mal'lert'ec'o
mallertecon	mal'lert'ec'o'n
mallertulo	mal'lert'ul'o
mallevas	mal'lev'as
mallevi	mal'lev'i
mallevis	mal'lev'is
mallevos	mal'lev'os
mallevu	mal'lev'u
mallevante	mal'lev'ant'e
malleviĝas	mal'lev'iĝ'as
malleviĝi	mal'lev'iĝ'i
malleviĝis	mal'lev'iĝ'is
malleviĝo	mal'lev'iĝ'o
malleviĝanta	mal'lev'iĝ'ant'a
malleviĝantaj	mal'lev'iĝ'ant'a'j
malleviĝinte	mal'lev'iĝ'int'e
mallevinte	mal'lev'int'e
mallevita	mal'lev'it'a
mallevitaj	mal'lev'it'a'j
mallibera	mal'liber'a
malliberaj	mal'liber'a'j
malliberajn	mal'liber'a'j'n
malliberan	mal'liber'a'n
mallibero	mal'liber'o
mallibereco	mal'liber'ec'o
malliberecon	mal'liber'ec'o'n
mallibereja	mal'liber'ej'a
malliberejaj	mal'liber'ej'a'j
malliberejo	mal'liber'ej'o
malliberejoj	mal'liber'ej'o'j
malliberejojn	mal'liber'ej'o'j'n
malliberejon	mal'liber'ej'o'n
malliberejsistemo	mal'liber'ej'sistem'o
malliberigas	mal'liber'ig'as
malliberigi	mal'liber'ig'i
malliberigis	mal'liber'ig'is
malliberigo	mal'liber'ig'o
malliberigon	mal'liber'ig'o'n
malliberigata	mal'liber'ig'at'a
malliberigita	mal'liber'ig'it'a
malliberigitaj	mal'liber'ig'it'a'j
malliberigite	mal'liber'ig'it'e
malliberigito	mal'liber'ig'it'o
malliberigitoj	mal'liber'ig'it'o'j
malliberigitojn	mal'liber'ig'it'o'j'n
malliberiĝo	mal'liber'iĝ'o
malliberulo	mal'liber'ul'o
malliberuloj	mal'liber'ul'o'j
malliberulojn	mal'liber'ul'o'j'n
malliberulon	mal'liber'ul'o'n
malligas	mal'lig'as
malligi	mal'lig'i
malligis	mal'lig'is
malligo	mal'lig'o
malligoj	mal'lig'o'j
malligon	mal'lig'o'n
malligita	mal'lig'it'a
malligitaj	mal'lig'it'a'j
mallogi	mal'log'i
mallogika	mal'logik'a
mallogike	mal'logik'e
mallojala	mal'lojal'a
mallojaleco	mal'lojal'ec'o
malloka	mal'lok'a
mallonga	mal'long'a
mallongaj	mal'long'a'j
mallongajn	mal'long'a'j'n
mallongan	mal'long'a'n
mallongas	mal'long'as
mallonge	mal'long'e
mallongbeka	mal'long'bek'a
mallongdaŭra	mal'long'daŭr'a
mallongdaŭraj	mal'long'daŭr'a'j
mallongdaŭran	mal'long'daŭr'a'n
mallongdistanca	mal'long'distanc'a
mallongdistancaj	mal'long'distanc'a'j
mallongdistancan	mal'long'distanc'a'n
mallongeco	mal'long'ec'o
mallongega	mal'long'eg'a
mallongegaj	mal'long'eg'a'j
mallongegajn	mal'long'eg'a'j'n
mallongigas	mal'long'ig'as
mallongige	mal'long'ig'e
mallongigi	mal'long'ig'i
mallongigis	mal'long'ig'is
mallongigo	mal'long'ig'o
mallongigoj	mal'long'ig'o'j
mallongigojn	mal'long'ig'o'j'n
mallongigon	mal'long'ig'o'n
mallongigu	mal'long'ig'u
mallongigado	mal'long'ig'ad'o
mallongigante	mal'long'ig'ant'e
mallongigata	mal'long'ig'at'a
mallongigita	mal'long'ig'it'a
mallongigitaj	mal'long'ig'it'a'j
mallongigitan	mal'long'ig'it'a'n
mallongigite	mal'long'ig'it'e
mallongiĝas	mal'long'iĝ'as
mallongiĝis	mal'long'iĝ'is
mallongperspektiva	mal'long'perspektiv'a
mallongperspektivaj	mal'long'perspektiv'a'j
mallongperspektivajn	mal'long'perspektiv'a'j'n
mallongperspektivan	mal'long'perspektiv'a'n
mallongtempa	mal'long'temp'a
mallongtempaj	mal'long'temp'a'j
mallongtempe	mal'long'temp'e
malluksa	mal'luks'a
malluksaj	mal'luks'a'j
malluma	mal'lum'a
mallumaj	mal'lum'a'j
mallumajn	mal'lum'a'j'n
malluman	mal'lum'a'n
mallumas	mal'lum'as
mallume	mal'lum'e
mallumis	mal'lum'is
mallumo	mal'lum'o
mallumon	mal'lum'o'n
mallumigita	mal'lum'ig'it'a
mallumiĝas	mal'lum'iĝ'as
mallumiĝis	mal'lum'iĝ'is
mallumiĝo	mal'lum'iĝ'o
mallumuloj	mal'lum'ul'o'j
malmilda	mal'mild'a
malmildaj	mal'mild'a'j
malmilde	mal'mild'e
malmodera	mal'moder'a
malmodere	mal'moder'e
malmoderna	mal'modern'a
malmodernaj	mal'modern'a'j
malmodernajn	mal'modern'a'j'n
malmodernan	mal'modern'a'n
malmodesta	mal'modest'a
malmodeste	mal'modest'e
malmodesteco	mal'modest'ec'o
malmola	mal'mol'a
malmolaj	mal'mol'a'j
malmolajn	mal'mol'a'j'n
malmolan	mal'mol'a'n
malmole	mal'mol'e
malmoleco	mal'mol'ec'o
malmolecon	mal'mol'ec'o'n
malmolega	mal'mol'eg'a
malmoliĝas	mal'mol'iĝ'as
malmoliĝi	mal'mol'iĝ'i
malmoliĝis	mal'mol'iĝ'is
malmorala	mal'moral'a
malmoralaj	mal'moral'a'j
malmoralajn	mal'moral'a'j'n
malmoralan	mal'moral'a'n
malmorale	mal'moral'e
malmoralo	mal'moral'o
malmoraleco	mal'moral'ec'o
malmoralecon	mal'moral'ec'o'n
malmulta	mal'mult'a
malmultaj	mal'mult'a'j
malmultajn	mal'mult'a'j'n
malmultan	mal'mult'a'n
malmultas	mal'mult'as
malmulte	mal'mult'e
malmultis	mal'mult'is
malmulto	mal'mult'o
malmultoj	mal'mult'o'j
malmulton	mal'mult'o'n
malmultekosta	mal'mult'e'kost'a
malmultekostaj	mal'mult'e'kost'a'j
malmultekostajn	mal'mult'e'kost'a'j'n
malmultekostan	mal'mult'e'kost'a'n
malmultekoste	mal'mult'e'kost'e
malmultenombra	mal'mult'e'nombr'a
malmulteco	mal'mult'ec'o
malmultegaj	mal'mult'eg'a'j
malmultege	mal'mult'eg'e
malmultigi	mal'mult'ig'i
malmultiĝas	mal'mult'iĝ'as
malmultiĝis	mal'mult'iĝ'is
malmultiĝo	mal'mult'iĝ'o
malmultkosta	mal'mult'kost'a
malmultkostaj	mal'mult'kost'a'j
malmultnombraj	mal'mult'nombr'a'j
malmuntas	mal'munt'as
malmunti	mal'munt'i
malmuntis	mal'munt'is
malmuntado	mal'munt'ad'o
malmuntadon	mal'munt'ad'o'n
malmuntita	mal'munt'it'a
malmuntitaj	mal'munt'it'a'j
malnaiva	mal'naiv'a
malnatura	mal'natur'a
malnecesa	mal'neces'a
malneta	mal'net'a
malnetaj	mal'net'a'j
malnetan	mal'net'a'n
malneto	mal'net'o
malneton	mal'net'o'n
malnobelo	mal'nobel'o
malnobeloj	mal'nobel'o'j
malnobla	mal'nobl'a
malnoblaj	mal'nobl'a'j
malnoblajn	mal'nobl'a'j'n
malnoblan	mal'nobl'a'n
malnoble	mal'nobl'e
malnobleco	mal'nobl'ec'o
malnoblulo	mal'nobl'ul'o
malnormala	mal'normal'a
malnova	mal'nov'a
malnovaj	mal'nov'a'j
malnovajn	mal'nov'a'j'n
malnovan	mal'nov'a'n
malnovas	mal'nov'as
malnove	mal'nov'e
malnovo	mal'nov'o
malnovoj	mal'nov'o'j
malnovon	mal'nov'o'n
malnovaĵoj	mal'nov'aĵ'o'j
malnovaltgermana	mal'nov'alt'german'a
malnovega	mal'nov'eg'a
malnovegaj	mal'nov'eg'a'j
malnovegan	mal'nov'eg'a'n
malnovfranca	mal'nov'franc'a
malnovgermana	mal'nov'german'a
malnovgreka	mal'nov'grek'a
malnovgrekaj	mal'nov'grek'a'j
malnoviĝas	mal'nov'iĝ'as
malnoviĝo	mal'nov'iĝ'o
malnoviĝinta	mal'nov'iĝ'int'a
malnoviĝintaj	mal'nov'iĝ'int'a'j
malnoviĝintan	mal'nov'iĝ'int'a'n
malnovirlanda	mal'nov'irland'a
malnovmoda	mal'nov'mod'a
malnovmondaj	mal'nov'mond'a'j
malnovpola	mal'nov'pol'a
malnovritanoj	mal'nov'rit'an'o'j
malnovrusa	mal'nov'rus'a
malnovslava	mal'nov'slav'a
malnovtestamenta	mal'nov'testament'a
malnovtestamentaj	mal'nov'testament'a'j
malobeas	mal'obe'as
malobee	mal'obe'e
malobei	mal'obe'i
malobeis	mal'obe'is
malobeo	mal'obe'o
malobeon	mal'obe'o'n
malobeos	mal'obe'os
malobeus	mal'obe'us
malobeado	mal'obe'ad'o
malobeante	mal'obe'ant'e
malobeema	mal'obe'em'a
malobeemaj	mal'obe'em'a'j
malobeemo	mal'obe'em'o
malobeita	mal'obe'it'a
malobservas	mal'observ'as
malobservi	mal'observ'i
malobservis	mal'observ'is
malobservo	mal'observ'o
malobservoj	mal'observ'o'j
malobservojn	mal'observ'o'j'n
malobservon	mal'observ'o'n
malobservos	mal'observ'os
malobservus	mal'observ'us
malobservado	mal'observ'ad'o
malobservante	mal'observ'ant'e
malobservita	mal'observ'it'a
malobservitaj	mal'observ'it'a'j
malofta	mal'oft'a
maloftaj	mal'oft'a'j
maloftajn	mal'oft'a'j'n
maloftan	mal'oft'a'n
maloftas	mal'oft'as
malofte	mal'oft'e
maloftis	mal'oft'is
maloftaĵo	mal'oft'aĵ'o
malofteco	mal'oft'ec'o
maloftega	mal'oft'eg'a
maloftegaj	mal'oft'eg'a'j
maloftege	mal'oft'eg'e
maloportuna	mal'oportun'a
maloportunaj	mal'oportun'a'j
maloportunan	mal'oportun'a'n
maloportune	mal'oportun'e
maloportunaĵoj	mal'oportun'aĵ'o'j
malorda	mal'ord'a
malordaj	mal'ord'a'j
malordan	mal'ord'a'n
malorde	mal'ord'e
malordo	mal'ord'o
malordoj	mal'ord'o'j
malordojn	mal'ord'o'j'n
malordon	mal'ord'o'n
malordigis	mal'ord'ig'is
malordigita	mal'ord'ig'it'a
malordigitaj	mal'ord'ig'it'a'j
malpaca	mal'pac'a
malpacas	mal'pac'as
malpaci	mal'pac'i
malpacis	mal'pac'is
malpaco	mal'pac'o
malpacoj	mal'pac'o'j
malpacon	mal'pac'o'n
malpacienca	mal'pacienc'a
malpaciencaj	mal'pacienc'a'j
malpacience	mal'pacienc'e
malpacienco	mal'pacienc'o
malpaciencon	mal'pacienc'o'n
malpacienciĝas	mal'pacienc'iĝ'as
malpakis	mal'pak'is
malpara	mal'par'a
malparolema	mal'parol'em'a
malparolemaj	mal'parol'em'a'j
malperforto	mal'per'fort'o
malperfekta	mal'perfekt'a
malperfektaj	mal'perfekt'a'j
malperfektaĵoj	mal'perfekt'aĵ'o'j
malperfektaĵojn	mal'perfekt'aĵ'o'j'n
malperfekteco	mal'perfekt'ec'o
malpermesas	mal'permes'as
malpermesi	mal'permes'i
malpermesis	mal'permes'is
malpermeso	mal'permes'o
malpermesoj	mal'permes'o'j
malpermesojn	mal'permes'o'j'n
malpermeson	mal'permes'o'n
malpermesos	mal'permes'os
malpermesu	mal'permes'u
malpermesus	mal'permes'us
malpermesado	mal'permes'ad'o
malpermesanta	mal'permes'ant'a
malpermesantaj	mal'permes'ant'a'j
malpermesantajn	mal'permes'ant'a'j'n
malpermesantan	mal'permes'ant'a'n
malpermesante	mal'permes'ant'e
malpermesata	mal'permes'at'a
malpermesataj	mal'permes'at'a'j
malpermesatas	mal'permes'at'as
malpermesate	mal'permes'at'e
malpermesita	mal'permes'it'a
malpermesitaj	mal'permes'it'a'j
malpermesitajn	mal'permes'it'a'j'n
malpermesitan	mal'permes'it'a'n
malpermesitas	mal'permes'it'as
malpermesite	mal'permes'it'e
malpeza	mal'pez'a
malpezaj	mal'pez'a'j
malpezajn	mal'pez'a'j'n
malpezan	mal'pez'a'n
malpeze	mal'pez'e
malpezeco	mal'pez'ec'o
malpezigas	mal'pez'ig'as
malpezigi	mal'pez'ig'i
malpezigis	mal'pez'ig'is
malpeziĝis	mal'pez'iĝ'is
malpeziĝo	mal'pez'iĝ'o
malpia	mal'pi'a
malpiaj	mal'pi'a'j
malpieco	mal'pi'ec'o
malpiuloj	mal'pi'ul'o'j
malplaĉa	mal'plaĉ'a
malplaĉaj	mal'plaĉ'a'j
malplaĉas	mal'plaĉ'as
malplaĉe	mal'plaĉ'e
malplaĉi	mal'plaĉ'i
malplaĉis	mal'plaĉ'is
malplaĉon	mal'plaĉ'o'n
malpleja	mal'plej'a
malplejan	mal'plej'a'n
malpleje	mal'plej'e
malplena	mal'plen'a
malplenaj	mal'plen'a'j
malplenajn	mal'plen'a'j'n
malplenan	mal'plen'a'n
malplenas	mal'plen'as
malplene	mal'plen'e
malplenis	mal'plen'is
malpleno	mal'plen'o
malplenoj	mal'plen'o'j
malplenojn	mal'plen'o'j'n
malplenon	mal'plen'o'n
malpleneco	mal'plen'ec'o
malplenecon	mal'plen'ec'o'n
malplenigas	mal'plen'ig'as
malplenigi	mal'plen'ig'i
malplenigis	mal'plen'ig'is
malplenigo	mal'plen'ig'o
malplenigon	mal'plen'ig'o'n
malplenigu	mal'plen'ig'u
malplenigado	mal'plen'ig'ad'o
malplenigante	mal'plen'ig'ant'e
malplenigita	mal'plen'ig'it'a
malplenigitaj	mal'plen'ig'it'a'j
malplenigitan	mal'plen'ig'it'a'n
malpleniĝis	mal'plen'iĝ'is
malplezuro	mal'plezur'o
malplezuron	mal'plezur'o'n
malplia	mal'pli'a
malplian	mal'pli'a'n
malplie	mal'pli'e
malpliaĝa	mal'pli'aĝ'a
malplialtagrade	mal'pli'alt'a'grad'e
malplibonigo	mal'pli'bon'ig'o
malplibonigon	mal'pli'bon'ig'o'n
malpliboniĝas	mal'pli'bon'iĝ'as
malpliboniĝis	mal'pli'bon'iĝ'is
malpligrandigas	mal'pli'grand'ig'as
malpligrandigi	mal'pli'grand'ig'i
malpligrandiĝas	mal'pli'grand'iĝ'as
malpligrandiĝis	mal'pli'grand'iĝ'is
malpligrandiĝo	mal'pli'grand'iĝ'o
malpliiga	mal'pli'ig'a
malpliigas	mal'pli'ig'as
malpliigi	mal'pli'ig'i
malpliigis	mal'pli'ig'is
malpliigo	mal'pli'ig'o
malpliigon	mal'pli'ig'o'n
malpliigos	mal'pli'ig'os
malpliigu	mal'pli'ig'u
malpliigus	mal'pli'ig'us
malpliigado	mal'pli'ig'ad'o
malpliiganta	mal'pli'ig'ant'a
malpliigante	mal'pli'ig'ant'e
malpliigita	mal'pli'ig'it'a
malpliigitaj	mal'pli'ig'it'a'j
malpliigitan	mal'pli'ig'it'a'n
malpliiĝas	mal'pli'iĝ'as
malpliiĝi	mal'pli'iĝ'i
malpliiĝis	mal'pli'iĝ'is
malpliiĝo	mal'pli'iĝ'o
malpliiĝon	mal'pli'iĝ'o'n
malpliiĝos	mal'pli'iĝ'os
malpliiĝu	mal'pli'iĝ'u
malpliiĝus	mal'pli'iĝ'us
malpliiĝanta	mal'pli'iĝ'ant'a
malpliiĝantaj	mal'pli'iĝ'ant'a'j
malpliiĝante	mal'pli'iĝ'ant'e
malplilaŭtigi	mal'pli'laŭt'ig'i
malplimulta	mal'pli'mult'a
malplimultaj	mal'pli'mult'a'j
malplimulto	mal'pli'mult'o
malplimultoj	mal'pli'mult'o'j
malplimultojn	mal'pli'mult'o'j'n
malplimulton	mal'pli'mult'o'n
malplipeziĝo	mal'pli'pez'iĝ'o
malplivaloreco	mal'pli'valor'ec'o
malplivalorigi	mal'pli'valor'ig'i
malplivalorigo	mal'pli'valor'ig'o
malpolariĝo	mal'polar'iĝ'o
malpopulara	mal'popular'a
malpopulareco	mal'popular'ec'o
malprava	mal'prav'a
malpravaj	mal'prav'a'j
malpravas	mal'prav'as
malprave	mal'prav'e
malpravi	mal'prav'i
malpravis	mal'prav'is
malpravo	mal'prav'o
malpravigas	mal'prav'ig'as
malpreciza	mal'preciz'a
malprecizaj	mal'preciz'a'j
malprecizajn	mal'preciz'a'j'n
malprecizan	mal'preciz'a'n
malprecize	mal'preciz'e
malprecizaĵo	mal'preciz'aĵ'o
malprecizeco	mal'preciz'ec'o
malprobabla	mal'probabl'a
malprobable	mal'probabl'e
malprofita	mal'profit'a
malprofitan	mal'profit'a'n
malprofitas	mal'profit'as
malprofite	mal'profit'e
malprofito	mal'profit'o
malprofiton	mal'profit'o'n
malprofunda	mal'profund'a
malprofundaj	mal'profund'a'j
malprofundajn	mal'profund'a'j'n
malprofundan	mal'profund'a'n
malprofunde	mal'profund'e
malprofundaĵo	mal'profund'aĵ'o
malprofundejo	mal'profund'ej'o
malprogresas	mal'progres'as
malprogreso	mal'progres'o
malprogreson	mal'progres'o'n
malprogresinta	mal'progres'int'a
malproksima	mal'proksim'a
malproksimaj	mal'proksim'a'j
malproksimajn	mal'proksim'a'j'n
malproksiman	mal'proksim'a'n
malproksimas	mal'proksim'as
malproksime	mal'proksim'e
malproksimen	mal'proksim'e'n
malproksimo	mal'proksim'o
malproksimon	mal'proksim'o'n
malproksimeco	mal'proksim'ec'o
malproksimega	mal'proksim'eg'a
malproksimigas	mal'proksim'ig'as
malproksimigi	mal'proksim'ig'i
malproksimigis	mal'proksim'ig'is
malproksimiĝas	mal'proksim'iĝ'as
malproksimiĝi	mal'proksim'iĝ'i
malproksimiĝis	mal'proksim'iĝ'is
malproksimiĝo	mal'proksim'iĝ'o
malproksimiĝu	mal'proksim'iĝ'u
malprospera	mal'prosper'a
malprosperis	mal'prosper'is
malprospero	mal'prosper'o
malprosperon	mal'prosper'o'n
malprotesto	mal'protest'o
malprudenta	mal'prudent'a
malprudentaj	mal'prudent'a'j
malprudente	mal'prudent'e
malpruvas	mal'pruv'as
malpruvi	mal'pruv'i
malpruvebla	mal'pruv'ebl'a
malpublike	mal'publik'e
malpubliko	mal'publik'o
malpura	mal'pur'a
malpuraj	mal'pur'a'j
malpurajn	mal'pur'a'j'n
malpuran	mal'pur'a'n
malpuras	mal'pur'as
malpure	mal'pur'e
malpuro	mal'pur'o
malpuraĵo	mal'pur'aĵ'o
malpuraĵoj	mal'pur'aĵ'o'j
malpuraĵojn	mal'pur'aĵ'o'j'n
malpuraĵon	mal'pur'aĵ'o'n
malpuraĵogrupoj	mal'pur'aĵ'o'grup'o'j
malpureco	mal'pur'ec'o
malpurigas	mal'pur'ig'as
malpurigi	mal'pur'ig'i
malpurigis	mal'pur'ig'is
malpurigo	mal'pur'ig'o
malpurigon	mal'pur'ig'o'n
malpurigos	mal'pur'ig'os
malpurigu	mal'pur'ig'u
malpurigaĵo	mal'pur'ig'aĵ'o
malpurigaĵoj	mal'pur'ig'aĵ'o'j
malpurigaĵojn	mal'pur'ig'aĵ'o'j'n
malpurigita	mal'pur'ig'it'a
malpurigitaj	mal'pur'ig'it'a'j
malpuriĝas	mal'pur'iĝ'as
malpuriĝis	mal'pur'iĝ'is
malpuriĝo	mal'pur'iĝ'o
malracia	mal'raci'a
malraciaj	mal'raci'a'j
malracian	mal'raci'a'n
malracie	mal'raci'e
malrapida	mal'rapid'a
malrapidaj	mal'rapid'a'j
malrapidajn	mal'rapid'a'j'n
malrapidan	mal'rapid'a'n
malrapidas	mal'rapid'as
malrapide	mal'rapid'e
malrapidis	mal'rapid'is
malrapido	mal'rapid'o
malrapidu	mal'rapid'u
malrapideco	mal'rapid'ec'o
malrapidege	mal'rapid'eg'e
malrapidema	mal'rapid'em'a
malrapidigas	mal'rapid'ig'as
malrapidigi	mal'rapid'ig'i
malrapidigis	mal'rapid'ig'is
malrapidiĝas	mal'rapid'iĝ'as
malrapidiĝi	mal'rapid'iĝ'i
malrapidiĝis	mal'rapid'iĝ'is
malrapidiĝo	mal'rapid'iĝ'o
malrapidiĝon	mal'rapid'iĝ'o'n
malrapidiĝu	mal'rapid'iĝ'u
malrapidmovaj	mal'rapid'mov'a'j
malreala	mal'real'a
malregula	mal'regul'a
malregulaj	mal'regul'a'j
malregulajn	mal'regul'a'j'n
malregulan	mal'regul'a'n
malregule	mal'regul'e
malregulaĵo	mal'regul'aĵ'o
malregulaĵoj	mal'regul'aĵ'o'j
malrekomendas	mal'rekomend'as
malrekomendi	mal'rekomend'i
malrekomendis	mal'rekomend'is
malrekomendita	mal'rekomend'it'a
malrekta	mal'rekt'a
malrektaj	mal'rekt'a'j
malrektan	mal'rekt'a'n
malrekte	mal'rekt'e
malrespekta	mal'respekt'a
malrespektas	mal'respekt'as
malrespekte	mal'respekt'e
malrespekti	mal'respekt'i
malrespektis	mal'respekt'is
malrespekto	mal'respekt'o
malrespekton	mal'respekt'o'n
malriĉa	mal'riĉ'a
malriĉaj	mal'riĉ'a'j
malriĉajn	mal'riĉ'a'j'n
malriĉan	mal'riĉ'a'n
malriĉas	mal'riĉ'as
malriĉe	mal'riĉ'e
malriĉis	mal'riĉ'is
malriĉo	mal'riĉ'o
malriĉon	mal'riĉ'o'n
malriĉeco	mal'riĉ'ec'o
malriĉecon	mal'riĉ'ec'o'n
malriĉecredukto	mal'riĉ'ec'redukt'o
malriĉega	mal'riĉ'eg'a
malriĉigas	mal'riĉ'ig'as
malriĉigita	mal'riĉ'ig'it'a
malriĉiĝas	mal'riĉ'iĝ'as
malriĉiĝis	mal'riĉ'iĝ'is
malriĉiĝo	mal'riĉ'iĝ'o
malriĉulo	mal'riĉ'ul'o
malriĉuloj	mal'riĉ'ul'o'j
malriĉulojn	mal'riĉ'ul'o'j'n
malriĉulon	mal'riĉ'ul'o'n
malriĉularo	mal'riĉ'ul'ar'o
malriĉulejo	mal'riĉ'ul'ej'o
malrigida	mal'rigid'a
malsagha	mal'saĝ'a
malsaĝa	mal'saĝ'a
malsaĝaj	mal'saĝ'a'j
malsaĝan	mal'saĝ'a'n
malsaĝe	mal'saĝ'e
malsaĝo	mal'saĝ'o
malsaĝeco	mal'saĝ'ec'o
malsaĝecon	mal'saĝ'ec'o'n
malsaghulo	mal'saĝ'ul'o
malsaĝulo	mal'saĝ'ul'o
malsaĝuloj	mal'saĝ'ul'o'j
malsaĝulon	mal'saĝ'ul'o'n
malsama	mal'sam'a
malsamaj	mal'sam'a'j
malsamajn	mal'sam'a'j'n
malsaman	mal'sam'a'n
malsamas	mal'sam'as
malsame	mal'sam'e
malsami	mal'sam'i
malsamis	mal'sam'is
malsamo	mal'sam'o
malsamoj	mal'sam'o'j
malsamos	mal'sam'os
malsamaĵoj	mal'sam'aĵ'o'j
malsamaĵojn	mal'sam'aĵ'o'j'n
malsamantaj	mal'sam'ant'a'j
malsamante	mal'sam'ant'e
malsameco	mal'sam'ec'o
malsamecoj	mal'sam'ec'o'j
malsamecojn	mal'sam'ec'o'j'n
malsamecon	mal'sam'ec'o'n
malsamgrandaj	mal'sam'grand'a'j
malsamlingvanoj	mal'sam'lingv'an'o'j
malsammaniere	mal'sam'manier'e
malsamopinias	mal'sam'opini'as
malsamopinioj	mal'samo'pini'o'j
malsana	mal'san'a
malsanaj	mal'san'a'j
malsanajn	mal'san'a'j'n
malsanan	mal'san'a'n
malsanas	mal'san'as
malsane	mal'san'e
malsani	mal'san'i
malsanis	mal'san'is
malsano	mal'san'o
malsanoj	mal'san'o'j
malsanojn	mal'san'o'j'n
malsanon	mal'san'o'n
malsaneca	mal'san'ec'a
malsaneco	mal'san'ec'o
malsanecon	mal'san'ec'o'n
malsanema	mal'san'em'a
malsaneta	mal'san'et'a
malsaneto	mal'san'et'o
malsaniga	mal'san'ig'a
malsanigaj	mal'san'ig'a'j
malsanigas	mal'san'ig'as
malsanigi	mal'san'ig'i
malsanigis	mal'san'ig'is
malsaniĝas	mal'san'iĝ'as
malsaniĝi	mal'san'iĝ'i
malsaniĝis	mal'san'iĝ'is
malsaniĝo	mal'san'iĝ'o
malsaniĝoj	mal'san'iĝ'o'j
malsaniĝon	mal'san'iĝ'o'n
malsaniĝos	mal'san'iĝ'os
malsaniĝemeco	mal'san'iĝ'em'ec'o
malsaniĝemecon	mal'san'iĝ'em'ec'o'n
malsaniĝinta	mal'san'iĝ'int'a
malsankontrolo	mal'san'kontrol'o
malsanula	mal'san'ul'a
malsanulo	mal'san'ul'o
malsanuloj	mal'san'ul'o'j
malsanulojn	mal'san'ul'o'j'n
malsanulon	mal'san'ul'o'n
malsanuleja	mal'san'ul'ej'a
malsanulejo	mal'san'ul'ej'o
malsanulejoj	mal'san'ul'ej'o'j
malsanulejojn	mal'san'ul'ej'o'j'n
malsanulejon	mal'san'ul'ej'o'n
malsanulino	mal'san'ul'in'o
malsankta	mal'sankt'a
malsata	mal'sat'a
malsataj	mal'sat'a'j
malsatajn	mal'sat'a'j'n
malsatan	mal'sat'a'n
malsatas	mal'sat'as
malsate	mal'sat'e
malsati	mal'sat'i
malsatis	mal'sat'is
malsato	mal'sat'o
malsaton	mal'sat'o'n
malsatos	mal'sat'os
malsatu	mal'sat'u
malsatanta	mal'sat'ant'a
malsatantaj	mal'sat'ant'a'j
malsatega	mal'sat'eg'a
malsategas	mal'sat'eg'as
malsatego	mal'sat'eg'o
malsategon	mal'sat'eg'o'n
malsatigas	mal'sat'ig'as
malsatigi	mal'sat'ig'i
malsatigis	mal'sat'ig'is
malsatigos	mal'sat'ig'os
malsatkatastrofo	mal'sat'katastrof'o
malsatkatastrofoj	mal'sat'katastrof'o'j
malsatkatastrofojn	mal'sat'katastrof'o'j'n
malsatkatastrofon	mal'sat'katastrof'o'n
malsatmortas	mal'sat'mort'as
malsatmorti	mal'sat'mort'i
malsatmortis	mal'sat'mort'is
malsatulo	mal'sat'ul'o
malsatuloj	mal'sat'ul'o'j
malsatulojn	mal'sat'ul'o'j'n
malscio	mal'sci'o
malseka	mal'sek'a
malsekaj	mal'sek'a'j
malsekajn	mal'sek'a'j'n
malsekan	mal'sek'a'n
malsekas	mal'sek'as
malseke	mal'sek'e
malsekeco	mal'sek'ec'o
malsekecon	mal'sek'ec'o'n
malsekega	mal'sek'eg'a
malsekejoj	mal'sek'ej'o'j
malseketa	mal'sek'et'a
malseketaj	mal'sek'et'a'j
malseketiga	mal'sek'et'ig'a
malseketigi	mal'sek'et'ig'i
malseketigis	mal'sek'et'ig'is
malseketigado	mal'sek'et'ig'ad'o
malseketigita	mal'sek'et'ig'it'a
malseketigitaj	mal'sek'et'ig'it'a'j
malsekherbejoj	mal'sek'herb'ej'o'j
malsekigas	mal'sek'ig'as
malsekigi	mal'sek'ig'i
malsekigis	mal'sek'ig'is
malsekigo	mal'sek'ig'o
malsekigita	mal'sek'ig'it'a
malsekigitaj	mal'sek'ig'it'a'j
malsekigite	mal'sek'ig'it'e
malsekiĝas	mal'sek'iĝ'as
malsekiĝis	mal'sek'iĝ'is
malsekiĝo	mal'sek'iĝ'o
malsekiĝos	mal'sek'iĝ'os
malsekregiono	mal'sek'region'o
malsekregionoj	mal'sek'region'o'j
malsekregionojn	mal'sek'region'o'j'n
malsekura	mal'sekur'a
malsekureco	mal'sekur'ec'o
malserena	mal'seren'a
malserene	mal'seren'e
malsereniĝis	mal'seren'iĝ'is
malsereniĝo	mal'seren'iĝ'o
malserioza	mal'serioz'a
malserioze	mal'serioz'e
malsevera	mal'sever'a
malseveraj	mal'sever'a'j
malsevereco	mal'sever'ec'o
malsimetria	mal'simetri'a
malsimetriaj	mal'simetri'a'j
malsimetrian	mal'simetri'a'n
malsimetrie	mal'simetri'e
malsimetrio	mal'simetri'o
malsimetrion	mal'simetri'o'n
malsimila	mal'simil'a
malsimilaj	mal'simil'a'j
malsimilajn	mal'simil'a'j'n
malsimilan	mal'simil'a'n
malsimilas	mal'simil'as
malsimile	mal'simil'e
malsimilis	mal'simil'is
malsimileco	mal'simil'ec'o
malsimilecoj	mal'simil'ec'o'j
malsimilecon	mal'simil'ec'o'n
malsimpatia	mal'simpati'a
malsimpatio	mal'simpati'o
malsimpation	mal'simpati'o'n
malsimpla	mal'simpl'a
malsimplaj	mal'simpl'a'j
malsimplajn	mal'simpl'a'j'n
malsimplan	mal'simpl'a'n
malsimplas	mal'simpl'as
malsimple	mal'simpl'e
malsimpleco	mal'simpl'ec'o
malsincera	mal'sincer'a
malsinceraj	mal'sincer'a'j
malsincereco	mal'sincer'ec'o
malsocietema	mal'societ'em'a
malsolida	mal'solid'a
malsolidaj	mal'solid'a'j
malsovaĝa	mal'sovaĝ'a
malsovaĝaj	mal'sovaĝ'a'j
malsovaĝigi	mal'sovaĝ'ig'i
malsovaĝigis	mal'sovaĝ'ig'is
malsovaĝigo	mal'sovaĝ'ig'o
malsovaĝigita	mal'sovaĝ'ig'it'a
malsovaĝigitaj	mal'sovaĝ'ig'it'a'j
malsperta	mal'spert'a
malspertaj	mal'spert'a'j
malsperteco	mal'spert'ec'o
malsprita	mal'sprit'a
malspritaj	mal'sprit'a'j
malstabila	mal'stabil'a
malstabilaj	mal'stabil'a'j
malstabilan	mal'stabil'a'n
malstabileco	mal'stabil'ec'o
malstabilecoj	mal'stabil'ec'o'j
malstabilecon	mal'stabil'ec'o'n
malstabiligi	mal'stabil'ig'i
malstabiligis	mal'stabil'ig'is
malstreĉa	mal'streĉ'a
malstreĉaj	mal'streĉ'a'j
malstreĉan	mal'streĉ'a'n
malstreĉas	mal'streĉ'as
malstreĉe	mal'streĉ'e
malstreĉi	mal'streĉ'i
malstreĉis	mal'streĉ'is
malstreĉo	mal'streĉ'o
malstreĉon	mal'streĉ'o'n
malstreĉos	mal'streĉ'os
malstreĉu	mal'streĉ'u
malstreĉiga	mal'streĉ'ig'a
malstreĉiĝas	mal'streĉ'iĝ'as
malstreĉiĝi	mal'streĉ'iĝ'i
malstreĉiĝis	mal'streĉ'iĝ'is
malstreĉiĝo	mal'streĉ'iĝ'o
malstreĉiĝon	mal'streĉ'iĝ'o'n
malstreĉiĝu	mal'streĉ'iĝ'u
malstreĉita	mal'streĉ'it'a
malstreĉitaj	mal'streĉ'it'a'j
malstreĉitan	mal'streĉ'it'a'n
malstrikta	mal'strikt'a
malstriktaj	mal'strikt'a'j
malstriktan	mal'strikt'a'n
malstrikte	mal'strikt'e
malsufiĉa	mal'sufiĉ'a
malsufiĉas	mal'sufiĉ'as
malsufiĉe	mal'sufiĉ'e
malsufiĉo	mal'sufiĉ'o
malsukcesa	mal'sukces'a
malsukcesaj	mal'sukces'a'j
malsukcesajn	mal'sukces'a'j'n
malsukcesan	mal'sukces'a'n
malsukcesas	mal'sukces'as
malsukcese	mal'sukces'e
malsukcesi	mal'sukces'i
malsukcesis	mal'sukces'is
malsukceso	mal'sukces'o
malsukcesoj	mal'sukces'o'j
malsukcesojn	mal'sukces'o'j'n
malsukceson	mal'sukces'o'n
malsukcesos	mal'sukces'os
malsukcesu	mal'sukces'u
malsukcesus	mal'sukces'us
malsukcesado	mal'sukces'ad'o
malsukcesanta	mal'sukces'ant'a
malsukcesante	mal'sukces'ant'e
malsukcesigi	mal'sukces'ig'i
malsukcesigis	mal'sukces'ig'is
malsukcesigita	mal'sukces'ig'it'a
malsukcesigitaj	mal'sukces'ig'it'a'j
malsukcesinta	mal'sukces'int'a
malsukcesintus	mal'sukces'int'us
malsukcesita	mal'sukces'it'a
malsukcesprocento	mal'sukces'procent'o
malsukcesulo	mal'sukces'ul'o
malsupera	mal'super'a
malsuperaj	mal'super'a'j
malsuperajn	mal'super'a'j'n
malsuperan	mal'super'a'n
malsuperas	mal'super'as
malsupereco	mal'super'ec'o
malsuperklasaj	mal'super'klas'a'j
malsupra	mal'supr'a
malsupraj	mal'supr'a'j
malsuprajn	mal'supr'a'j'n
malsupran	mal'supr'a'n
malsupre	mal'supr'e
malsupren	mal'supr'e'n
malsupro	mal'supr'o
malsupron	mal'supr'o'n
malsupranivelaj	mal'supr'a'nivel'a'j
malsuprenigi	mal'supr'e'n'ig'i
malsuprenigis	mal'supr'e'n'ig'is
malsupreniĝa	mal'supr'e'n'iĝ'a
malsupreniĝan	mal'supr'e'n'iĝ'a'n
malsupreniĝis	mal'supr'e'n'iĝ'is
malsupreniĝo	mal'supr'e'n'iĝ'o
malsuprenira	mal'supr'e'n'ir'a
malsupreniras	mal'supr'e'n'ir'as
malsupreniri	mal'supr'e'n'ir'i
malsupreniris	mal'supr'e'n'ir'is
malsupreniro	mal'supr'e'n'ir'o
malsupreniros	mal'supr'e'n'ir'os
malsupreniru	mal'supr'e'n'ir'u
malsupreniranta	mal'supr'e'n'ir'ant'a
malsuprenirante	mal'supr'e'n'ir'ant'e
malsuprenkuris	mal'supr'e'n'kur'is
malŝaltas	mal'ŝalt'as
malŝalti	mal'ŝalt'i
malŝaltis	mal'ŝalt'is
malŝalto	mal'ŝalt'o
malŝaltos	mal'ŝalt'os
malŝaltu	mal'ŝalt'u
malŝaltiĝis	mal'ŝalt'iĝ'is
malŝaltita	mal'ŝalt'it'a
malŝaltitaj	mal'ŝalt'it'a'j
malŝargo	mal'ŝarg'o
malŝarĝas	mal'ŝarĝ'as
malŝarĝi	mal'ŝarĝ'i
malŝarĝis	mal'ŝarĝ'is
malŝarĝo	mal'ŝarĝ'o
malŝarĝado	mal'ŝarĝ'ad'o
malŝarĝita	mal'ŝarĝ'it'a
malŝarĝitaj	mal'ŝarĝ'it'a'j
malŝatas	mal'ŝat'as
malŝate	mal'ŝat'e
malŝati	mal'ŝat'i
malŝatis	mal'ŝat'is
malŝato	mal'ŝat'o
malŝaton	mal'ŝat'o'n
malŝatus	mal'ŝat'us
malŝatata	mal'ŝat'at'a
malŝatataj	mal'ŝat'at'a'j
malŝategas	mal'ŝat'eg'as
malŝategis	mal'ŝat'eg'is
malŝatinda	mal'ŝat'ind'a
malŝlosas	mal'ŝlos'as
malŝlosi	mal'ŝlos'i
malŝlosis	mal'ŝlos'is
malŝlosita	mal'ŝlos'it'a
malŝparas	mal'ŝpar'as
malŝpari	mal'ŝpar'i
malŝparis	mal'ŝpar'is
malŝparo	mal'ŝpar'o
malŝparon	mal'ŝpar'o'n
malŝparos	mal'ŝpar'os
malŝparu	mal'ŝpar'u
malŝparus	mal'ŝpar'us
malŝparado	mal'ŝpar'ad'o
malŝparante	mal'ŝpar'ant'e
malŝparema	mal'ŝpar'em'a
malŝparemaj	mal'ŝpar'em'a'j
malŝpareme	mal'ŝpar'em'e
malŝparemo	mal'ŝpar'em'o
malŝparita	mal'ŝpar'it'a
malŝparitaj	mal'ŝpar'it'a'j
malŝtopi	mal'ŝtop'i
malŝtopis	mal'ŝtop'is
maltaŭga	mal'taŭg'a
maltaŭgaj	mal'taŭg'a'j
maltaŭgajn	mal'taŭg'a'j'n
maltaŭgan	mal'taŭg'a'n
maltaŭgas	mal'taŭg'as
malteni	mal'ten'i
maltenis	mal'ten'is
maltenu	mal'ten'u
maltima	mal'tim'a
maltimida	mal'timid'a
maltipa	mal'tip'a
maltipaj	mal'tip'a'j
maltolerema	mal'toler'em'a
maltoleremaj	mal'toler'em'a'j
maltoleremo	mal'toler'em'o
maltoleremon	mal'toler'em'o'n
maltrafa	mal'traf'a
maltrafas	mal'traf'as
maltrafe	mal'traf'e
maltrafi	mal'traf'i
maltrafis	mal'traf'is
maltrafo	mal'traf'o
maltrafos	mal'traf'os
maltrafu	mal'traf'u
maltrafado	mal'traf'ad'o
maltrankvila	mal'trankvil'a
maltrankvilaj	mal'trankvil'a'j
maltrankvilajn	mal'trankvil'a'j'n
maltrankvilan	mal'trankvil'a'n
maltrankvilas	mal'trankvil'as
maltrankvile	mal'trankvil'e
maltrankvili	mal'trankvil'i
maltrankvilis	mal'trankvil'is
maltrankvilo	mal'trankvil'o
maltrankviloj	mal'trankvil'o'j
maltrankvilojn	mal'trankvil'o'j'n
maltrankvilon	mal'trankvil'o'n
maltrankvilu	mal'trankvil'u
maltrankvileco	mal'trankvil'ec'o
maltrankvilecon	mal'trankvil'ec'o'n
maltrankviliga	mal'trankvil'ig'a
maltrankviligaj	mal'trankvil'ig'a'j
maltrankviligan	mal'trankvil'ig'a'n
maltrankviligas	mal'trankvil'ig'as
maltrankvilige	mal'trankvil'ig'e
maltrankviligi	mal'trankvil'ig'i
maltrankviligis	mal'trankvil'ig'is
maltrankviligu	mal'trankvil'ig'u
maltrankviligado	mal'trankvil'ig'ad'o
maltrankviliganta	mal'trankvil'ig'ant'a
maltrankviligita	mal'trankvil'ig'it'a
maltrankviligitaj	mal'trankvil'ig'it'a'j
maltrankviligite	mal'trankvil'ig'it'e
maltrankviliĝas	mal'trankvil'iĝ'as
maltrankviliĝi	mal'trankvil'iĝ'i
maltrankviliĝis	mal'trankvil'iĝ'is
maltrankviliĝo	mal'trankvil'iĝ'o
maltrankviliĝon	mal'trankvil'iĝ'o'n
maltrankviliĝos	mal'trankvil'iĝ'os
maltrankviliĝu	mal'trankvil'iĝ'u
malunueca	mal'unu'ec'a
malurba	mal'urb'a
malutila	mal'util'a
malutilaj	mal'util'a'j
malutilajn	mal'util'a'j'n
malutilan	mal'util'a'n
malutilas	mal'util'as
malutile	mal'util'e
malutili	mal'util'i
malutilis	mal'util'is
malutilo	mal'util'o
malutiloj	mal'util'o'j
malutilojn	mal'util'o'j'n
malutilon	mal'util'o'n
malutilos	mal'util'os
malutilus	mal'util'us
malutileco	mal'util'ec'o
maluziĝis	mal'uz'iĝ'is
malvalida	mal'valid'a
malvalidaj	mal'valid'a'j
malvarma	mal'varm'a
malvarmaj	mal'varm'a'j
malvarmajn	mal'varm'a'j'n
malvarman	mal'varm'a'n
malvarmas	mal'varm'as
malvarme	mal'varm'e
malvarmis	mal'varm'is
malvarmo	mal'varm'o
malvarmoj	mal'varm'o'j
malvarmon	mal'varm'o'n
malvarmeco	mal'varm'ec'o
malvarmecon	mal'varm'ec'o'n
malvarmega	mal'varm'eg'a
malvarmegan	mal'varm'eg'a'n
malvarmegas	mal'varm'eg'as
malvarmege	mal'varm'eg'e
malvarmegis	mal'varm'eg'is
malvarmego	mal'varm'eg'o
malvarmeta	mal'varm'et'a
malvarmetaj	mal'varm'et'a'j
malvarmetajn	mal'varm'et'a'j'n
malvarmetan	mal'varm'et'a'n
malvarmetas	mal'varm'et'as
malvarmete	mal'varm'et'e
malvarmeto	mal'varm'et'o
malvarmeton	mal'varm'et'o'n
malvarmetigas	mal'varm'et'ig'as
malvarmetigi	mal'varm'et'ig'i
malvarmetigis	mal'varm'et'ig'is
malvarmetigu	mal'varm'et'ig'u
malvarmetigado	mal'varm'et'ig'ad'o
malvarmetigante	mal'varm'et'ig'ant'e
malvarmetigita	mal'varm'et'ig'it'a
malvarmetigitaj	mal'varm'et'ig'it'a'j
malvarmetigitan	mal'varm'et'ig'it'a'n
malvarmetigite	mal'varm'et'ig'it'e
malvarmetiĝas	mal'varm'et'iĝ'as
malvarmetiĝi	mal'varm'et'iĝ'i
malvarmetiĝis	mal'varm'et'iĝ'is
malvarmfronto	mal'varm'front'o
malvarmiga	mal'varm'ig'a
malvarmigaj	mal'varm'ig'a'j
malvarmigan	mal'varm'ig'a'n
malvarmigas	mal'varm'ig'as
malvarmigi	mal'varm'ig'i
malvarmigis	mal'varm'ig'is
malvarmigo	mal'varm'ig'o
malvarmigon	mal'varm'ig'o'n
malvarmiganta	mal'varm'ig'ant'a
malvarmigantaj	mal'varm'ig'ant'a'j
malvarmigantajn	mal'varm'ig'ant'a'j'n
malvarmigantan	mal'varm'ig'ant'a'n
malvarmigante	mal'varm'ig'ant'e
malvarmigita	mal'varm'ig'it'a
malvarmigoakvo	mal'varm'ig'o'akv'o
malvarmigosistemo	mal'varm'ig'o'sistem'o
malvarmigosistemoj	mal'varm'ig'o'sistem'o'j
malvarmiĝas	mal'varm'iĝ'as
malvarmiĝi	mal'varm'iĝ'i
malvarmiĝis	mal'varm'iĝ'is
malvarmiĝo	mal'varm'iĝ'o
malvarmiĝos	mal'varm'iĝ'os
malvarmsanga	mal'varm'sang'a
malvarmsange	mal'varm'sang'e
malvarmujo	mal'varm'uj'o
malvarmumas	mal'varm'um'as
malvarmumi	mal'varm'um'i
malvarmumis	mal'varm'um'is
malvarmumo	mal'varm'um'o
malvarmumon	mal'varm'um'o'n
malvarmumos	mal'varm'um'os
malvarmumu	mal'varm'um'u
malvarmumiĝis	mal'varm'um'iĝ'is
malvasta	mal'vast'a
malvastaj	mal'vast'a'j
malvastajn	mal'vast'a'j'n
malvastan	mal'vast'a'n
malvaste	mal'vast'e
malvastanima	mal'vast'anim'a
malvastanimaj	mal'vast'anim'a'j
malvasteco	mal'vast'ec'o
malvastigas	mal'vast'ig'as
malvastigi	mal'vast'ig'i
malvastigis	mal'vast'ig'is
malvastigita	mal'vast'ig'it'a
malvenkas	mal'venk'as
malvenki	mal'venk'i
malvenkis	mal'venk'is
malvenko	mal'venk'o
malvenkoj	mal'venk'o'j
malvenkojn	mal'venk'o'j'n
malvenkon	mal'venk'o'n
malvenkos	mal'venk'os
malvenkintoj	mal'venk'int'o'j
malvenkita	mal'venk'it'a
malvera	mal'ver'a
malveraj	mal'ver'a'j
malverajn	mal'ver'a'j'n
malveran	mal'ver'a'n
malveras	mal'ver'as
malvere	mal'ver'e
malvero	mal'ver'o
malverojn	mal'ver'o'j'n
malveron	mal'ver'o'n
malveraĵo	mal'ver'aĵ'o
malveraĵoj	mal'ver'aĵ'o'j
malveraĵojn	mal'ver'aĵ'o'j'n
malverema	mal'ver'em'a
malveremaj	mal'ver'em'a'j
malverŝajna	mal'ver'ŝajn'a
malverŝajnas	mal'ver'ŝajn'as
malverŝajne	mal'ver'ŝajn'e
malvesti	mal'vest'i
malvestis	mal'vest'is
malvigla	mal'vigl'a
malviglaj	mal'vigl'a'j
malvigle	mal'vigl'e
malvirta	mal'virt'a
malvirtaj	mal'virt'a'j
malvirtan	mal'virt'a'n
malvirto	mal'virt'o
malvirtoj	mal'virt'o'j
malvirtojn	mal'virt'o'j'n
malvirton	mal'virt'o'n
malvirtulo	mal'virt'ul'o
malvirtuloj	mal'virt'ul'o'j
malviva	mal'viv'a
malvivaj	mal'viv'a'j
malvivan	mal'viv'a'n
malvive	mal'viv'e
malvola	mal'vol'a
malvolaj	mal'vol'a'j
malvolajn	mal'vol'a'j'n
malvolan	mal'vol'a'n
malvolas	mal'vol'as
malvolis	mal'vol'is
malvolonta	mal'vol'ont'a
malvolontaj	mal'vol'ont'a'j
malvolonte	mal'vol'ont'e
malvolonta	mal'volont'a
malvolontaj	mal'volont'a'j
malvolonte	mal'volont'e
malvolvas	mal'volv'as
malvolvis	mal'volv'is
malvolviĝo	mal'volv'iĝ'o
malvortoj	mal'vort'o'j
malvortojn	mal'vort'o'j'n
malzorga	mal'zorg'a
malzorgas	mal'zorg'as
malzorge	mal'zorg'e
malzorgis	mal'zorg'is
malzorgo	mal'zorg'o
malzorgema	mal'zorg'em'a
malzorgemaj	mal'zorg'em'a'j
malzorgeman	mal'zorg'em'a'n
malzorgeme	mal'zorg'em'e
malzorgemo	mal'zorg'em'o
malago	malag'o
malagasa	malagas'a
malagasaj	malagas'a'j
malaja	malaj'a
malajaj	malaj'a'j
malajan	malaj'a'n
malajo	malaj'o
malajoj	malaj'o'j
malajala	malajal'a
malakito	malakit'o
malaria	malari'a
malario	malari'o
malarion	malari'o'n
malavio	malavi'o
maldivoj	maldiv'o'j
maleo	male'o
maleata	male'at'a
maleato	male'at'o
maleolo	maleol'o
maleoloj	maleol'o'j
maleolojn	maleol'o'j'n
maleolon	maleol'o'n
malgraŭ	malgraŭ
malgraŭe	malgraŭ'e
malgraŭvole	malgraŭ'vol'e
malia	mali'a
malio	mali'o
malica	malic'a
malicaj	malic'a'j
malicajn	malic'a'j'n
malican	malic'a'n
malice	malic'e
malico	malic'o
malicoj	malic'o'j
malicon	malic'o'n
maliceta	malic'et'a
malicspiritoj	malic'spirit'o'j
maliculo	malic'ul'o
maliculoj	malic'ul'o'j
maligna	malign'a
malignaj	malign'a'j
malone	malon'e
malta	malt'a
maltaj	malt'a'j
maltan	malt'a'n
malto	malt'o
malton	malt'o'n
maltano	malt'an'o
maltuso	maltus'o
malva	malv'a
malvacoj	malv'ac'o'j
malversacio	malversaci'o
malvinoj	malvin'o'j
mama	mam'a
mamaj	mam'a'j
maman	mam'a'n
mamo	mam'o
mamoj	mam'o'j
mamojn	mam'o'j'n
mamon	mam'o'n
mamakancera	mam'a'kancer'a
mambestoj	mam'best'o'j
mamkancero	mam'kancer'o
mamnutras	mam'nutr'as
mamnutri	mam'nutr'i
mamnutris	mam'nutr'is
mamnutrado	mam'nutr'ad'o
mamnutranta	mam'nutr'ant'a
mamnutrantaj	mam'nutr'ant'a'j
mamnutrantajn	mam'nutr'ant'a'j'n
mamsuĉas	mam'suĉ'as
mamula	mam'ul'a
mamulaj	mam'ul'a'j
mamulo	mam'ul'o
mamuloj	mam'ul'o'j
mamulojn	mam'ul'o'j'n
mamulviando	mam'ul'viand'o
mamzono	mam'zon'o
mamzonoj	mam'zon'o'j
mamzonon	mam'zon'o'n
mamono	mamon'o
mamuta	mamut'a
mamuto	mamut'o
mamutoj	mamut'o'j
mana	man'a
manaj	man'a'j
manajn	man'a'j'n
manan	man'a'n
mane	man'e
mani	man'i
mano	man'o
manoj	man'o'j
manojn	man'o'j'n
manon	man'o'n
manartiko	man'artik'o
manbatalo	man'batal'o
mandorso	man'dors'o
manenmane	man'en'man'e
maneto	man'et'o
manetoj	man'et'o'j
manetojn	man'et'o'j'n
maneton	man'et'o'n
manfarado	man'far'ad'o
manfarita	man'far'it'a
manfaritaj	man'far'it'a'j
manfaritajn	man'far'it'a'j'n
manfaritaĵo	man'far'it'aĵ'o
manfaritaĵoj	man'far'it'aĵ'o'j
mankatenoj	man'katen'o'j
mankatenojn	man'katen'o'j'n
mankatenita	man'katen'it'a
mankluĉilo	man'kluĉ'il'o
manlaboro	man'labor'o
manlaboroj	man'labor'o'j
manlaboron	man'labor'o'n
manlaboristoj	man'labor'ist'o'j
manlavado	man'lav'ad'o
manlibro	man'libr'o
manlibroj	man'libr'o'j
manlibrojn	man'libr'o'j'n
manlibron	man'libr'o'n
manpafiloj	man'paf'il'o'j
manpilkado	man'pilk'ad'o
manplato	man'plat'o
manplatoj	man'plat'o'j
manplatojn	man'plat'o'j'n
manplaton	man'plat'o'n
manpleno	man'plen'o
manplenon	man'plen'o'n
manpremas	man'prem'as
manpremi	man'prem'i
manpremis	man'prem'is
manpremo	man'prem'o
manpremoj	man'prem'o'j
manpremon	man'prem'o'n
manradiko	man'radik'o
manradikon	man'radik'o'n
manrelo	man'rel'o
mansako	man'sak'o
mansakon	man'sak'o'n
mansaketo	man'sak'et'o
mansaketon	man'sak'et'o'n
mansalutas	man'salut'as
mansalutante	man'salut'ant'e
mansigna	man'sign'a
mansignas	man'sign'as
mansignis	man'sign'is
mansigno	man'sign'o
manskribo	man'skrib'o
manskribon	man'skrib'o'n
manskribaĵo	man'skrib'aĵ'o
manskribaĵoj	man'skrib'aĵ'o'j
manskribita	man'skrib'it'a
manskribitaj	man'skrib'it'a'j
manskribitan	man'skrib'it'a'n
mansurmeto	man'sur'met'o
mansvingas	man'sving'as
mansvingis	man'sving'is
mantenebla	man'ten'ebl'a
manteneblaj	man'ten'ebl'a'j
mantuko	man'tuk'o
mantukoj	man'tuk'o'j
mantukojn	man'tuk'o'j'n
mantukon	man'tuk'o'n
manumi	man'um'i
manumo	man'um'o
manumoj	man'um'o'j
manumojn	man'um'o'j'n
manao	mana'o
manaĝera	manaĝer'a
manaĝeraj	manaĝer'a'j
manaĝerajn	manaĝer'a'j'n
manaĝero	manaĝer'o
manaĝeroj	manaĝer'o'j
manaĝerojn	manaĝer'o'j'n
manaĝeron	manaĝer'o'n
manaĝerado	manaĝer'ad'o
manaĝerteamo	manaĝer'team'o
manaĝisto	manaĝist'o
manatoj	manat'o'j
manĉestro	manĉestr'o
manĉura	manĉur'a
manĉuraj	manĉur'a'j
manĉuran	manĉur'a'n
manĉuroj	manĉur'o'j
manĉurio	manĉur'i'o
mandalo	mandal'o
mandarena	mandaren'a
mandarenan	mandaren'a'n
mandareno	mandaren'o
mandarenoj	mandaren'o'j
mandarenon	mandaren'o'n
mandarenanasoj	mandaren'anas'o'j
mandarina	mandarin'a
mandarino	mandarin'o
mandarinoj	mandarin'o'j
mandate	mandat'e
mandato	mandat'o
mandatoj	mandat'o'j
mandatojn	mandat'o'j'n
mandaton	mandat'o'n
mandatperiodo	mandat'period'o
mandatulo	mandat'ul'o
mandatuloj	mandat'ul'o'j
mandiblo	mandibl'o
mandibloj	mandibl'o'j
mandiblojn	mandibl'o'j'n
mandolino	mandolin'o
manekeno	maneken'o
manekenoj	maneken'o'j
manetono	maneton'o
manga	mang'a
mango	mang'o
mangoj	mang'o'j
mangojn	mang'o'j'n
mangon	mang'o'n
mangao	manga'o
mangaoj	manga'o'j
mangaon	manga'o'n
mangana	mangan'a
mangano	mangan'o
manĝa	manĝ'a
manĝaj	manĝ'a'j
manĝas	manĝ'as
manĝi	manĝ'i
manĝis	manĝ'is
mangho	manĝ'o
manĝo	manĝ'o
manĝoj	manĝ'o'j
manĝojn	manĝ'o'j'n
manĝon	manĝ'o'n
manĝos	manĝ'os
manĝu	manĝ'u
manĝus	manĝ'us
manĝadas	manĝ'ad'as
manĝadi	manĝ'ad'i
manĝadis	manĝ'ad'is
manghado	manĝ'ad'o
manĝado	manĝ'ad'o
manĝadon	manĝ'ad'o'n
manĝaĵa	manĝ'aĵ'a
manĝaĵaj	manĝ'aĵ'a'j
manĝaĵan	manĝ'aĵ'a'n
manĝaĵo	manĝ'aĵ'o
manĝaĵoj	manĝ'aĵ'o'j
manĝaĵojn	manĝ'aĵ'o'j'n
manĝaĵon	manĝ'aĵ'o'n
manĝaĵmalabundoj	manĝ'aĵ'mal'abund'o'j
manĝaĵoprezoj	manĝ'aĵ'o'prez'o'j
manĝaĵprezoj	manĝ'aĵ'prez'o'j
manĝaĵproduktado	manĝ'aĵ'produkt'ad'o
manĝaĵproduktadon	manĝ'aĵ'produkt'ad'o'n
manĝaĵprovizado	manĝ'aĵ'proviz'ad'o
manĝaĵprovizadoj	manĝ'aĵ'proviz'ad'o'j
manĝaĵprovizadon	manĝ'aĵ'proviz'ad'o'n
manĝaĵrubo	manĝ'aĵ'rub'o
manĝaĵsekureco	manĝ'aĵ'sekur'ec'o
manĝaldonaĵoj	manĝ'al'don'aĵ'o'j
manĝanta	manĝ'ant'a
manĝantaj	manĝ'ant'a'j
manĝantajn	manĝ'ant'a'j'n
manĝantan	manĝ'ant'a'n
manĝantas	manĝ'ant'as
manĝante	manĝ'ant'e
manĝanto	manĝ'ant'o
manĝantoj	manĝ'ant'o'j
manĝata	manĝ'at'a
manĝataj	manĝ'at'a'j
manĝbastonetoj	manĝ'baston'et'o'j
manĝbastonetojn	manĝ'baston'et'o'j'n
manĝbutikoj	manĝ'butik'o'j
manĝebla	manĝ'ebl'a
manĝeblaj	manĝ'ebl'a'j
manĝeblajn	manĝ'ebl'a'j'n
manĝeblan	manĝ'ebl'a'n
manĝeblas	manĝ'ebl'as
manĝegas	manĝ'eg'as
manĝegis	manĝ'eg'is
manĝejo	manĝ'ej'o
manĝejoj	manĝ'ej'o'j
manĝejojn	manĝ'ej'o'j'n
manĝejon	manĝ'ej'o'n
manĝema	manĝ'em'a
manĝeroj	manĝ'er'o'j
manĝerojn	manĝ'er'o'j'n
manĝeti	manĝ'et'i
manĝetis	manĝ'et'is
manĝeto	manĝ'et'o
manĝetoj	manĝ'et'o'j
manĝetojn	manĝ'et'o'j'n
manĝeton	manĝ'et'o'n
manĝhavebleco	manĝ'hav'ebl'ec'o
manĝigas	manĝ'ig'as
manĝigi	manĝ'ig'i
manĝigis	manĝ'ig'is
manĝigo	manĝ'ig'o
manĝigon	manĝ'ig'o'n
manĝigos	manĝ'ig'os
manĝigu	manĝ'ig'u
manĝigado	manĝ'ig'ad'o
manĝigataj	manĝ'ig'at'a'j
manĝiloj	manĝ'il'o'j
manĝilojn	manĝ'il'o'j'n
manĝilaro	manĝ'il'ar'o
manĝilaron	manĝ'il'ar'o'n
manĝinta	manĝ'int'a
manĝintaj	manĝ'int'a'j
manĝinte	manĝ'int'e
manĝita	manĝ'it'a
manĝitaj	manĝ'it'a'j
manĝkultivaĵoj	manĝ'kultiv'aĵ'o'j
manĝkutimoj	manĝ'kutim'o'j
manĝkutimojn	manĝ'kutim'o'j'n
manĝoĉambro	manĝ'o'ĉambr'o
manĝoĉambron	manĝ'o'ĉambr'o'n
manĝodisponeblo	manĝ'o'dispon'ebl'o
manĝofonto	manĝ'o'font'o
manĝokutimoj	manĝ'o'kutim'o'j
manĝosalono	manĝ'o'salon'o
manĝotablo	manĝ'o'tabl'o
manĝotablon	manĝ'o'tabl'o'n
manĝonta	manĝ'ont'a
manĝpreparo	manĝ'prepar'o
manĝreto	manĝ'ret'o
manĝretoj	manĝ'ret'o'j
manĝujo	manĝ'uj'o
manĝvagono	manĝ'vagon'o
manĝvagonon	manĝ'vagon'o'n
manĝvaroj	manĝ'var'o'j
manĝvarojn	manĝ'var'o'j'n
mania	mani'a
manie	mani'e
manio	mani'o
manion	mani'o'n
maniulo	mani'ul'o
maniera	manier'a
maniere	manier'e
maniero	manier'o
manieroj	manier'o'j
manierojn	manier'o'j'n
manieron	manier'o'n
manieraĵoj	manier'aĵ'o'j
manierismo	manier'ism'o
manifesta	manifest'a
manifestaj	manifest'a'j
manifestas	manifest'as
manifesti	manifest'i
manifestis	manifest'is
manifesto	manifest'o
manifestoj	manifest'o'j
manifestojn	manifest'o'j'n
manifeston	manifest'o'n
manifestos	manifest'os
manifestado	manifest'ad'o
manifestaĵo	manifest'aĵ'o
manifestaĵoj	manifest'aĵ'o'j
manifestante	manifest'ant'e
manifestigi	manifest'ig'i
manifestigita	manifest'ig'it'a
manifestiĝas	manifest'iĝ'as
manifestiĝi	manifest'iĝ'i
manifestiĝis	manifest'iĝ'is
manifestiĝo	manifest'iĝ'o
manifestiĝoj	manifest'iĝ'o'j
manifestiĝojn	manifest'iĝ'o'j'n
manifestiĝon	manifest'iĝ'o'n
manifestita	manifest'it'a
manifestitaj	manifest'it'a'j
manifestacias	manifestaci'as
manifestacii	manifestaci'i
manifestaciis	manifestaci'is
manifestacio	manifestaci'o
manifestacioj	manifestaci'o'j
manifestaciojn	manifestaci'o'j'n
manifestacion	manifestaci'o'n
manifestacianoj	manifestaci'an'o'j
manifestacianojn	manifestaci'an'o'j'n
manifestaciantoj	manifestaci'ant'o'j
manifestaciantojn	manifestaci'ant'o'j'n
maniĥeismo	maniĥe'ism'o
manika	manik'a
maniko	manik'o
manikoj	manik'o'j
manikojn	manik'o'j'n
manikon	manik'o'n
manikeismo	manike'ism'o
manila	manil'a
manilo	manil'o
maniloj	manil'o'j
manioko	maniok'o
manipula	manipul'a
manipulas	manipul'as
manipuli	manipul'i
manipulis	manipul'is
manipulo	manipul'o
manipulojn	manipul'o'j'n
manipulu	manipul'u
manipulado	manipul'ad'o
manipuladoj	manipul'ad'o'j
manipuladojn	manipul'ad'o'j'n
manipuladon	manipul'ad'o'n
manipulantaj	manipul'ant'a'j
manipulante	manipul'ant'e
manipulata	manipul'at'a
manipulataj	manipul'at'a'j
manipulebla	manipul'ebl'a
manipuleblaj	manipul'ebl'a'j
manipulita	manipul'it'a
manipulitaj	manipul'it'a'j
manipulatoro	manipulator'o
manipuro	manipur'o
manja	manj'a
manka	mank'a
mankaj	mank'a'j
mankas	mank'as
manke	mank'e
manki	mank'i
mankis	mank'is
manko	mank'o
mankoj	mank'o'j
mankojn	mank'o'j'n
mankon	mank'o'n
mankos	mank'os
manku	mank'u
mankus	mank'us
mankanta	mank'ant'a
mankantaj	mank'ant'a'j
mankantajn	mank'ant'a'j'n
mankantan	mank'ant'a'n
mankante	mank'ant'e
mankhava	mank'hav'a
mankhavaj	mank'hav'a'j
mankhavan	mank'hav'a'n
mankinta	mank'int'a
mankohava	mank'o'hav'a
manometro	manometr'o
manovra	manovr'a
manovran	manovr'a'n
manovras	manovr'as
manovri	manovr'i
manovris	manovr'is
manovro	manovr'o
manovroj	manovr'o'j
manovrojn	manovr'o'j'n
manovron	manovr'o'n
manovrado	manovr'ad'o
manovrebla	manovr'ebl'a
manovreblaj	manovr'ebl'a'j
manovrita	manovr'it'a
mansarda	mansard'a
mansardo	mansard'o
mansardoj	mansard'o'j
mansardon	mansard'o'n
manto	mant'o
mantelo	mantel'o
manteloj	mantel'o'j
mantelojn	mantel'o'j'n
mantelon	mantel'o'n
mantinea	mantine'a
mantineo	mantine'o
mantoo	manto'o
mantovo	mantov'o
mantro	mantr'o
mantroj	mantr'o'j
mantrojn	mantr'o'j'n
mantron	mantr'o'n
mantuo	mantu'o
manuela	manuel'a
manuelo	manuel'o
manufakturo	manufaktur'o
manufakturoj	manufaktur'o'j
manufakturado	manufaktur'ad'o
manufaktursektoro	manufaktur'sektor'o
manuskripta	manuskript'a
manuskriptaj	manuskript'a'j
manuskripto	manuskript'o
manuskriptoj	manuskript'o'j
manuskriptojn	manuskript'o'j'n
manuskripton	manuskript'o'n
manuskriptinto	manuskript'int'o
manuskriptintoj	manuskript'int'o'j
manuskriptprovlegantoj	manuskript'prov'leg'ant'o'j
maoria	maori'a
maorioj	maori'o'j
mapa	map'a
mapas	map'as
mapi	map'i
mapis	map'is
mapo	map'o
mapoj	map'o'j
mapojn	map'o'j'n
mapon	map'o'n
mapado	map'ad'o
mapadoj	map'ad'o'j
mapadon	map'ad'o'n
mapanta	map'ant'a
mapante	map'ant'e
mapita	map'it'a
mapitaj	map'it'a'j
mara	mar'a
maraj	mar'a'j
marajn	mar'a'j'n
maran	mar'a'n
mare	mar'e
maren	mar'e'n
maro	mar'o
maroj	mar'o'j
marojn	mar'o'j'n
maron	mar'o'n
maraglo	mar'agl'o
maragloj	mar'agl'o'j
marakvo	mar'akv'o
marakvon	mar'akv'o'n
mararmea	mar'arme'a
mararmeaj	mar'arme'a'j
mararmeo	mar'arme'o
mararmeoj	mar'arme'o'j
mararmeon	mar'arme'o'n
marbatalo	mar'batal'o
marbestoj	mar'best'o'j
marbirdo	mar'bird'o
marbirdoj	mar'bird'o'j
marborda	mar'bord'a
marbordaj	mar'bord'a'j
marbordajn	mar'bord'a'j'n
marbordan	mar'bord'a'n
marborde	mar'bord'e
marborden	mar'bord'e'n
marbordo	mar'bord'o
marbordoj	mar'bord'o'j
marbordojn	mar'bord'o'j'n
marbordon	mar'bord'o'n
marbordogardistaro	mar'bord'o'gard'ist'ar'o
mareltena	mar'el'ten'a
mareltenaj	mar'el'ten'a'j
marelefantoj	mar'elefant'o'j
marfluo	mar'flu'o
marfluoj	mar'flu'o'j
marfruktoj	mar'frukt'o'j
marfruktojn	mar'frukt'o'j'n
marfundo	mar'fund'o
marfundoj	mar'fund'o'j
marfundon	mar'fund'o'n
marhaveno	mar'haven'o
marinfanterio	mar'infanteri'o
marista	mar'ist'a
maristaj	mar'ist'a'j
maristan	mar'ist'a'n
maristo	mar'ist'o
maristoj	mar'ist'o'j
maristojn	mar'ist'o'j'n
mariston	mar'ist'o'n
maristaro	mar'ist'ar'o
markolo	mar'kol'o
markoloj	mar'kol'o'j
markolon	mar'kol'o'n
markomerco	mar'komerc'o
marleono	mar'leon'o
marleonoj	mar'leon'o'j
marlutro	mar'lutr'o
marlutroj	mar'lutr'o'j
marmalsano	mar'mal'san'o
marmanĝaĵo	mar'manĝ'aĵ'o
marnivelo	mar'nivel'o
marniveloj	mar'nivel'o'j
marnivelpliiĝo	mar'nivel'pli'iĝ'o
marondoj	mar'ond'o'j
marpotenco	mar'potenc'o
marsoldata	mar'soldat'a
marsoldato	mar'soldat'o
marsoldatoj	mar'soldat'o'j
marsoldatojn	mar'soldat'o'j'n
marsteloj	mar'stel'o'j
marsurfaco	mar'surfac'o
martestudo	mar'testud'o
martestudoj	mar'testud'o'j
martrupo	mar'trup'o
marvirino	mar'vir'in'o
marvojo	mar'voj'o
marvojoj	mar'voj'o'j
marvojaĝo	mar'vojaĝ'o
maranjo	maranj'o
marasmo	marasm'o
maratona	maraton'a
maratono	maraton'o
maratonon	maraton'o'n
marcelo	marcel'o
marciono	marcion'o
marcipano	marcipan'o
marĉa	marĉ'a
marĉaj	marĉ'a'j
marĉajn	marĉ'a'j'n
marĉan	marĉ'a'n
marĉo	marĉ'o
marĉoj	marĉ'o'j
marĉojn	marĉ'o'j'n
marĉon	marĉ'o'n
marĉarbaroj	marĉ'arb'ar'o'j
marĉejo	marĉ'ej'o
marĉejoj	marĉ'ej'o'j
marĉeto	marĉ'et'o
marĉandas	marĉand'as
marĉandi	marĉand'i
marĉandis	marĉand'is
marĉando	marĉand'o
marĉandado	marĉand'ad'o
marda	mard'a
marde	mard'e
mardo	mard'o
mardon	mard'o'n
margarino	margarin'o
margarinon	margarin'o'n
margrafo	margraf'o
margraflando	margraf'land'o
marĝena	marĝen'a
marĝenaj	marĝen'a'j
marĝenajn	marĝen'a'j'n
marĝenan	marĝen'a'n
marĝene	marĝen'e
marĝeno	marĝen'o
marĝenoj	marĝen'o'j
marĝenojn	marĝen'o'j'n
marĝenon	marĝen'o'n
marĝenigi	marĝen'ig'i
marĝenigis	marĝen'ig'is
marĝenigo	marĝen'ig'o
marĝenigita	marĝen'ig'it'a
marĝenigitaj	marĝen'ig'it'a'j
marĝenuloj	marĝen'ul'o'j
maria	mari'a
mariaj	mari'a'j
marian	mari'a'n
mario	mari'o
marion	mari'o'n
mariana	mari'an'a
mariano	mari'an'o
marianoj	mari'an'o'j
mariino	mari'in'o
marilando	mari'land'o
mariologio	mari'olog'i'o
mariana	marian'a
mariano	marian'o
marina	marin'a
marine	marin'e
marino	marin'o
marioneta	marionet'a
marioneto	marionet'o
marionetoj	marionet'o'j
marionetojn	marionet'o'j'n
marioneton	marionet'o'n
marka	mark'a
markaj	mark'a'j
markan	mark'a'n
markas	mark'as
marki	mark'i
markis	mark'is
marko	mark'o
markoj	mark'o'j
markojn	mark'o'j'n
markon	mark'o'n
markos	mark'os
marku	mark'u
markus	mark'us
markado	mark'ad'o
markadoj	mark'ad'o'j
markadojn	mark'ad'o'j'n
markadon	mark'ad'o'n
markaĵoj	mark'aĵ'o'j
markanta	mark'ant'a
markantan	mark'ant'a'n
markante	mark'ant'e
markata	mark'at'a
markataj	mark'at'a'j
markatan	mark'at'a'n
markate	mark'at'e
markio	mark'i'o
markigo	mark'ig'o
markigon	mark'ig'o'n
markilo	mark'il'o
markiloj	mark'il'o'j
markita	mark'it'a
markitaj	mark'it'a'j
markitajn	mark'it'a'j'n
markitan	mark'it'a'n
markite	mark'it'e
markonomo	mark'o'nom'o
markonomoj	mark'o'nom'o'j
markostampo	mark'o'stamp'o
markostampoj	mark'o'stamp'o'j
markonomon	mark'onom'o'n
markezo	markez'o
markezoj	markez'o'j
markiono	markion'o
markizo	markiz'o
markizino	markiz'in'o
markovĉeno	markov'ĉen'o
markso	marks'o
marksisma	marks'ism'a
marksismaj	marks'ism'a'j
marksisman	marks'ism'a'n
marksismo	marks'ism'o
marksismon	marks'ism'o'n
marksismoleninismo	marks'ism'o'lenin'ism'o
marksista	marks'ist'a
marksistaj	marks'ist'a'j
marksisto	marks'ist'o
marksistoj	marks'ist'o'j
marksistleninista	marks'ist'lenin'ist'a
marmelado	marmelad'o
marmeladon	marmelad'o'n
marmora	marmor'a
marmoraj	marmor'a'j
marmorajn	marmor'a'j'n
marmoran	marmor'a'n
marmoro	marmor'o
marmoroj	marmor'o'j
marmoron	marmor'o'n
marmoto	marmot'o
marmotoj	marmot'o'j
marne	marn'e
marno	marn'o
maroka	marok'a
marokaj	marok'a'j
marokajn	marok'a'j'n
marokan	marok'a'n
maroko	marok'o
marokon	marok'o'n
marokano	marok'an'o
marokanoj	marok'an'o'j
maronita	maronit'a
maronitoj	maronit'o'j
marsa	mars'a
marsaj	mars'a'j
marsan	mars'a'n
marso	mars'o
marson	mars'o'n
marsano	mars'an'o
marsanoj	mars'an'o'j
marsrenkonta	mars'renkont'a
marsilio	marsili'o
marsupiuloj	marsupi'ul'o'j
marŝas	marŝ'as
marŝi	marŝ'i
marŝis	marŝ'is
marŝo	marŝ'o
marŝoj	marŝ'o'j
marŝojn	marŝ'o'j'n
marŝon	marŝ'o'n
marŝos	marŝ'os
marŝu	marŝ'u
marŝus	marŝ'us
marŝadi	marŝ'ad'i
marŝadis	marŝ'ad'is
marŝado	marŝ'ad'o
marŝadon	marŝ'ad'o'n
marŝanta	marŝ'ant'a
marŝantaj	marŝ'ant'a'j
marŝantan	marŝ'ant'a'n
marŝante	marŝ'ant'e
marŝantoj	marŝ'ant'o'j
marŝinte	marŝ'int'e
marŝala	marŝal'a
marŝalo	marŝal'o
marŝaloj	marŝal'o'j
marta	mart'a
martan	mart'a'n
marte	mart'e
marto	mart'o
martoj	mart'o'j
marton	mart'o'n
martelas	martel'as
martelis	martel'is
martelo	martel'o
marteloj	martel'o'j
martelojn	martel'o'j'n
martelon	martel'o'n
martelado	martel'ad'o
marteladon	martel'ad'o'n
martelita	martel'it'a
martelmonto	martel'mont'o
marteno	marten'o
marteso	martes'o
martiniko	martinik'o
martira	martir'a
martiro	martir'o
martiroj	martir'o'j
martirojn	martir'o'j'n
martireco	martir'ec'o
martirecon	martir'ec'o'n
martirigita	martir'ig'it'a
martirigitaj	martir'ig'it'a'j
martiriĝo	martir'iĝ'o
martiriĝon	martir'iĝ'o'n
masa	mas'a
masan	mas'a'n
maso	mas'o
masoj	mas'o'j
masojn	mas'o'j'n
mason	mas'o'n
masdenseco	mas'dens'ec'o
masocentro	mas'o'centr'o
maspunktoj	mas'punkt'o'j
masspektrogramo	mas'spektrogram'o
masaĉuseca	masaĉusec'a
masaĉuseco	masaĉusec'o
masaĝas	masaĝ'as
masaĝi	masaĝ'i
masaĝis	masaĝ'is
masaĝo	masaĝ'o
masaĝoj	masaĝ'o'j
masaĝon	masaĝ'o'n
masakri	masakr'i
masakris	masakr'is
masakro	masakr'o
masakroj	masakr'o'j
masakrojn	masakr'o'j'n
masakron	masakr'o'n
masakrita	masakr'it'a
masakritaj	masakr'it'a'j
masero	maser'o
masiva	masiv'a
masivaj	masiv'a'j
masivajn	masiv'a'j'n
masivan	masiv'a'n
masive	masiv'e
masivo	masiv'o
masivoj	masiv'o'j
maskas	mask'as
maski	mask'i
maskis	mask'is
masko	mask'o
maskoj	mask'o'j
maskojn	mask'o'j'n
maskon	mask'o'n
maskado	mask'ad'o
maskato	mask'at'o
maskita	mask'it'a
maskitaj	mask'it'a'j
maskobalo	mask'o'bal'o
maskerado	maskerad'o
maskla	maskl'a
masklaj	maskl'a'j
masklajn	maskl'a'j'n
masklan	maskl'a'n
masklo	maskl'o
maskloj	maskl'o'j
masklojn	maskl'o'j'n
masklon	maskl'o'n
maskoto	maskot'o
maskotoj	maskot'o'j
masoĥismo	masoĥ'ism'o
masoĥisto	masoĥ'ist'o
masoni	mason'i
masonado	mason'ad'o
masonaĵo	mason'aĵ'o
masonaĵon	mason'aĵ'o'n
masonisto	mason'ist'o
masonistoj	mason'ist'o'j
masonita	mason'it'a
masonitaj	mason'it'a'j
masora	masor'a
masto	mast'o
mastoj	mast'o'j
mastojn	mast'o'j'n
maston	mast'o'n
mastiko	mastik'o
mastra	mastr'a
mastras	mastr'as
mastri	mastr'i
mastris	mastr'is
mastro	mastr'o
mastroj	mastr'o'j
mastrojn	mastr'o'j'n
mastron	mastr'o'n
mastrado	mastr'ad'o
mastrino	mastr'in'o
mastrinoj	mastr'in'o'j
mastrinon	mastr'in'o'n
mastrokomputilo	mastr'o'komput'il'o
mastruma	mastr'um'a
mastrumaj	mastr'um'a'j
mastrumajn	mastr'um'a'j'n
mastruman	mastr'um'a'n
mastrumas	mastr'um'as
mastrumi	mastr'um'i
mastrumis	mastr'um'is
mastrumo	mastr'um'o
mastrumado	mastr'um'ad'o
mastrumadon	mastr'um'ad'o'n
mastrumaĵo	mastr'um'aĵ'o
mastrumanto	mastr'um'ant'o
mastrumata	mastr'um'at'a
mastrumistino	mastr'um'ist'in'o
mastriĥto	mastriĥt'o
masturbas	masturb'as
masturbi	masturb'i
masturbado	masturb'ad'o
maŝa	maŝ'a
maŝo	maŝ'o
maŝoj	maŝ'o'j
maŝojn	maŝ'o'j'n
maŝon	maŝ'o'n
maŝina	maŝin'a
maŝinaj	maŝin'a'j
maŝinan	maŝin'a'n
maŝine	maŝin'e
mashino	maŝin'o
maŝino	maŝin'o
mashinoj	maŝin'o'j
maŝinoj	maŝin'o'j
maŝinojn	maŝin'o'j'n
mashinon	maŝin'o'n
maŝinon	maŝin'o'n
maŝinado	maŝin'ad'o
maŝinaro	maŝin'ar'o
maŝinaron	maŝin'ar'o'n
maŝinejo	maŝin'ej'o
maŝiniloj	maŝin'il'o'j
maŝinindustrio	maŝin'industri'o
mashinisto	maŝin'ist'o
maŝinisto	maŝin'ist'o
maŝinkodo	maŝin'kod'o
maŝinkonstruado	maŝin'konstru'ad'o
maŝinlegebla	maŝin'leg'ebl'a
maŝinlernado	maŝin'lern'ad'o
maŝinpafado	maŝin'paf'ad'o
maŝinpafilo	maŝin'paf'il'o
maŝinpafiloj	maŝin'paf'il'o'j
maŝinpafilojn	maŝin'paf'il'o'j'n
maŝinpafilon	maŝin'paf'il'o'n
maŝinprilabora	maŝin'pri'labor'a
maŝinprilaboraj	maŝin'pri'labor'a'j
maŝinprilaborita	maŝin'pri'labor'it'a
maŝinprilaboritaj	maŝin'pri'labor'it'a'j
maŝinskribita	maŝin'skrib'it'a
maŝinskribitaj	maŝin'skrib'it'a'j
maŝintradukado	maŝin'traduk'ad'o
maŝintradukadon	maŝin'traduk'ad'o'n
mata	mat'a
mato	mat'o
matoj	mat'o'j
matojn	mat'o'j'n
maton	mat'o'n
matroso	mat'ros'o
matadoro	matador'o
matĉo	matĉ'o
matĉoj	matĉ'o'j
matĉojn	matĉ'o'j'n
matĉon	matĉ'o'n
mateo	mate'o
mateon	mate'o'n
matematika	matematik'a
matematikaj	matematik'a'j
matematikajn	matematik'a'j'n
matematikan	matematik'a'n
matematike	matematik'e
matematiko	matematik'o
matematikoj	matematik'o'j
matematikon	matematik'o'n
matematikisto	matematik'ist'o
matematikistoj	matematik'ist'o'j
matematikistojn	matematik'ist'o'j'n
matena	maten'a
matenaj	maten'a'j
matenajn	maten'a'j'n
matenan	maten'a'n
matene	maten'e
mateno	maten'o
matenoj	maten'o'j
matenojn	maten'o'j'n
matenon	maten'o'n
matenhoroj	maten'hor'o'j
mateniĝe	maten'iĝ'e
mateniĝo	maten'iĝ'o
matenkrepusko	maten'krepusk'o
matenmanĝa	maten'manĝ'a
matenmanĝas	maten'manĝ'as
matenmanĝi	maten'manĝ'i
matenmanĝis	maten'manĝ'is
matenmanĝo	maten'manĝ'o
matenmanĝon	maten'manĝ'o'n
matenmanĝos	maten'manĝ'os
matenmanĝu	maten'manĝ'u
matenruĝo	maten'ruĝ'o
matenuloj	maten'ul'o'j
materia	materi'a
materiaj	materi'a'j
materiajn	materi'a'j'n
materian	materi'a'n
materie	materi'e
materio	materi'o
materioj	materi'o'j
materiojn	materi'o'j'n
materion	materi'o'n
materieco	materi'ec'o
materiisma	materi'ism'a
materiismo	materi'ism'o
materiisto	materi'ist'o
materiistoj	materi'ist'o'j
materiofiziko	materi'o'fizik'o
materiala	material'a
materialaj	material'a'j
materialajn	material'a'j'n
materialan	material'a'n
materiale	material'e
materialo	material'o
materialoj	material'o'j
materialojn	material'o'j'n
materialon	material'o'n
materialisma	material'ism'a
materialismaj	material'ism'a'j
materialismo	material'ism'o
materialismon	material'ism'o'n
materialistoj	material'ist'o'j
matraco	matrac'o
matracoj	matrac'o'j
matracojn	matrac'o'j'n
matracon	matrac'o'n
matraso	matras'o
matrica	matric'a
matrico	matric'o
matricoj	matric'o'j
matricojn	matric'o'j'n
matricon	matric'o'n
matrono	matron'o
matrosoj	matros'o'j
matura	matur'a
maturaj	matur'a'j
maturajn	matur'a'j'n
maturan	matur'a'n
maturas	matur'as
mature	matur'e
matureco	matur'ec'o
maturecon	matur'ec'o'n
maturigas	matur'ig'as
maturigi	matur'ig'i
maturigis	matur'ig'is
maturigo	matur'ig'o
maturigado	matur'ig'ad'o
maturigante	matur'ig'ant'e
maturigitaj	matur'ig'it'a'j
maturiĝas	matur'iĝ'as
maturiĝi	matur'iĝ'i
maturiĝis	matur'iĝ'is
maturiĝo	matur'iĝ'o
maturiĝon	matur'iĝ'o'n
maturiĝos	matur'iĝ'os
maturiĝado	matur'iĝ'ad'o
maturiĝanta	matur'iĝ'ant'a
maturiĝinta	matur'iĝ'int'a
maŭra	maŭr'a
maŭraj	maŭr'a'j
maŭro	maŭr'o
maŭroj	maŭr'o'j
maŭricia	maŭrici'a
maŭricio	maŭrici'o
maŭritanio	maŭritani'o
maŭzoleo	maŭzole'o
maŭzoleoj	maŭzole'o'j
maŭzoleon	maŭzole'o'n
mazdaismo	mazda'ism'o
mazuto	mazut'o
meandro	meandr'o
meandroj	meandr'o'j
mebli	mebl'i
meblo	mebl'o
mebloj	mebl'o'j
meblojn	mebl'o'j'n
meblon	mebl'o'n
meblaro	mebl'ar'o
meblaron	mebl'ar'o'n
meblisto	mebl'ist'o
meblita	mebl'it'a
meblitaj	mebl'it'a'j
mecenato	mecenat'o
mecenatoj	mecenat'o'j
meĉo	meĉ'o
meĉoj	meĉ'o'j
meĉon	meĉ'o'n
medan	med'a'n
medo	med'o
medoj	med'o'j
medalo	medal'o
medaloj	medal'o'j
medalojn	medal'o'j'n
medalon	medal'o'n
medalisto	medal'ist'o
medaliono	medalion'o
medalionon	medalion'o'n
medaljono	medaljon'o
medaljonoj	medaljon'o'j
medea	mede'a
media	medi'a
mediaj	medi'a'j
mediajn	medi'a'j'n
median	medi'a'n
medie	medi'e
medio	medi'o
medioj	medi'o'j
mediojn	medi'o'j'n
medion	medi'o'n
medicirkonstancoj	medi'cirkonstanc'o'j
medicirkonstancojn	medi'cirkonstanc'o'j'n
medifaktoroj	medi'faktor'o'j
medioprotekta	medi'o'protekt'a
medioprotekto	medi'o'protekt'o
medioprotektado	medi'o'protekt'ad'o
medipoluo	medi'polu'o
medipoluon	medi'polu'o'n
mediprotekta	medi'protekt'a
mediprotektaj	medi'protekt'a'j
mediprotektan	medi'protekt'a'n
mediprotekto	medi'protekt'o
mediprotektado	medi'protekt'ad'o
mediprotektadon	medi'protekt'ad'o'n
mediscienco	medi'scienc'o
meditemperaturo	medi'temperatur'o
mediacias	mediaci'as
mediacii	mediaci'i
mediaciis	mediaci'is
mediacio	mediaci'o
mediacianto	mediaci'ant'o
mediaciisto	mediaci'ist'o
mediaciistoj	mediaci'ist'o'j
mediaciita	mediaci'it'a
mediaciitaj	mediaci'it'a'j
mediala	medial'a
medialaj	medial'a'j
medialan	medial'a'n
mediale	medial'e
mediana	median'a
medianaj	median'a'j
mediano	median'o
mediatoj	mediat'o'j
mediatoro	mediator'o
medicina	medicin'a
medicinaj	medicin'a'j
medicinajn	medicin'a'j'n
medicinan	medicin'a'n
medicine	medicin'e
medicino	medicin'o
medicinoj	medicin'o'j
medicinon	medicin'o'n
medicinaĵo	medicin'aĵ'o
medicinaĵoj	medicin'aĵ'o'j
medicinarkivoj	medicin'arkiv'o'j
medicinfakultata	medicin'fakultat'a
medicinista	medicin'ist'a
medicinisto	medicin'ist'o
medicinistoj	medicin'ist'o'j
medikamenta	medikament'a
medikamentaj	medikament'a'j
medikamentajn	medikament'a'j'n
medikamentan	medikament'a'n
medikamento	medikament'o
medikamentoj	medikament'o'j
medikamentojn	medikament'o'j'n
medikamenton	medikament'o'n
medikamentenkorpigo	medikament'en'korp'ig'o
medina	medin'a
medino	medin'o
medita	medit'a
meditaj	medit'a'j
meditas	medit'as
medite	medit'e
mediti	medit'i
meditis	medit'is
medito	medit'o
meditoj	medit'o'j
meditojn	medit'o'j'n
mediton	medit'o'n
meditos	medit'os
meditu	medit'u
meditadis	medit'ad'is
meditado	medit'ad'o
meditadoj	medit'ad'o'j
meditadon	medit'ad'o'n
meditanta	medit'ant'a
meditante	medit'ant'e
meditema	medit'em'a
meditemaj	medit'em'a'j
mediteme	medit'em'e
mediteranea	mediterane'a
mediteraneaj	mediterane'a'j
mediteraneajn	mediterane'a'j'n
mediteranean	mediterane'a'n
mediteraneo	mediterane'o
mediteraneon	mediterane'o'n
mediumo	medium'o
mediumoj	medium'o'j
mediumeco	medium'ec'o
medolo	medol'o
medolon	medol'o'n
medolradioj	medol'radi'o'j
meduzo	meduz'o
meduzoj	meduz'o'j
meduzon	meduz'o'n
mefito	mefit'o
mefitoj	mefit'o'j
megafono	megafon'o
megalita	megalit'a
megalitaj	megalit'a'j
megalitoj	megalit'o'j
megero	meger'o
meĥanika	meĥanik'a
meĥanikaj	meĥanik'a'j
meĥanike	meĥanik'e
meĥaniko	meĥanik'o
meĥanikisto	meĥanik'ist'o
meĥanismo	meĥanism'o
meĥanismoj	meĥanism'o'j
meĥanismojn	meĥanism'o'j'n
meĥanismon	meĥanism'o'n
mejlo	mejl'o
mejloj	mejl'o'j
mejlojn	mejl'o'j'n
mejlon	mejl'o'n
mejloŝtono	mejl'o'ŝton'o
mejloŝtonoj	mejl'o'ŝton'o'j
mejloŝtonojn	mejl'o'ŝton'o'j'n
mejloŝtonon	mejl'o'ŝton'o'n
mekanika	mekanik'a
mekanikaj	mekanik'a'j
mekanikajn	mekanik'a'j'n
mekanikan	mekanik'a'n
mekanike	mekanik'e
mekaniko	mekanik'o
mekanikoj	mekanik'o'j
mekanikon	mekanik'o'n
mekanikaĵoj	mekanik'aĵ'o'j
mekanikigo	mekanik'ig'o
mekanikisto	mekanik'ist'o
mekanikistoj	mekanik'ist'o'j
mekanikiston	mekanik'ist'o'n
mekanismo	mekanism'o
mekanismoj	mekanism'o'j
mekanismojn	mekanism'o'j'n
mekanismon	mekanism'o'n
meksika	meksik'a
meksikaj	meksik'a'j
meksikajn	meksik'a'j'n
meksikan	meksik'a'n
meksiko	meksik'o
meksikon	meksik'o'n
meksikano	meksik'an'o
meksikanoj	meksik'an'o'j
meksikia	meksik'i'a
meksikiaj	meksik'i'a'j
meksikian	meksik'i'a'n
meksikio	meksik'i'o
meksikion	meksik'i'o'n
meksikianoj	meksik'i'an'o'j
meksikurbo	meksik'urb'o
mela	mel'a
melo	mel'o
meloj	mel'o'j
melojn	mel'o'j'n
melhundo	mel'hund'o
melamino	melamin'o
melanino	melanin'o
melankolia	melankoli'a
melankoliaj	melankoli'a'j
melankolian	melankoli'a'n
melankolie	melankoli'e
melankolio	melankoli'o
melankolion	melankoli'o'n
melanomo	melanom'o
melaso	melas'o
melatonino	melatonin'o
melduo	meldu'o
meleagro	meleagr'o
meleagroj	meleagr'o'j
meleagron	meleagr'o'n
meleagraĵo	meleagr'aĵ'o
melio	meli'o
melilo	melil'o
melkas	melk'as
melki	melk'i
melkis	melk'is
melku	melk'u
melkado	melk'ad'o
melkistino	melk'ist'in'o
melodia	melodi'a
melodiaj	melodi'a'j
melodiajn	melodi'a'j'n
melodian	melodi'a'n
melodie	melodi'e
melodio	melodi'o
melodioj	melodi'o'j
melodiojn	melodi'o'j'n
melodion	melodi'o'n
melodrama	melodram'a
melodramo	melodram'o
melono	melon'o
melonoj	melon'o'j
melonojn	melon'o'j'n
melonon	melon'o'n
melongeno	melongen'o
melongenoj	melongen'o'j
melongenojn	melongen'o'j'n
mem	mem
mema	mem'a
memo	mem'o
memoj	mem'o'j
memon	mem'o'n
memadjunkta	mem'adjunkt'a
memadjunktaj	mem'adjunkt'a'j
memadministrado	mem'administr'ad'o
memamo	mem'am'o
memasemblea	mem'asemble'a
membildo	mem'bild'o
membildon	mem'bild'o'n
membiografiaj	mem'biograf'i'a'j
membiografio	mem'biograf'i'o
membiografion	mem'biograf'i'o'n
memcenzuro	mem'cenzur'o
memcerta	mem'cert'a
memcertaj	mem'cert'a'j
memcerte	mem'cert'e
memdecida	mem'decid'a
memdecido	mem'decid'o
memdefendaj	mem'defend'a'j
memdefendo	mem'defend'o
memdefendon	mem'defend'o'n
memdeklarita	mem'deklar'it'a
memdeklaritaj	mem'deklar'it'a'j
memdetermino	mem'determin'o
memdeterminado	mem'determin'ad'o
memdetruan	mem'detru'a'n
memdetruo	mem'detru'o
memdifino	mem'difin'o
memdisciplino	mem'disciplin'o
memefikeco	mem'efik'ec'o
memelektita	mem'elekt'it'a
memestimo	mem'estim'o
memestimon	mem'estim'o'n
memevidenta	mem'evident'a
memevidentaj	mem'evident'a'j
memevidente	mem'evident'e
memfarita	mem'far'it'a
memfaritaj	mem'far'it'a'j
memfaritajn	mem'far'it'a'j'n
memfaritan	mem'far'it'a'n
memfekundigo	mem'fekund'ig'o
memfida	mem'fid'a
memfidaj	mem'fid'a'j
memfide	mem'fid'e
memfido	mem'fid'o
memfidon	mem'fid'o'n
memhelpa	mem'help'a
memhelpo	mem'help'o
memidentigas	mem'ident'ig'as
memidentigo	mem'ident'ig'o
memkomprene	mem'kompren'e
memkompreno	mem'kompren'o
memkomprenebla	mem'kompren'ebl'a
memkompreneblaj	mem'kompren'ebl'a'j
memkompreneble	mem'kompren'ebl'e
memkompreneblaĵo	mem'kompren'ebl'aĵ'o
memkonscia	mem'konsci'a
memkonsciaj	mem'konsci'a'j
memkonscie	mem'konsci'e
memkonscio	mem'konsci'o
memkonscion	mem'konsci'o'n
memkonservo	mem'konserv'o
memkontenta	mem'kontent'a
memkontento	mem'kontent'o
memkritiko	mem'kritik'o
memkritikon	mem'kritik'o'n
memkulturado	mem'kultur'ad'o
memlerni	mem'lern'i
memlernis	mem'lern'is
memlernado	mem'lern'ad'o
memlernanto	mem'lern'ant'o
memlernantoj	mem'lern'ant'o'j
memmontrado	mem'montr'ad'o
memmortiga	mem'mort'ig'a
memmortigi	mem'mort'ig'i
memmortigis	mem'mort'ig'is
memmortigo	mem'mort'ig'o
memmortigoj	mem'mort'ig'o'j
memmortigon	mem'mort'ig'o'n
memorganizado	mem'organiz'ad'o
memplibonigo	mem'pli'bon'ig'o
memportreto	mem'portret'o
mempriskribita	mem'pri'skrib'it'a
memprofito	mem'profit'o
memproklamita	mem'proklam'it'a
memproviza	mem'proviz'a
memprovizaj	mem'proviz'a'j
memresanigo	mem're'san'ig'o
memrega	mem'reg'a
memregon	mem'reg'o'n
memregado	mem'reg'ad'o
memregadon	mem'reg'ad'o'n
memreguliga	mem'regul'ig'a
memreguligado	mem'regul'ig'ad'o
memrespekto	mem'respekt'o
memrespekton	mem'respekt'o'n
memserva	mem'serv'a
memservejo	mem'serv'ej'o
memstara	mem'star'a
memstaraj	mem'star'a'j
memstarajn	mem'star'a'j'n
memstaran	mem'star'a'n
memstare	mem'star'e
memstareco	mem'star'ec'o
memstarecon	mem'star'ec'o'n
memstudado	mem'stud'ad'o
memsubtena	mem'sub'ten'a
memsubtenan	mem'sub'ten'a'n
memsufiĉa	mem'sufiĉ'a
memsufiĉaj	mem'sufiĉ'a'j
memsufiĉeco	mem'sufiĉ'ec'o
memtakso	mem'taks'o
memtrompo	mem'tromp'o
memvaloro	mem'valor'o
memvetura	mem'vetur'a
memveturaj	mem'vetur'a'j
memvola	mem'vol'a
memvole	mem'vol'e
memzorga	mem'zorg'a
memzorgado	mem'zorg'ad'o
membra	membr'a
membraj	membr'a'j
membras	membr'as
membri	membr'i
membris	membr'is
membro	membr'o
membroj	membr'o'j
membrojn	membr'o'j'n
membron	membr'o'n
membraro	membr'ar'o
membraron	membr'ar'o'n
membreco	membr'ec'o
membrecoj	membr'ec'o'j
membrecon	membr'ec'o'n
membrigas	membr'ig'as
membrigi	membr'ig'i
membrigis	membr'ig'is
membrigado	membr'ig'ad'o
membrigita	membr'ig'it'a
membrigitaj	membr'ig'it'a'j
membriĝas	membr'iĝ'as
membriĝi	membr'iĝ'i
membriĝis	membr'iĝ'is
membrigho	membr'iĝ'o
membriĝo	membr'iĝ'o
membriĝon	membr'iĝ'o'n
membrino	membr'in'o
membroasocioj	membr'o'asoci'o'j
membrofalo	membr'o'fal'o
membrokarto	membr'o'kart'o
membrokarton	membr'o'kart'o'n
membrokategorioj	membr'o'kategori'o'j
membrokotizo	membr'o'kotiz'o
membrokotizoj	membr'o'kotiz'o'j
membrokotizojn	membr'o'kotiz'o'j'n
membrokotizon	membr'o'kotiz'o'n
membrokunveno	membr'o'kun'ven'o
membrokvanto	membr'o'kvant'o
membrolando	membr'o'land'o
membrolandoj	membr'o'land'o'j
membrolandojn	membr'o'land'o'j'n
membronacioj	membr'o'naci'o'j
membronombro	membr'o'nombr'o
membronombroj	membr'o'nombr'o'j
membroorganizoj	membr'o'organiz'o'j
membroŝtato	membr'o'ŝtat'o
membroŝtatoj	membr'o'ŝtat'o'j
membroŝtatojn	membr'o'ŝtat'o'j'n
membrojabonantoj	membr'oj'abon'ant'o'j
membronombron	membr'onombr'o'n
membrana	membran'a
membranaj	membran'a'j
membrano	membran'o
membranoj	membran'o'j
membranojn	membran'o'j'n
membranon	membran'o'n
membranpotencialo	membran'potencial'o
membranproteinoj	membran'protein'o'j
memora	memor'a
memoraj	memor'a'j
memoras	memor'as
memore	memor'e
memori	memor'i
memoris	memor'is
memoro	memor'o
memoroj	memor'o'j
memorojn	memor'o'j'n
memoron	memor'o'n
memoros	memor'os
memoru	memor'u
memorus	memor'us
memorado	memor'ad'o
memoraĵo	memor'aĵ'o
memoraĵoj	memor'aĵ'o'j
memoraĵojn	memor'aĵ'o'j'n
memoraĵon	memor'aĵ'o'n
memoranta	memor'ant'a
memorante	memor'ant'e
memorata	memor'at'a
memorataj	memor'at'a'j
memorceremonio	memor'ceremoni'o
memorĉeloj	memor'ĉel'o'j
memorebla	memor'ebl'a
memoreblaj	memor'ebl'a'j
memorejo	memor'ej'o
memorfiksi	memor'fiks'i
memorfiksu	memor'fiks'u
memorhalo	memor'hal'o
memoriga	memor'ig'a
memorigaj	memor'ig'a'j
memorigan	memor'ig'a'n
memorigas	memor'ig'as
memorigi	memor'ig'i
memorigis	memor'ig'is
memorigo	memor'ig'o
memorigoj	memor'ig'o'j
memorigon	memor'ig'o'n
memorigos	memor'ig'os
memorigu	memor'ig'u
memorigaĵo	memor'ig'aĵ'o
memorigaĵoj	memor'ig'aĵ'o'j
memorigante	memor'ig'ant'e
memorigata	memor'ig'at'a
memorigilo	memor'ig'il'o
memorigiloj	memor'ig'il'o'j
memorigilojn	memor'ig'il'o'j'n
memorigita	memor'ig'it'a
memorigitaj	memor'ig'it'a'j
memorigloko	memor'ig'lok'o
memorilo	memor'il'o
memoriloj	memor'il'o'j
memorinda	memor'ind'a
memorindaj	memor'ind'a'j
memorindajn	memor'ind'a'j'n
memorindan	memor'ind'a'n
memorindas	memor'ind'as
memorindaĵo	memor'ind'aĵ'o
memorindaĵoj	memor'ind'aĵ'o'j
memorita	memor'it'a
memoritaj	memor'it'a'j
memorite	memor'it'e
memorkapablo	memor'kapabl'o
memorkapablon	memor'kapabl'o'n
memorkapacito	memor'kapacit'o
memorlibro	memor'libr'o
memorlibron	memor'libr'o'n
memorloko	memor'lok'o
memorlokoj	memor'lok'o'j
memormaŝinoj	memor'maŝin'o'j
memormonumento	memor'monument'o
memorperdo	memor'perd'o
memorperdon	memor'perd'o'n
memorsistemo	memor'sistem'o
memorsistemoj	memor'sistem'o'j
memorŝtono	memor'ŝton'o
memortabulo	memor'tabul'o
memortabuloj	memor'tabul'o'j
memortabulon	memor'tabul'o'n
memortago	memor'tag'o
memorunuo	memor'unu'o
memorunuoj	memor'unu'o'j
memorando	memorand'o
memorandon	memorand'o'n
memuaro	memuar'o
memuaroj	memuar'o'j
memuarojn	memuar'o'j'n
menaĝerio	menaĝeri'o
mencias	menci'as
mencii	menci'i
menciis	menci'is
mencio	menci'o
mencioj	menci'o'j
menciojn	menci'o'j'n
mencion	menci'o'n
mencios	menci'os
menciu	menci'u
mencius	menci'us
menciado	menci'ad'o
menciante	menci'ant'e
menciata	menci'at'a
menciataj	menci'at'a'j
menciendas	menci'end'as
menciiĝas	menci'iĝ'as
menciiĝis	menci'iĝ'is
menciinda	menci'ind'a
menciindaj	menci'ind'a'j
menciindas	menci'ind'as
menciinde	menci'ind'e
menciinte	menci'int'e
menciita	menci'it'a
menciitaj	menci'it'a'j
menciitajn	menci'it'a'j'n
menciitan	menci'it'a'n
menciite	menci'it'e
mendas	mend'as
mendi	mend'i
mendis	mend'is
mendo	mend'o
mendoj	mend'o'j
mendojn	mend'o'j'n
mendon	mend'o'n
mendos	mend'os
mendu	mend'u
mendado	mend'ad'o
mendadon	mend'ad'o'n
mendanto	mend'ant'o
mendantoj	mend'ant'o'j
mendebla	mend'ebl'a
mendeblaj	mend'ebl'a'j
mendilo	mend'il'o
mendiloj	mend'il'o'j
mendilon	mend'il'o'n
mendinto	mend'int'o
mendintoj	mend'int'o'j
mendita	mend'it'a
menditaj	mend'it'a'j
menditajn	mend'it'a'j'n
menditan	mend'it'a'n
mendela	mendel'a
menhiro	menhir'o
meningito	mening'it'o
mensa	mens'a
mensaj	mens'a'j
mensajn	mens'a'j'n
mensan	mens'a'n
mense	mens'e
menso	mens'o
mensoj	mens'o'j
mensojn	mens'o'j'n
menson	mens'o'n
menshigieno	mens'higien'o
mensmalsana	mens'mal'san'a
mensmalsano	mens'mal'san'o
mensmalsanon	mens'mal'san'o'n
mensmalsanulo	mens'mal'san'ul'o
mensmalsanuloj	mens'mal'san'ul'o'j
mensostato	mens'o'stat'o
mensostaton	mens'o'stat'o'n
mensstato	mens'stat'o
mensoga	mensog'a
mensogaj	mensog'a'j
mensogajn	mensog'a'j'n
mensogas	mensog'as
mensoge	mensog'e
mensogi	mensog'i
mensogis	mensog'is
mensogo	mensog'o
mensogoj	mensog'o'j
mensogojn	mensog'o'j'n
mensogon	mensog'o'n
mensogos	mensog'os
mensogu	mensog'u
mensogus	mensog'us
mensogadis	mensog'ad'is
mensogado	mensog'ad'o
mensoganta	mensog'ant'a
mensoganto	mensog'ant'o
mensogantoj	mensog'ant'o'j
mensogema	mensog'em'a
mensoginta	mensog'int'a
mensogisto	mensog'ist'o
mensogulo	mensog'ul'o
mensoguloj	mensog'ul'o'j
mensogulino	mensog'ul'in'o
menstrua	menstru'a
menstruo	menstru'o
menstruon	menstru'o'n
menta	ment'a
mento	ment'o
mentoj	ment'o'j
mentono	menton'o
mentonon	menton'o'n
mentoris	mentor'is
mentoro	mentor'o
mentoroj	mentor'o'j
mentoron	mentor'o'n
mentorado	mentor'ad'o
menuo	menu'o
menuoj	menu'o'j
menuojn	menu'o'j'n
menuon	menu'o'n
merda	merd'a
merdo	merd'o
merdon	merd'o'n
merdulo	merd'ul'o
mergas	merg'as
mergi	merg'i
mergis	merg'is
mergo	merg'o
mergado	merg'ad'o
mergante	merg'ant'e
mergiĝas	merg'iĝ'as
mergiĝi	merg'iĝ'i
mergiĝis	merg'iĝ'is
mergita	merg'it'a
mergitaj	merg'it'a'j
merĝo	merĝ'o
merĝopetrelo	merĝ'o'petrel'o
meridiano	meridian'o
meridianoj	meridian'o'j
merita	merit'a
meritaj	merit'a'j
meritan	merit'a'n
meritas	merit'as
merite	merit'e
meriti	merit'i
meritis	merit'is
merito	merit'o
meritoj	merit'o'j
meritojn	merit'o'j'n
meriton	merit'o'n
meritos	merit'os
meritu	merit'u
meritus	merit'us
meritado	merit'ad'o
meritigas	merit'ig'as
meritigis	merit'ig'is
meritigita	merit'ig'it'a
meritigitaj	merit'ig'it'a'j
meritita	merit'it'a
merititan	merit'it'a'n
meritoplena	merit'o'plen'a
meritplena	merit'plen'a
meritplenaj	merit'plen'a'j
meritpostuli	merit'postul'i
meritokratio	meritokrati'o
merkantilismo	merkantilism'o
merkata	merkat'a
merkataj	merkat'a'j
merkatajn	merkat'a'j'n
merkatan	merkat'a'n
merkate	merkat'e
merkato	merkat'o
merkatoj	merkat'o'j
merkatojn	merkat'o'j'n
merkaton	merkat'o'n
merkatado	merkat'ad'o
merkataliro	merkat'al'ir'o
merkataliron	merkat'al'ir'o'n
merkatekonomio	merkat'ekonomi'o
merkatfortoj	merkat'fort'o'j
merkatigo	merkat'ig'o
merkatigon	merkat'ig'o'n
merkatika	merkat'ik'a
merkatiko	merkat'ik'o
merkatismo	merkat'ism'o
merkatparto	merkat'part'o
merkatparton	merkat'part'o'n
merkatpotenco	merkat'potenc'o
merkatpotencon	merkat'potenc'o'n
merkatsituacio	merkat'situaci'o
merkreda	merkred'a
merkrede	merkred'e
merkredo	merkred'o
merkredoj	merkred'o'j
merkredon	merkred'o'n
merkuro	merkur'o
merkurrenkonta	merkur'renkont'a
merlo	merl'o
merloj	merl'o'j
meropo	merop'o
mesa	mes'a
meso	mes'o
mesoj	mes'o'j
mesojn	mes'o'j'n
meson	mes'o'n
mescelebri	mes'celebr'i
mescelebro	mes'celebr'o
meslibro	mes'libr'o
meslibron	mes'libr'o'n
mesoservantoj	mes'o'serv'ant'o'j
mesaĝi	mesaĝ'i
mesaĝis	mesaĝ'is
mesagho	mesaĝ'o
mesaĝo	mesaĝ'o
mesaĝoj	mesaĝ'o'j
mesaĝojn	mesaĝ'o'j'n
mesaĝon	mesaĝ'o'n
mesaĝado	mesaĝ'ad'o
mesaĝadon	mesaĝ'ad'o'n
mesaĝeton	mesaĝ'et'o'n
mesaĝisto	mesaĝ'ist'o
mesaĝistoj	mesaĝ'ist'o'j
mesaĝistojn	mesaĝ'ist'o'j'n
mesaĝiston	mesaĝ'ist'o'n
mesia	mesi'a
mesiaj	mesi'a'j
mesio	mesi'o
mesion	mesi'o'n
mesiana	mesi'an'a
mesino	mesin'o
mestizo	mestiz'o
mestizoj	mestiz'o'j
meta	met'a
metas	met'as
meti	met'i
metis	met'is
meto	met'o
metos	met'os
metu	met'u
metus	met'us
metadis	met'ad'is
metado	met'ad'o
metakrilata	met'akr'il'at'a
metakrilato	met'akr'il'at'o
metamfetamino	met'amfet'amin'o
metano	met'an'o
metanon	met'an'o'n
metanosulfonata	met'an'o'sulfon'at'a
metanolo	met'an'ol'o
metanolon	met'an'ol'o'n
metanta	met'ant'a
metantaj	met'ant'a'j
metantan	met'ant'a'n
metante	met'ant'e
metata	met'at'a
metataj	met'at'a'j
metiĝas	met'iĝ'as
metiĝis	met'iĝ'is
metila	met'il'a
metilo	met'il'o
metinta	met'int'a
metinte	met'int'e
metita	met'it'a
metitaj	met'it'a'j
metitajn	met'it'a'j'n
metitan	met'it'a'n
metite	met'it'e
metoksido	met'oksid'o
metaanalizo	meta'analiz'o
metaanalizoj	meta'analiz'o'j
metadatenoj	meta'daten'o'j
metadatenojn	meta'daten'o'j'n
metafizika	meta'fizik'a
metafizikaj	meta'fizik'a'j
metafizikajn	meta'fizik'a'j'n
metafizikan	meta'fizik'a'n
metafizike	meta'fizik'e
metafiziko	meta'fizik'o
metafizikon	meta'fizik'o'n
metalingvo	meta'lingv'o
metamateriala	meta'material'a
metamaterialoj	meta'material'o'j
metastabila	meta'stabil'a
metabola	metabol'a
metabolaj	metabol'a'j
metabolajn	metabol'a'j'n
metabolan	metabol'a'n
metabole	metabol'e
metabolo	metabol'o
metabolon	metabol'o'n
metaboligas	metabol'ig'as
metaboligita	metabol'ig'it'a
metaboligitaj	metabol'ig'it'a'j
metabolismo	metabol'ism'o
metabolito	metabol'it'o
metabolitoj	metabol'it'o'j
metafora	metafor'a
metaforaj	metafor'a'j
metaforajn	metafor'a'j'n
metaforan	metafor'a'n
metafore	metafor'e
metaforo	metafor'o
metaforoj	metafor'o'j
metaforojn	metafor'o'j'n
metaforon	metafor'o'n
metala	metal'a
metalaj	metal'a'j
metalajn	metal'a'j'n
metalan	metal'a'n
metalo	metal'o
metaloj	metal'o'j
metalojn	metal'o'j'n
metalon	metal'o'n
metalaĵoj	metal'aĵ'o'j
metalaĵojn	metal'aĵ'o'j'n
metalatomoj	metal'atom'o'j
metalbandoj	metal'band'o'j
metaleca	metal'ec'a
metalfunkciado	metal'funkci'ad'o
metalindustrio	metal'industri'o
metaljonoj	metal'jon'o'j
metalobjektoj	metal'objekt'o'j
metaloksidoj	metal'oksid'o'j
metalroko	metal'rok'o
metalsurfaco	metal'surfac'o
metalsurfacoj	metal'surfac'o'j
metaltavoleto	metal'tavol'et'o
metalverkaĵo	metal'verk'aĵ'o
metaloido	metaloid'o
metaloidoj	metaloid'o'j
metalurgia	metalurgi'a
metalurgiaj	metalurgi'a'j
metalurgio	metalurgi'o
metalurgion	metalurgi'o'n
metamorfa	metamorf'a
metamorfaj	metamorf'a'j
metamorfozas	metamorfoz'as
metamorfozis	metamorfoz'is
metamorfozo	metamorfoz'o
metamorfozoj	metamorfoz'o'j
metamorfozon	metamorfoz'o'n
metapsikia	metapsiki'a
metastaza	metastaz'a
metastazo	metastaz'o
metastazoj	metastaz'o'j
metatezo	metatez'o
meteologo	mete'olog'o
meteologoj	mete'olog'o'j
meteologia	mete'olog'i'a
meteologiaj	mete'olog'i'a'j
meteologiajn	mete'olog'i'a'j'n
meteologio	mete'olog'i'o
metempsikozo	metempsikoz'o
meteora	meteor'a
meteoro	meteor'o
meteoroj	meteor'o'j
meteorfluoj	meteor'flu'o'j
meteorŝtono	meteor'ŝton'o
meteorŝtonoj	meteor'ŝton'o'j
meteorito	meteorit'o
meteoritoj	meteorit'o'j
meteoroidoj	meteoroid'o'j
meteorologia	meteorologi'a
meteorologiaj	meteorologi'a'j
metia	meti'a
metiaj	meti'a'j
metiajn	meti'a'j'n
metian	meti'a'n
metie	meti'e
metio	meti'o
metioj	meti'o'j
metiojn	meti'o'j'n
metion	meti'o'n
metiarto	meti'art'o
metiarton	meti'art'o'n
metiartaĵoj	meti'art'aĵ'o'j
metiartaĵojn	meti'art'aĵ'o'j'n
metiartistoj	meti'art'ist'o'j
metiejo	meti'ej'o
metiejoj	meti'ej'o'j
metiejojn	meti'ej'o'j'n
metiejon	meti'ej'o'n
metiista	meti'ist'a
metiistaj	meti'ist'a'j
metiisto	meti'ist'o
metiistoj	meti'ist'o'j
metiistojn	meti'ist'o'j'n
metiiston	meti'ist'o'n
metiisteco	meti'ist'ec'o
metilernado	meti'lern'ad'o
metilernadoj	meti'lern'ad'o'j
metilernadon	meti'lern'ad'o'n
metilernanto	meti'lern'ant'o
metilernantoj	meti'lern'ant'o'j
metilernantojn	meti'lern'ant'o'j'n
metoda	metod'a
metodaj	metod'a'j
metodan	metod'a'n
metode	metod'e
metodo	metod'o
metodoj	metod'o'j
metodojn	metod'o'j'n
metodon	metod'o'n
metodaro	metod'ar'o
metodaroj	metod'ar'o'j
metodarojn	metod'ar'o'j'n
metodaron	metod'ar'o'n
metodika	metod'ik'a
metodikaj	metod'ik'a'j
metodikajn	metod'ik'a'j'n
metodikan	metod'ik'a'n
metodiko	metod'ik'o
metodisma	metod'ism'a
metodista	metod'ist'a
metodistoj	metod'ist'o'j
metodistpreĝejo	metod'ist'preĝ'ej'o
metodologia	metod'olog'i'a
metodologio	metod'olog'i'o
metodio	metodi'o
metonimio	metonimi'o
metopoj	metop'o'j
metra	metr'a
metran	metr'a'n
metro	metr'o
metroj	metr'o'j
metrojn	metr'o'j'n
metron	metr'o'n
metrika	metr'ik'a
metrikaj	metr'ik'a'j
metrikajn	metr'ik'a'j'n
metrikan	metr'ik'a'n
metrike	metr'ik'e
metriko	metr'ik'o
metrikon	metr'ik'o'n
metrologio	metr'olog'i'o
metroa	metro'a
metroaj	metro'a'j
metroe	metro'e
metroo	metro'o
metrooj	metro'o'j
metroon	metro'o'n
metrolinio	metro'lini'o
metrolinioj	metro'lini'o'j
metrosistemo	metro'sistem'o
metrosistemoj	metro'sistem'o'j
metrostacio	metro'staci'o
metrostacioj	metro'staci'o'j
metropola	metropol'a
metropolaj	metropol'a'j
metropolo	metropol'o
metropoloj	metropol'o'j
metropolon	metropol'o'n
metropolano	metropol'an'o
metropolita	metropolit'a
metropolitan	metropolit'a'n
metropolito	metropolit'o
metropolitena	metropoliten'a
metropolitenaj	metropoliten'a'j
metropolitenan	metropoliten'a'n
metropoliteno	metropoliten'o
metropolitenon	metropoliten'o'n
mevo	mev'o
mevoj	mev'o'j
mevojn	mev'o'j'n
meza	mez'a
mezaj	mez'a'j
mezajn	mez'a'j'n
mezan	mez'a'n
meze	mez'e
mezen	mez'e'n
mezo	mez'o
mezon	mez'o'n
mezaklasaj	mez'a'klas'a'j
mezafriko	mez'afrik'o
mezaĝa	mez'aĝ'a
mezaĝaj	mez'aĝ'a'j
mezaĝo	mez'aĝ'o
mezaĝulo	mez'aĝ'ul'o
mezaĝuloj	mez'aĝ'ul'o'j
mezalta	mez'alt'a
mezaltaj	mez'alt'a'j
mezaltgermana	mez'alt'german'a
mezamerika	mez'amerik'a
mezamerikaj	mez'amerik'a'j
mezameriko	mez'amerik'o
mezangla	mez'angl'a
mezanglo	mez'angl'o
mezazia	mez'azi'a
mezazio	mez'azi'o
mezazion	mez'azi'o'n
mezbona	mez'bon'a
mezbonaj	mez'bon'a'j
mezepoka	mez'epok'a
mezepokaj	mez'epok'a'j
mezepokajn	mez'epok'a'j'n
mezepokan	mez'epok'a'n
mezepoke	mez'epok'e
mezepoko	mez'epok'o
mezepokoj	mez'epok'o'j
mezepokon	mez'epok'o'n
mezeŭropa	mez'eŭrop'a
mezeŭropaj	mez'eŭrop'a'j
mezeŭropo	mez'eŭrop'o
mezeŭropon	mez'eŭrop'o'n
mezfingro	mez'fingr'o
mezgrada	mez'grad'a
mezgradan	mez'grad'a'n
mezgranda	mez'grand'a
mezgrandaj	mez'grand'a'j
mezgrandajn	mez'grand'a'j'n
mezgrandan	mez'grand'a'n
mezintervalaj	mez'interval'a'j
mezjarcento	mez'jar'cent'o
mezkampulo	mez'kamp'ul'o
mezklasa	mez'klas'a
mezklasaj	mez'klas'a'j
mezklaso	mez'klas'o
mezklasuloj	mez'klas'ul'o'j
mezkoridoro	mez'koridor'o
mezkoridoroj	mez'koridor'o'j
mezkvalita	mez'kvalit'a
mezkvalitaj	mez'kvalit'a'j
mezlatitudoj	mez'latitud'o'j
mezlerneja	mez'lern'ej'a
mezlernejaj	mez'lern'ej'a'j
mezlernejan	mez'lern'ej'a'n
mezlernejo	mez'lern'ej'o
mezlernejoj	mez'lern'ej'o'j
mezlernejojn	mez'lern'ej'o'j'n
mezlernejon	mez'lern'ej'o'n
mezlernejano	mez'lern'ej'an'o
mezlernejanoj	mez'lern'ej'an'o'j
mezlinio	mez'lini'o
mezlonga	mez'long'a
mezmontaro	mez'mont'ar'o
meznavo	mez'nav'o
meznivela	mez'nivel'a
meznivelaj	mez'nivel'a'j
meznivelan	mez'nivel'a'n
meznokta	mez'nokt'a
meznokte	mez'nokt'e
meznokto	mez'nokt'o
meznombra	mez'nombr'a
meznombre	mez'nombr'e
meznombro	mez'nombr'o
meznombron	mez'nombr'o'n
mezoregiono	mez'o'region'o
mezoregionoj	mez'o'region'o'j
mezokcidenta	mez'okcident'a
mezokcidentaj	mez'okcident'a'j
mezokcidento	mez'okcident'o
mezorelo	mez'orel'o
mezorienta	mez'orient'a
mezorientaj	mez'orient'a'j
mezorientan	mez'orient'a'n
mezoriento	mez'orient'o
mezorienton	mez'orient'o'n
mezperioda	mez'period'a
mezpozicio	mez'pozici'o
mezpunkto	mez'punkt'o
meztero	mez'ter'o
meztereno	mez'teren'o
mezterenon	mez'teren'o'n
mezuma	mez'um'a
mezumaj	mez'um'a'j
mezuman	mez'um'a'n
mezume	mez'um'e
mezumo	mez'um'o
mezumoj	mez'um'o'j
mezumon	mez'um'o'n
mezvaloro	mez'valor'o
mezvarma	mez'varm'a
mezvarmaj	mez'varm'a'j
mezvoje	mez'voj'e
mezvojo	mez'voj'o
mezodermo	mezoderm'o
mezolitiko	mezolitik'o
mezoplodo	mezoplod'o
mezopotamia	mezopotami'a
mezopotamiaj	mezopotami'a'j
mezopotamio	mezopotami'o
mezopotamion	mezopotami'o'n
mezozoiko	mezozoik'o
mezura	mezur'a
mezuraj	mezur'a'j
mezuran	mezur'a'n
mezuras	mezur'as
mezure	mezur'e
mezuri	mezur'i
mezuris	mezur'is
mezuro	mezur'o
mezuroj	mezur'o'j
mezurojn	mezur'o'j'n
mezuron	mezur'o'n
mezuros	mezur'os
mezuru	mezur'u
mezurado	mezur'ad'o
mezuradoj	mezur'ad'o'j
mezuradojn	mezur'ad'o'j'n
mezuradon	mezur'ad'o'n
mezuranta	mezur'ant'a
mezurantaj	mezur'ant'a'j
mezurante	mezur'ant'e
mezurata	mezur'at'a
mezurataj	mezur'at'a'j
mezurebla	mezur'ebl'a
mezureblaj	mezur'ebl'a'j
mezureblajn	mezur'ebl'a'j'n
mezureblan	mezur'ebl'a'n
mezureblas	mezur'ebl'as
mezuriĝas	mezur'iĝ'as
mezurilo	mezur'il'o
mezuriloj	mezur'il'o'j
mezurilojn	mezur'il'o'j'n
mezurilon	mezur'il'o'n
mezurita	mezur'it'a
mezuritaj	mezur'it'a'j
mezuritajn	mezur'it'a'j'n
mezuritan	mezur'it'a'n
mezurite	mezur'it'e
mezursistemo	mezur'sistem'o
mezurunuo	mezur'unu'o
mezurunuoj	mezur'unu'o'j
mezurunuon	mezur'unu'o'n
mi	mi
mia	mi'a
miaj	mi'a'j
miajn	mi'a'j'n
mian	mi'a'n
min	mi'n
mio	mi'o
mion	mi'o'n
miaflanke	mi'a'flank'e
miahejme	mi'a'hejm'e
miahejmen	mi'a'hejm'e'n
mianome	mi'a'nom'e
miaopinie	mi'a'opini'e
miaparte	mi'a'part'e
miascie	mi'a'sci'e
miavice	mi'a'vic'e
miokardia	mi'o'kardi'a
miokardio	mi'o'kardi'o
miopinie	mi'opini'e
miperspektiva	mi'perspektiv'a
miperspektivaj	mi'perspektiv'a'j
miama	miam'a
miamo	miam'o
miasmo	miasm'o
miaŭas	miaŭ'as
miaŭis	miaŭ'is
micele	micel'e
midraŝo	midraŝ'o
miela	miel'a
mielan	miel'a'n
mielo	miel'o
mielon	miel'o'n
mielabelo	miel'abel'o
mielabeloj	miel'abel'o'j
mielĉelaro	miel'ĉel'ar'o
mielmonato	miel'monat'o
mienas	mien'as
mienis	mien'is
mieno	mien'o
mienoj	mien'o'j
mienojn	mien'o'j'n
mienon	mien'o'n
mienu	mien'u
miensimboloj	mien'simbol'o'j
migdala	migdal'a
migdalo	migdal'o
migdaloj	migdal'o'j
migdalojn	migdal'o'j'n
migdalarboj	migdal'arb'o'j
migra	migr'a
migraj	migr'a'j
migran	migr'a'n
migras	migr'as
migri	migr'i
migris	migr'is
migros	migr'os
migradaj	migr'ad'a'j
migradas	migr'ad'as
migradi	migr'ad'i
migradis	migr'ad'is
migrado	migr'ad'o
migradoj	migr'ad'o'j
migradojn	migr'ad'o'j'n
migradon	migr'ad'o'n
migranta	migr'ant'a
migrantaj	migr'ant'a'j
migrantajn	migr'ant'a'j'n
migrantan	migr'ant'a'n
migrante	migr'ant'e
migranto	migr'ant'o
migrantoj	migr'ant'o'j
migrantojn	migr'ant'o'j'n
migranton	migr'ant'o'n
migrintoj	migr'int'o'j
migrobirdoj	migr'o'bird'o'j
migrokolombo	migr'o'kolomb'o
migrokolomboj	migr'o'kolomb'o'j
migrovojo	migr'o'voj'o
migrovojoj	migr'o'voj'o'j
migrovojojn	migr'o'voj'o'j'n
migrovojon	migr'o'voj'o'n
miĥaelo	miĥael'o
mikado	mikad'o
mikelanĝelo	mikelanĝel'o
mikena	miken'a
mikenaj	miken'a'j
mikeno	miken'o
mikenon	miken'o'n
mikenanoj	miken'an'o'j
mikrobiologio	mikro'biolog'i'o
mikrobusoj	mikro'bus'o'j
mikroelektroniko	mikro'elektron'ik'o
mikrokredito	mikro'kredit'o
mikrometro	mikro'metr'o
mikrometroj	mikro'metr'o'j
mikroprocesoro	mikro'procesor'o
mikroprocesoroj	mikro'procesor'o'j
mikroskopa	mikro'skop'a
mikroskopaj	mikro'skop'a'j
mikroskopajn	mikro'skop'a'j'n
mikroskope	mikro'skop'e
mikroskopo	mikro'skop'o
mikroskopoj	mikro'skop'o'j
mikroskopon	mikro'skop'o'n
mikroskopio	mikro'skop'i'o
mikrotubetoj	mikro'tub'et'o'j
mikroba	mikrob'a
mikrobaj	mikrob'a'j
mikrobajn	mikrob'a'j'n
mikroban	mikrob'a'n
mikrobo	mikrob'o
mikroboj	mikrob'o'j
mikrobojn	mikrob'o'j'n
mikrofono	mikrofon'o
mikrofonoj	mikrofon'o'j
mikrofonon	mikrofon'o'n
miksa	miks'a
miksaj	miks'a'j
miksan	miks'a'n
miksas	miks'as
mikse	miks'e
miksi	miks'i
miksis	miks'is
mikso	miks'o
mikson	miks'o'n
miksu	miks'u
miksado	miks'ad'o
miksadon	miks'ad'o'n
miksajho	miks'aĵ'o
miksaĵo	miks'aĵ'o
miksaĵoj	miks'aĵ'o'j
miksaĵojn	miks'aĵ'o'j'n
miksaĵon	miks'aĵ'o'n
miksanta	miks'ant'a
miksante	miks'ant'e
miksata	miks'at'a
miksataj	miks'at'a'j
miksĉifona	miks'ĉifon'a
miksĉifonan	miks'ĉifon'a'n
miksebla	miks'ebl'a
mikseblaj	miks'ebl'a'j
miksiĝas	miks'iĝ'as
miksiĝi	miks'iĝ'i
miksiĝis	miks'iĝ'is
miksiĝo	miks'iĝ'o
miksilo	miks'il'o
miksiloj	miks'il'o'j
miksilon	miks'il'o'n
miksita	miks'it'a
miksitaj	miks'it'a'j
miksitajn	miks'it'a'j'n
miksitan	miks'it'a'n
miksite	miks'it'e
mikspoto	miks'pot'o
miksraso	miks'ras'o
miksvorto	miks'vort'o
mil	mil
mila	mil'a
milan	mil'a'n
milo	mil'o
miloj	mil'o'j
milojn	mil'o'j'n
milon	mil'o'n
milfoje	mil'foj'e
miljara	mil'jar'a
miljaraj	mil'jar'a'j
miljaran	mil'jar'a'n
miljaro	mil'jar'o
miljaroj	mil'jar'o'j
miloble	mil'obl'e
milana	milan'a
milano	milan'o
milanon	milan'o'n
milda	mild'a
mildaj	mild'a'j
mildajn	mild'a'j'n
mildan	mild'a'n
mildas	mild'as
milde	mild'e
mildo	mild'o
mildeco	mild'ec'o
mildecon	mild'ec'o'n
mildiga	mild'ig'a
mildigaj	mild'ig'a'j
mildigas	mild'ig'as
mildigi	mild'ig'i
mildigis	mild'ig'is
mildigo	mild'ig'o
mildigon	mild'ig'o'n
mildigos	mild'ig'os
mildigu	mild'ig'u
mildigus	mild'ig'us
mildigado	mild'ig'ad'o
mildigante	mild'ig'ant'e
mildigita	mild'ig'it'a
mildigitaj	mild'ig'it'a'j
mildiĝas	mild'iĝ'as
mildiĝis	mild'iĝ'is
mileto	milet'o
milio	mili'o
milioj	mili'o'j
milion	mili'o'n
milimetro	mili'metr'o
milimetroj	mili'metr'o'j
milimetrojn	mili'metr'o'j'n
milisekundoj	mili'sekund'o'j
miliardo	miliard'o
miliardoj	miliard'o'j
miliardojn	miliard'o'j'n
miliardon	miliard'o'n
miliardulo	miliard'ul'o
miliarduloj	miliard'ul'o'j
milico	milic'o
milicoj	milic'o'j
milicojn	milic'o'j'n
milicon	milic'o'n
milicanoj	milic'an'o'j
milicisto	milic'ist'o
milicistoj	milic'ist'o'j
milicia	milici'a
miliciaj	milici'a'j
milicio	milici'o
milicioj	milici'o'j
milicianoj	milici'an'o'j
miliona	milion'a
milionaj	milion'a'j
miliono	milion'o
milionoj	milion'o'j
milionojn	milion'o'j'n
milionon	milion'o'n
milionulo	milion'ul'o
milionuloj	milion'ul'o'j
milionurbo	milion'urb'o
milita	milit'a
militaj	milit'a'j
militajn	milit'a'j'n
militan	milit'a'n
militas	milit'as
milite	milit'e
militi	milit'i
militis	milit'is
milito	milit'o
militoj	milit'o'j
militojn	milit'o'j'n
militon	milit'o'n
militos	milit'os
militu	milit'u
militado	milit'ad'o
militadon	milit'ad'o'n
militafera	milit'afer'a
militago	milit'ag'o
militagoj	milit'ag'o'j
militakiro	milit'akir'o
militakiron	milit'akir'o'n
militanta	milit'ant'a
militantaj	milit'ant'a'j
militantajn	milit'ant'a'j'n
militantan	milit'ant'a'n
militantoj	milit'ant'o'j
militarto	milit'art'o
militaviadilo	milit'aviad'il'o
militaviadiloj	milit'aviad'il'o'j
militbazo	milit'baz'o
militĉefo	milit'ĉef'o
militĉefoj	milit'ĉef'o'j
militdeklaro	milit'deklar'o
militema	milit'em'a
militemaj	milit'em'a'j
militemajn	milit'em'a'j'n
militeman	milit'em'a'n
militemo	milit'em'o
militemuloj	milit'em'ul'o'j
militestro	milit'estr'o
militestroj	milit'estr'o'j
militestrojn	milit'estr'o'j'n
militfino	milit'fin'o
militforta	milit'fort'a
militforto	milit'fort'o
militfortoj	milit'fort'o'j
militfortojn	milit'fort'o'j'n
militforton	milit'fort'o'n
militindustrio	milit'industri'o
militinvesto	milit'invest'o
militinveston	milit'invest'o'n
militiris	milit'ir'is
militiro	milit'ir'o
militiroj	milit'ir'o'j
militirojn	milit'ir'o'j'n
militiron	milit'ir'o'n
militisma	milit'ism'a
militismaj	milit'ism'a'j
militismo	milit'ism'o
militista	milit'ist'a
militistaj	milit'ist'a'j
militistajn	milit'ist'a'j'n
militistan	milit'ist'a'n
militisto	milit'ist'o
militistoj	milit'ist'o'j
militistojn	milit'ist'o'j'n
militiston	milit'ist'o'n
militistaro	milit'ist'ar'o
militistaroj	milit'ist'ar'o'j
militistaron	milit'ist'ar'o'n
militjuro	milit'jur'o
militjuron	milit'jur'o'n
militkaptito	milit'kapt'it'o
militkaptitoj	milit'kapt'it'o'j
militkaptitojn	milit'kapt'it'o'j'n
militkaptiteco	milit'kapt'it'ec'o
militkrimoj	milit'krim'o'j
militkrimojn	milit'krim'o'j'n
militkrimulo	milit'krim'ul'o
militkrimuloj	milit'krim'ul'o'j
militministerio	milit'ministeri'o
militministro	milit'ministr'o
militreĝimo	milit'reĝim'o
militservi	milit'serv'i
militservis	milit'serv'is
militservo	milit'serv'o
militservoj	milit'serv'o'j
militservon	milit'serv'o'n
militŝipo	milit'ŝip'o
militŝipoj	milit'ŝip'o'j
militŝipojn	milit'ŝip'o'j'n
milittempa	milit'temp'a
milittempaj	milit'temp'a'j
militviktimoj	milit'viktim'o'j
militarismo	militarism'o
militaristoj	militarist'o'j
milono	milon'o
milonoj	milon'o'j
milvo	milv'o
milvoj	milv'o'j
milvojn	milv'o'j'n
milvokio	milvoki'o
mimiko	mim'ik'o
mimikoj	mim'ik'o'j
mimikojn	mim'ik'o'j'n
mimikon	mim'ik'o'n
mina	min'a
minaj	min'a'j
minas	min'as
mini	min'i
minis	min'is
mino	min'o
minoj	min'o'j
minojn	min'o'j'n
minon	min'o'n
minadaj	min'ad'a'j
minado	min'ad'o
minadon	min'ad'o'n
minadoperacioj	min'ad'operaci'o'j
minaĵoj	min'aĵ'o'j
mineja	min'ej'a
minejaj	min'ej'a'j
minejo	min'ej'o
minejoj	min'ej'o'j
minejojn	min'ej'o'j'n
minejon	min'ej'o'n
mingalerioj	min'galeri'o'j
minindustrio	min'industri'o
minista	min'ist'a
ministaj	min'ist'a'j
ministo	min'ist'o
ministoj	min'ist'o'j
ministojn	min'ist'o'j'n
minita	min'it'a
minkampo	min'kamp'o
minkampoj	min'kamp'o'j
minkavoj	min'kav'o'j
minmajstro	min'majstr'o
minofirmaoj	min'o'firma'o'j
minaca	minac'a
minacaj	minac'a'j
minacajn	minac'a'j'n
minacan	minac'a'n
minacas	minac'as
minace	minac'e
minaci	minac'i
minacis	minac'is
minaco	minac'o
minacoj	minac'o'j
minacojn	minac'o'j'n
minacon	minac'o'n
minacos	minac'os
minacus	minac'us
minacado	minac'ad'o
minacanta	minac'ant'a
minacantaj	minac'ant'a'j
minacantan	minac'ant'a'n
minacante	minac'ant'e
minacata	minac'at'a
minacataj	minac'at'a'j
minacatajn	minac'at'a'j'n
minacatan	minac'at'a'n
minacita	minac'it'a
minacitaj	minac'it'a'j
minacite	minac'it'e
minareto	minaret'o
minaretoj	minaret'o'j
minca	minc'a
minerala	mineral'a
mineralaj	mineral'a'j
mineralajn	mineral'a'j'n
mineralan	mineral'a'n
mineralo	mineral'o
mineraloj	mineral'o'j
mineralojn	mineral'o'j'n
mineralon	mineral'o'n
mineralakvo	mineral'akv'o
mineralogia	mineralog'i'a
mineralogio	mineralog'i'o
minerva	minerv'a
minervo	minerv'o
miniatura	miniatur'a
miniaturaj	miniatur'a'j
miniaturajn	miniatur'a'j'n
miniaturan	miniatur'a'n
miniaturo	miniatur'o
miniaturoj	miniatur'o'j
miniaturojn	miniatur'o'j'n
miniaturon	miniatur'o'n
miniaturpentrigo	miniatur'pentr'ig'o
minimuma	minimum'a
minimumaj	minimum'a'j
minimumajn	minimum'a'j'n
minimuman	minimum'a'n
minimume	minimum'e
minimumo	minimum'o
minimumoj	minimum'o'j
minimumon	minimum'o'n
minimumigas	minimum'ig'as
minimumigi	minimum'ig'i
minimumigis	minimum'ig'is
minimumigo	minimum'ig'o
minimumigado	minimum'ig'ad'o
minimumigante	minimum'ig'ant'e
minimumigita	minimum'ig'it'a
minimumigitaj	minimum'ig'it'a'j
minimumisma	minimum'ism'a
minimumismo	minimum'ism'o
minimumkvadrata	minimum'kvadrat'a
ministeria	ministeri'a
ministeriaj	ministeri'a'j
ministerio	ministeri'o
ministerioj	ministeri'o'j
ministeriojn	ministeri'o'j'n
ministerion	ministeri'o'n
ministra	ministr'a
ministran	ministr'a'n
ministro	ministr'o
ministroj	ministr'o'j
ministrojn	ministr'o'j'n
ministron	ministr'o'n
ministraro	ministr'ar'o
ministrejo	ministr'ej'o
ministrejoj	ministr'ej'o'j
ministrestro	ministr'estr'o
ministrino	ministr'in'o
ministroprezidanto	ministr'o'prezid'ant'o
minoa	mino'a
minoo	mino'o
minotaŭro	mino'taŭr'o
minora	minor'a
minoraj	minor'a'j
minoro	minor'o
minoritata	minoritat'a
minoritataj	minoritat'a'j
minoritatajn	minoritat'a'j'n
minoritatan	minoritat'a'n
minoritato	minoritat'o
minoritatoj	minoritat'o'j
minoritatojn	minoritat'o'j'n
minoritaton	minoritat'o'n
minoritatgvidanto	minoritat'gvid'ant'o
minus	minus
minuso	minus'o
minusoj	minus'o'j
minuskomplekso	minus'kompleks'o
minuskla	minuskl'a
minusklaj	minuskl'a'j
minuskle	minuskl'e
minusklo	minuskl'o
minuskloj	minuskl'o'j
minusklojn	minuskl'o'j'n
minuskloleteroj	minuskl'o'leter'o'j
minuta	minut'a
minute	minut'e
minuto	minut'o
minutoj	minut'o'j
minutojn	minut'o'j'n
minuton	minut'o'n
mioceno	miocen'o
miopa	miop'a
miopaj	miop'a'j
miope	miop'e
miopeco	miop'ec'o
miopecon	miop'ec'o'n
mira	mir'a
miran	mir'a'n
miras	mir'as
mire	mir'e
miri	mir'i
miris	mir'is
miro	mir'o
miron	mir'o'n
miros	mir'os
miru	mir'u
mirus	mir'us
miranta	mir'ant'a
mirantaj	mir'ant'a'j
mirante	mir'ant'e
miregas	mir'eg'as
miregi	mir'eg'i
miregis	mir'eg'is
mirego	mir'eg'o
miregon	mir'eg'o'n
miregante	mir'eg'ant'e
miregigi	mir'eg'ig'i
miregigis	mir'eg'ig'is
miregigita	mir'eg'ig'it'a
miriga	mir'ig'a
mirigaj	mir'ig'a'j
mirigan	mir'ig'a'n
mirigas	mir'ig'as
mirige	mir'ig'e
mirigi	mir'ig'i
mirigis	mir'ig'is
mirigos	mir'ig'os
mirigus	mir'ig'us
miriganta	mir'ig'ant'a
mirigante	mir'ig'ant'e
mirigita	mir'ig'it'a
mirigitaj	mir'ig'it'a'j
mirigite	mir'ig'it'e
mirinda	mir'ind'a
mirindaj	mir'ind'a'j
mirindajn	mir'ind'a'j'n
mirindan	mir'ind'a'n
mirindas	mir'ind'as
mirinde	mir'ind'e
mirindaĵo	mir'ind'aĵ'o
mirindaĵoj	mir'ind'aĵ'o'j
mirindaĵojn	mir'ind'aĵ'o'j'n
mirindaĵon	mir'ind'aĵ'o'n
mirinfano	mir'infan'o
mirlando	mir'land'o
miraĝo	miraĝ'o
miraĝoj	miraĝ'o'j
mirakla	mirakl'a
miraklaj	mirakl'a'j
miraklajn	mirakl'a'j'n
miraklan	mirakl'a'n
mirakle	mirakl'e
miraklo	mirakl'o
mirakloj	mirakl'o'j
miraklojn	mirakl'o'j'n
miraklon	mirakl'o'n
mirho	mirh'o
miriado	miriad'o
miriadoj	miriad'o'j
mirto	mirt'o
mirtelo	mirtel'o
mirteloj	mirtel'o'j
mirtelojn	mirtel'o'j'n
mirtelujoj	mirtel'uj'o'j
misa	mis'a
misaj	mis'a'j
misajn	mis'a'j'n
misan	mis'a'n
misas	mis'as
mise	mis'e
misis	mis'is
miso	mis'o
misoj	mis'o'j
misojn	mis'o'j'n
mison	mis'o'n
misadministrado	mis'administr'ad'o
misagis	mis'ag'is
misago	mis'ag'o
misagoj	mis'ag'o'j
misagordo	mis'agord'o
misagordita	mis'agord'it'a
misaĵo	mis'aĵ'o
misaĵoj	mis'aĵ'o'j
misaĵojn	mis'aĵ'o'j'n
misaĵon	mis'aĵ'o'n
misaŭdis	mis'aŭd'is
misedukita	mis'eduk'it'a
misfama	mis'fam'a
misfamigi	mis'fam'ig'i
misfamigis	mis'fam'ig'is
misfamigo	mis'fam'ig'o
misfamigita	mis'fam'ig'it'a
misfamigitaj	mis'fam'ig'it'a'j
misfaras	mis'far'as
misfaris	mis'far'is
misfaro	mis'far'o
misfaroj	mis'far'o'j
misfarojn	mis'far'o'j'n
misfaron	mis'far'o'n
misfarto	mis'fart'o
misfidas	mis'fid'as
misforma	mis'form'a
misformas	mis'form'as
misformi	mis'form'i
misformis	mis'form'is
misformado	mis'form'ad'o
misformaĵo	mis'form'aĵ'o
misformita	mis'form'it'a
misformitaj	mis'form'it'a'j
misfortuna	mis'fortun'a
misfortune	mis'fortun'e
misfortuno	mis'fortun'o
misfortunoj	mis'fortun'o'j
misfortunon	mis'fortun'o'n
misfunkcias	mis'funkci'as
misfunkcii	mis'funkci'i
misfunkciis	mis'funkci'is
misfunkcio	mis'funkci'o
misfunkcioj	mis'funkci'o'j
misfunkcion	mis'funkci'o'n
misfunkciado	mis'funkci'ad'o
misglutis	mis'glut'is
misgvida	mis'gvid'a
misgvidaj	mis'gvid'a'j
misgvidajn	mis'gvid'a'j'n
misgvidas	mis'gvid'as
misgvide	mis'gvid'e
misgvidi	mis'gvid'i
misharmonio	mis'harmoni'o
misharmonion	mis'harmoni'o'n
mishumora	mis'humor'a
misinformas	mis'inform'as
misinformi	mis'inform'i
misinformis	mis'inform'is
misinformo	mis'inform'o
misinformado	mis'inform'ad'o
misinformita	mis'inform'it'a
misinterpretas	mis'interpret'as
misinterpreti	mis'interpret'i
misinterpretis	mis'interpret'is
misinterpreto	mis'interpret'o
misinterpretoj	mis'interpret'o'j
misinterpretita	mis'interpret'it'a
misinterpretitaj	mis'interpret'it'a'j
misiris	mis'ir'is
misjuĝis	mis'juĝ'is
miskalkulis	mis'kalkul'is
miskomprenas	mis'kompren'as
miskompreni	mis'kompren'i
miskomprenis	mis'kompren'is
miskompreno	mis'kompren'o
miskomprenoj	mis'kompren'o'j
miskomprenojn	mis'kompren'o'j'n
miskomprenon	mis'kompren'o'n
miskomprenu	mis'kompren'u
miskomprenata	mis'kompren'at'a
miskomprenebla	mis'kompren'ebl'a
miskompreniĝo	mis'kompren'iĝ'o
miskompreniĝoj	mis'kompren'iĝ'o'j
miskomprenita	mis'kompren'it'a
miskomprenitaj	mis'kompren'it'a'j
miskonduto	mis'kondut'o
miskonduton	mis'kondut'o'n
mislegis	mis'leg'is
misnomo	mis'nom'o
misoficado	mis'ofic'ad'o
misordo	mis'ord'o
mispaŝis	mis'paŝ'is
mispaŝo	mis'paŝ'o
mispaŝoj	mis'paŝ'o'j
mispaŝojn	mis'paŝ'o'j'n
mispaŝon	mis'paŝ'o'n
mispraktiko	mis'praktik'o
misprezentas	mis'prezent'as
misprezenti	mis'prezent'i
misprezentis	mis'prezent'is
misprezento	mis'prezent'o
misprezentoj	mis'prezent'o'j
misprezentojn	mis'prezent'o'j'n
misprezenton	mis'prezent'o'n
misprezentado	mis'prezent'ad'o
misprezentita	mis'prezent'it'a
misprononcas	mis'prononc'as
misprononco	mis'prononc'o
misproporcia	mis'proporci'a
misproporciaj	mis'proporci'a'j
misproporcie	mis'proporci'e
misregado	mis'reg'ad'o
misrezono	mis'rezon'o
misrezonoj	mis'rezon'o'j
misrezonon	mis'rezon'o'n
mistajpis	mis'tajp'is
mistajpo	mis'tajp'o
mistajpoj	mis'tajp'o'j
mistaksis	mis'taks'is
mistrafas	mis'traf'as
mistrafis	mis'traf'is
mistraktas	mis'trakt'as
mistrakti	mis'trakt'i
mistraktis	mis'trakt'is
mistraktado	mis'trakt'ad'o
mistraktadon	mis'trakt'ad'o'n
mistraktataj	mis'trakt'at'a'j
mistraktita	mis'trakt'it'a
mistraktitaj	mis'trakt'it'a'j
misuzas	mis'uz'as
misuzi	mis'uz'i
misuzis	mis'uz'is
misuzo	mis'uz'o
misuzoj	mis'uz'o'j
misuzojn	mis'uz'o'j'n
misuzon	mis'uz'o'n
misuzu	mis'uz'u
misuzado	mis'uz'ad'o
misuzante	mis'uz'ant'e
misuzantoj	mis'uz'ant'o'j
misuzata	mis'uz'at'a
misuzataj	mis'uz'at'a'j
misuzita	mis'uz'it'a
misuzitaj	mis'uz'it'a'j
misvetero	mis'veter'o
misalo	misal'o
misia	misi'a
misiaj	misi'a'j
misiajn	misi'a'j'n
misian	misi'a'n
misio	misi'o
misioj	misi'o'j
misiojn	misi'o'j'n
mision	misi'o'n
misiado	misi'ad'o
misiejo	misi'ej'o
misiista	misi'ist'a
misiisto	misi'ist'o
misiistoj	misi'ist'o'j
misiistojn	misi'ist'o'j'n
misiistinoj	misi'ist'in'o'j
misilaboro	misi'labor'o
misiraporto	misi'raport'o
misilo	misil'o
misiloj	misil'o'j
misilojn	misil'o'j'n
misilon	misil'o'n
misilkapoj	misil'kap'o'j
misisipo	misisip'o
misisipio	misisip'i'o
misoo	miso'o
mistera	mister'a
misteraj	mister'a'j
misterajn	mister'a'j'n
misteran	mister'a'n
mistere	mister'e
mistero	mister'o
misteroj	mister'o'j
misterojn	mister'o'j'n
misteron	mister'o'n
mistereco	mister'ec'o
mistifikas	mistifik'as
mistifiki	mistifik'i
mistifikis	mistifik'is
mistifiko	mistifik'o
mistika	mistik'a
mistikaj	mistik'a'j
mistikajn	mistik'a'j'n
mistikan	mistik'a'n
mistike	mistik'e
mistiko	mistik'o
mistikismo	mistik'ism'o
mistikismon	mistik'ism'o'n
mistikulo	mistik'ul'o
mistikuloj	mistik'ul'o'j
misuro	misur'o
misurio	misur'i'o
mita	mit'a
mitaj	mit'a'j
mitajn	mit'a'j'n
mitan	mit'a'n
mito	mit'o
mitoj	mit'o'j
mitojn	mit'o'j'n
miton	mit'o'n
mitu	mit'u
mitaro	mit'ar'o
mitologia	mit'olog'i'a
mitologiaj	mit'olog'i'a'j
mitologiajn	mit'olog'i'a'j'n
mitologian	mit'olog'i'a'n
mitologio	mit'olog'i'o
mitologioj	mit'olog'i'o'j
mitologion	mit'olog'i'o'n
mitingo	miting'o
mitingoj	miting'o'j
mitingon	miting'o'n
mitokondria	mitokondri'a
mitokondriaj	mitokondri'a'j
mitokondrian	mitokondri'a'n
mitokondrio	mitokondri'o
mitokondrioj	mitokondri'o'j
mitozo	mitoz'o
mitre	mitr'e
mitro	mitr'o
mitraismo	mitra'ism'o
mitrala	mitral'a
mitralo	mitral'o
mitraloj	mitral'o'j
mitralojn	mitral'o'j'n
mitraleto	mitral'et'o
mitraletoj	mitral'et'o'j
mitulo	mitul'o
mituloj	mitul'o'j
mitulojn	mitul'o'j'n
mizera	mizer'a
mizeraj	mizer'a'j
mizerajn	mizer'a'j'n
mizeran	mizer'a'n
mizeras	mizer'as
mizere	mizer'e
mizero	mizer'o
mizeroj	mizer'o'j
mizerojn	mizer'o'j'n
mizeron	mizer'o'n
mizereco	mizer'ec'o
mizerego	mizer'eg'o
mizerkvartaloj	mizer'kvartal'o'j
mizerulo	mizer'ul'o
mizeruloj	mizer'ul'o'j
mizerulojn	mizer'ul'o'j'n
mizerulon	mizer'ul'o'n
mizerikorda	mizerikord'a
mizerikordo	mizerikord'o
mizerikordon	mizerikord'o'n
mjelo	mjel'o
mjelon	mjel'o'n
mobilizas	mobiliz'as
mobilizi	mobiliz'i
mobilizis	mobiliz'is
mobilizo	mobiliz'o
mobilizon	mobiliz'o'n
mobilizado	mobiliz'ad'o
mobilizadon	mobiliz'ad'o'n
mobilizante	mobiliz'ant'e
mobilizita	mobiliz'it'a
mobilizitaj	mobiliz'it'a'j
moda	mod'a
modaj	mod'a'j
modajn	mod'a'j'n
modan	mod'a'n
mode	mod'e
modi	mod'i
modo	mod'o
modoj	mod'o'j
modojn	mod'o'j'n
modon	mod'o'n
modus	mod'us
modema	mod'em'a
modemaj	mod'em'a'j
modemo	mod'em'o
modemoj	mod'em'o'j
modemon	mod'em'o'n
modindustrio	mod'industri'o
modloko	mod'lok'o
modlokon	mod'lok'o'n
modokreantoj	mod'o'kre'ant'o'j
modala	modal'a
modalaj	modal'a'j
modalo	modal'o
modaloj	modal'o'j
modalon	modal'o'n
modaleco	modal'ec'o
modalecoj	modal'ec'o'j
modalecon	modal'ec'o'n
modela	model'a
modelaj	model'a'j
modelajn	model'a'j'n
modelan	model'a'n
modelas	model'as
modele	model'e
modeli	model'i
modelo	model'o
modeloj	model'o'j
modelojn	model'o'j'n
modelon	model'o'n
modelado	model'ad'o
modeliga	model'ig'a
modeligaj	model'ig'a'j
modeligas	model'ig'as
modeligi	model'ig'i
modeligis	model'ig'is
modeligo	model'ig'o
modeligado	model'ig'ad'o
modeligadon	model'ig'ad'o'n
modeligante	model'ig'ant'e
modeliganto	model'ig'ant'o
modeligita	model'ig'it'a
modeligitaj	model'ig'it'a'j
modelino	model'in'o
modelinoj	model'in'o'j
modelita	model'it'a
modelorganismoj	model'organism'o'j
modelparametroj	model'parametr'o'j
modelprojekto	model'projekt'o
modema	modem'a
modemaj	modem'a'j
modemo	modem'o
modemoj	modem'o'j
modemon	modem'o'n
modera	moder'a
moderaj	moder'a'j
moderajn	moder'a'j'n
moderan	moder'a'n
modere	moder'e
modero	moder'o
modereco	moder'ec'o
moderecon	moder'ec'o'n
moderigas	moder'ig'as
moderigi	moder'ig'i
moderigis	moder'ig'is
moderigo	moder'ig'o
moderigon	moder'ig'o'n
moderigu	moder'ig'u
moderigado	moder'ig'ad'o
moderigaĵo	moder'ig'aĵ'o
moderigaĵoj	moder'ig'aĵ'o'j
moderigante	moder'ig'ant'e
moderiganto	moder'ig'ant'o
moderigisto	moder'ig'ist'o
moderigita	moder'ig'it'a
moderigitaj	moder'ig'it'a'j
moderklimata	moder'klimat'a
moderklimataj	moder'klimat'a'j
moderulo	moder'ul'o
moderuloj	moder'ul'o'j
moderatoro	moderator'o
moderna	modern'a
modernaj	modern'a'j
modernajn	modern'a'j'n
modernan	modern'a'n
moderne	modern'e
moderno	modern'o
moderneco	modern'ec'o
modernecon	modern'ec'o'n
moderniga	modern'ig'a
modernigi	modern'ig'i
modernigis	modern'ig'is
modernigo	modern'ig'o
modernigon	modern'ig'o'n
modernigado	modern'ig'ad'o
modernigita	modern'ig'it'a
modernigitaj	modern'ig'it'a'j
moderniĝo	modern'iĝ'o
modernisma	modern'ism'a
modernismaj	modern'ism'a'j
modernismo	modern'ism'o
modernismon	modern'ism'o'n
modernisto	modern'ist'o
modernistoj	modern'ist'o'j
modernulo	modern'ul'o
modernuloj	modern'ul'o'j
modesta	modest'a
modestaj	modest'a'j
modestajn	modest'a'j'n
modestan	modest'a'n
modestas	modest'as
modeste	modest'e
modesto	modest'o
modesteco	modest'ec'o
modestecon	modest'ec'o'n
modifas	modif'as
modifi	modif'i
modifis	modif'is
modifo	modif'o
modifoj	modif'o'j
modifojn	modif'o'j'n
modifon	modif'o'n
modifos	modif'os
modifu	modif'u
modifado	modif'ad'o
modifante	modif'ant'e
modifebla	modif'ebl'a
modifiĝis	modif'iĝ'is
modifita	modif'it'a
modifitaj	modif'it'a'j
modifitajn	modif'it'a'j'n
modifitan	modif'it'a'n
modifite	modif'it'e
modli	modl'i
modlis	modl'is
modlado	modl'ad'o
modlaĵoj	modl'aĵ'o'j
modlebla	modl'ebl'a
modlita	modl'it'a
modula	modul'a
modulaj	modul'a'j
modulas	modul'as
module	modul'e
moduli	modul'i
modulis	modul'is
modulo	modul'o
moduloj	modul'o'j
modulojn	modul'o'j'n
modulon	modul'o'n
modulus	modul'us
modulado	modul'ad'o
moduladoj	modul'ad'o'j
moduladon	modul'ad'o'n
modulareco	modul'ar'ec'o
modulita	modul'it'a
modulitaj	modul'it'a'j
modulitan	modul'it'a'n
moka	mok'a
mokan	mok'a'n
mokas	mok'as
moke	mok'e
moki	mok'i
mokis	mok'is
moko	mok'o
mokoj	mok'o'j
mokojn	mok'o'j'n
mokon	mok'o'n
mokos	mok'os
moku	mok'u
mokus	mok'us
mokadis	mok'ad'is
mokado	mok'ad'o
mokadon	mok'ad'o'n
mokanta	mok'ant'a
mokante	mok'ant'e
mokata	mok'at'a
mokataj	mok'at'a'j
mokbirdo	mok'bird'o
mokema	mok'em'a
mokeman	mok'em'a'n
moketis	mok'et'is
mokinda	mok'ind'a
mokita	mok'it'a
mokitaj	mok'it'a'j
moknomis	mok'nom'is
moknomo	mok'nom'o
moknomoj	mok'nom'o'j
moknomojn	mok'nom'o'j'n
moknomon	mok'nom'o'n
moknomita	mok'nom'it'a
mokridis	mok'rid'is
mola	mol'a
molaj	mol'a'j
molajn	mol'a'j'n
molan	mol'a'n
molas	mol'as
mole	mol'e
molo	mol'o
molaĵoj	mol'aĵ'o'j
moleco	mol'ec'o
molecon	mol'ec'o'n
molfero	mol'fer'o
moligaj	mol'ig'a'j
moligas	mol'ig'as
moligi	mol'ig'i
moligis	mol'ig'is
moligita	mol'ig'it'a
moliĝas	mol'iĝ'as
moliĝi	mol'iĝ'i
moliĝis	mol'iĝ'is
molkora	mol'kor'a
molaroj	molar'o'j
moldava	moldav'a
moldavio	moldav'i'o
moleo	mole'o
moleon	mole'o'n
molekula	molekul'a
molekulaj	molekul'a'j
molekulajn	molekul'a'j'n
molekulan	molekul'a'n
molekulo	molekul'o
molekuloj	molekul'o'j
molekulojn	molekul'o'j'n
molekulon	molekul'o'n
molekulpezo	molekul'pez'o
molestas	molest'as
molesti	molest'i
molestis	molest'is
molestu	molest'u
molestado	molest'ad'o
molibdeno	molibden'o
molokanoj	molokan'o'j
molotro	molotr'o
molusko	molusk'o
moluskoj	molusk'o'j
moluskojn	molusk'o'j'n
momanto	momant'o
momanton	momant'o'n
momenta	moment'a
momentaj	moment'a'j
momentan	moment'a'n
momente	moment'e
momento	moment'o
momentoj	moment'o'j
momentojn	moment'o'j'n
momenton	moment'o'n
momentete	moment'et'e
momenteto	moment'et'o
momenteton	moment'et'o'n
momentfoto	moment'fot'o
mona	mon'a
monaj	mon'a'j
monajn	mon'a'j'n
monan	mon'a'n
mone	mon'e
mono	mon'o
monoj	mon'o'j
monojn	mon'o'j'n
monon	mon'o'n
monaro	mon'ar'o
monbileto	mon'bilet'o
monbiletoj	mon'bilet'o'j
monbiletojn	mon'bilet'o'j'n
monbileton	mon'bilet'o'n
mondonaco	mon'donac'o
mondonacoj	mon'donac'o'j
mondonacojn	mon'donac'o'j'n
mondonacon	mon'donac'o'n
monero	mon'er'o
moneroj	mon'er'o'j
monerojn	mon'er'o'j'n
moneron	mon'er'o'n
monfaris	mon'far'is
monfarita	mon'far'it'a
monfaritaj	mon'far'it'a'j
monfonduso	mon'fondus'o
monhelpi	mon'help'i
monhelpis	mon'help'is
monhelpo	mon'help'o
monhelpoj	mon'help'o'j
monhelpon	mon'help'o'n
monkesto	mon'kest'o
monkolekta	mon'kolekt'a
monkolekto	mon'kolekt'o
monkolekton	mon'kolekt'o'n
monkolektado	mon'kolekt'ad'o
monkompenson	mon'kompens'o'n
monkontribuon	mon'kontribu'o'n
monkultivaĵoj	mon'kultiv'aĵ'o'j
monlavado	mon'lav'ad'o
monmalfacilaĵoj	mon'mal'facil'aĵ'o'j
monomanko	mon'o'mank'o
monofero	mon'ofer'o
monpolitiko	mon'politik'o
monpolitikon	mon'politik'o'n
monproblemojn	mon'problem'o'j'n
monprovizo	mon'proviz'o
monprovizon	mon'proviz'o'n
monpunas	mon'pun'as
monpuno	mon'pun'o
monpunoj	mon'pun'o'j
monpunojn	mon'pun'o'j'n
monpunon	mon'pun'o'n
monpunita	mon'pun'it'a
monpunitaj	mon'pun'it'a'j
monrimedoj	mon'rimed'o'j
monrimedojn	mon'rimed'o'j'n
monsendaĵoj	mon'send'aĵ'o'j
monsistemo	mon'sistem'o
monsumo	mon'sum'o
monsumoj	mon'sum'o'j
monsumojn	mon'sum'o'j'n
monsumon	mon'sum'o'n
monŝranko	mon'ŝrank'o
monŝrankon	mon'ŝrank'o'n
monujo	mon'uj'o
monujoj	mon'uj'o'j
monujojn	mon'uj'o'j'n
monujon	mon'uj'o'n
monunio	mon'uni'o
monunua	mon'unu'a
monunuo	mon'unu'o
monunuoj	mon'unu'o'j
monunuon	mon'unu'o'n
monado	monad'o
monadoj	monad'o'j
monaĥa	monaĥ'a
monaĥaj	monaĥ'a'j
monaĥajn	monaĥ'a'j'n
monaĥan	monaĥ'a'n
monaĥo	monaĥ'o
monaĥoj	monaĥ'o'j
monaĥojn	monaĥ'o'j'n
monaĥon	monaĥ'o'n
monaĥeco	monaĥ'ec'o
monaĥeja	monaĥ'ej'a
monaĥejaj	monaĥ'ej'a'j
monaĥejan	monaĥ'ej'a'n
monaĥejo	monaĥ'ej'o
monaĥejoj	monaĥ'ej'o'j
monaĥejojn	monaĥ'ej'o'j'n
monaĥejon	monaĥ'ej'o'n
monaĥejestro	monaĥ'ej'estr'o
monaĥino	monaĥ'in'o
monaĥinoj	monaĥ'in'o'j
monaĥinojn	monaĥ'in'o'j'n
monaĥinejo	monaĥ'in'ej'o
monaĥinejoj	monaĥ'in'ej'o'j
monaĥinejon	monaĥ'in'ej'o'n
monaĥismo	monaĥ'ism'o
monako	monak'o
monakoj	monak'o'j
monakejo	monak'ej'o
monarĥa	monarĥ'a
monarĥo	monarĥ'o
monarĥio	monarĥ'i'o
monarĥion	monarĥ'i'o'n
monarko	monark'o
monarkoj	monark'o'j
monarkojn	monark'o'j'n
monarkon	monark'o'n
monarkia	monark'i'a
monarkian	monark'i'a'n
monarkio	monark'i'o
monarkioj	monark'i'o'j
monarkion	monark'i'o'n
monarkistoj	monark'ist'o'j
monastero	monaster'o
monata	monat'a
monataj	monat'a'j
monatajn	monat'a'j'n
monatan	monat'a'n
monate	monat'e
monato	monat'o
monatoj	monat'o'j
monatojn	monat'o'j'n
monaton	monat'o'n
monatfino	monat'fin'o
monda	mond'a
mondaj	mond'a'j
mondajn	mond'a'j'n
mondan	mond'a'n
monde	mond'e
mondo	mond'o
mondoj	mond'o'j
mondojn	mond'o'j'n
mondon	mond'o'n
mondaferoj	mond'afer'o'j
mondanoj	mond'an'o'j
mondbildo	mond'bild'o
mondcivitana	mond'civit'an'a
mondcivitano	mond'civit'an'o
mondcivitanoj	mond'civit'an'o'j
mondĉampiono	mond'ĉampion'o
mondĉampioneco	mond'ĉampion'ec'o
mondĉampionecoj	mond'ĉampion'ec'o'j
mondeco	mond'ec'o
mondeto	mond'et'o
mondfama	mond'fam'a
mondfamaj	mond'fam'a'j
mondfaman	mond'fam'a'n
mondfederisma	mond'feder'ism'a
mondfederismo	mond'feder'ism'o
mondfederistoj	mond'feder'ist'o'j
mondgvidantoj	mond'gvid'ant'o'j
mondhistorio	mond'histori'o
mondkonata	mond'kon'at'a
mondkonataj	mond'kon'at'a'j
mondkoncepto	mond'koncept'o
mondkonceptoj	mond'koncept'o'j
mondkoncepton	mond'koncept'o'n
mondkongreso	mond'kongres'o
mondkonsilantaro	mond'konsil'ant'ar'o
mondlingva	mond'lingv'a
mondlingvo	mond'lingv'o
mondlingvoj	mond'lingv'o'j
mondlingvon	mond'lingv'o'n
mondliteraturo	mond'literatur'o
mondloĝantaro	mond'loĝ'ant'ar'o
mondmapo	mond'map'o
mondmilito	mond'milit'o
mondmilitoj	mond'milit'o'j
mondmiliton	mond'milit'o'n
mondmuziko	mond'muzik'o
mondofino	mond'o'fin'o
mondolingvo	mond'o'lingv'o
mondomilito	mond'o'milit'o
mondomilitoj	mond'o'milit'o'j
mondoparto	mond'o'part'o
mondopartoj	mond'o'part'o'j
mondopartojn	mond'o'part'o'j'n
mondoregiono	mond'o'region'o
mondoregionoj	mond'o'region'o'j
mondordo	mond'ord'o
mondpaca	mond'pac'a
mondpaco	mond'pac'o
mondpacon	mond'pac'o'n
mondparto	mond'part'o
mondpartoj	mond'part'o'j
mondpercepto	mond'percept'o
mondpercepton	mond'percept'o'n
mondpokalo	mond'pokal'o
mondpokalon	mond'pokal'o'n
mondpotenco	mond'potenc'o
mondregado	mond'reg'ad'o
mondregistaro	mond'reg'ist'ar'o
mondregistaron	mond'reg'ist'ar'o'n
mondregiono	mond'region'o
mondregionoj	mond'region'o'j
mondrigardo	mond'rigard'o
mondrigardoj	mond'rigard'o'j
mondrigardon	mond'rigard'o'n
mondsistemo	mond'sistem'o
mondskala	mond'skal'a
mondskalan	mond'skal'a'n
mondskale	mond'skal'e
monduma	mond'um'a
mondumaj	mond'um'a'j
mondumo	mond'um'o
mondurbo	mond'urb'o
mondvarmiĝo	mond'varm'iĝ'o
mondvarmiĝon	mond'varm'iĝ'o'n
mondvasta	mond'vast'a
mondvastan	mond'vast'a'n
mondvaste	mond'vast'e
mondvojaĝo	mond'vojaĝ'o
monedo	moned'o
monedoj	moned'o'j
mongola	mongol'a
mongolaj	mongol'a'j
mongolajn	mongol'a'j'n
mongolan	mongol'a'n
mongolo	mongol'o
mongoloj	mongol'o'j
mongolojn	mongol'o'j'n
mongolio	mongol'i'o
mongolion	mongol'i'o'n
mongolnacieca	mongol'naci'ec'a
mongolujo	mongol'uj'o
monismo	monism'o
monitora	monitor'a
monitoraj	monitor'a'j
monitoras	monitor'as
monitori	monitor'i
monitoris	monitor'is
monitoro	monitor'o
monitorado	monitor'ad'o
monitoradon	monitor'ad'o'n
monitoranta	monitor'ant'a
monitorante	monitor'ant'e
monitorita	monitor'it'a
monitoritaj	monitor'it'a'j
monofonio	mono'foni'o
monomero	mono'mer'o
monomeroj	mono'mer'o'j
monooksido	mono'oksid'o
monorelo	mono'rel'o
monoreloj	mono'rel'o'j
monosakaridoj	mono'sakar'id'o'j
monofiletika	monofiletik'a
monogamio	monogami'o
monogamion	monogami'o'n
monografio	monografi'o
monografioj	monografi'o'j
monografion	monografi'o'n
monogramo	monogram'o
monoikaj	monoik'a'j
monokromata	monokromat'a
monokromataj	monokromat'a'j
monolita	monolit'a
monolitaj	monolit'a'j
monolitan	monolit'a'n
monolito	monolit'o
monologo	monolog'o
monologoj	monolog'o'j
monologojn	monolog'o'j'n
monologon	monolog'o'n
monomorfioj	monomorfi'o'j
monopola	monopol'a
monopolan	monopol'a'n
monopolo	monopol'o
monopoloj	monopol'o'j
monopolojn	monopol'o'j'n
monopolon	monopol'o'n
monopoligi	monopol'ig'i
monopoligis	monopol'ig'is
monopolisma	monopol'ism'a
monopolistoj	monopol'ist'o'j
monoteisma	monoteism'a
monoteismaj	monoteism'a'j
monoteismo	monoteism'o
monoteismon	monoteism'o'n
monotipa	monotip'a
monotona	monoton'a
monotonaj	monoton'a'j
monotonan	monoton'a'n
monotone	monoton'e
monotoneco	monoton'ec'o
monotonecon	monoton'ec'o'n
monsinjoro	monsinjor'o
monstra	monstr'a
monstraj	monstr'a'j
monstrajn	monstr'a'j'n
monstran	monstr'a'n
monstre	monstr'e
monstro	monstr'o
monstroj	monstr'o'j
monstrojn	monstr'o'j'n
monstron	monstr'o'n
monstraĵo	monstr'aĵ'o
monstraĵoj	monstr'aĵ'o'j
monta	mont'a
montaj	mont'a'j
montajn	mont'a'j'n
montan	mont'a'n
monte	mont'e
monto	mont'o
montoj	mont'o'j
montojn	mont'o'j'n
monton	mont'o'n
montana	mont'an'a
montano	mont'an'o
montanoj	mont'an'o'j
montara	mont'ar'a
montaraj	mont'ar'a'j
montarajn	mont'ar'a'j'n
montaran	mont'ar'a'n
montaro	mont'ar'o
montaroj	mont'ar'o'j
montarojn	mont'ar'o'j'n
montaron	mont'ar'o'n
montaranoj	mont'ar'an'o'j
montararbaroj	mont'ar'arb'ar'o'j
montarmasivo	mont'ar'masiv'o
montarbaroj	mont'arb'ar'o'j
montbiciklado	mont'bicikl'ad'o
montburgo	mont'burg'o
montĉeno	mont'ĉen'o
montdeklivo	mont'dekliv'o
montdeklivoj	mont'dekliv'o'j
montego	mont'eg'o
montegoj	mont'eg'o'j
montegon	mont'eg'o'n
monteta	mont'et'a
montetaj	mont'et'a'j
montetan	mont'et'a'n
monteto	mont'et'o
montetoj	mont'et'o'j
montetojn	mont'et'o'j'n
monteton	mont'et'o'n
montetaro	mont'et'ar'o
montetopinto	mont'et'o'pint'o
montfendoj	mont'fend'o'j
montgrimpado	mont'grimp'ad'o
montgrimpantoj	mont'grimp'ant'o'j
montkanto	mont'kant'o
montoĉeno	mont'o'ĉen'o
montoĉenoj	mont'o'ĉen'o'j
montodeklivo	mont'o'dekliv'o
montodeklivoj	mont'o'dekliv'o'j
montodorso	mont'o'dors'o
montoflanko	mont'o'flank'o
montoflankoj	mont'o'flank'o'j
montogrimpado	mont'o'grimp'ad'o
montopasejo	mont'o'pas'ej'o
montopinto	mont'o'pint'o
montopintoj	mont'o'pint'o'j
montopintojn	mont'o'pint'o'j'n
montopinton	mont'o'pint'o'n
montosupro	mont'o'supr'o
montosupron	mont'o'supr'o'n
montpasejo	mont'pas'ej'o
montpasejoj	mont'pas'ej'o'j
montpiedo	mont'pied'o
montpinto	mont'pint'o
montpintoj	mont'pint'o'j
montpinton	mont'pint'o'n
montregiono	mont'region'o
montregionoj	mont'region'o'j
montsupro	mont'supr'o
montvalo	mont'val'o
montvaloj	mont'val'o'j
montvojo	mont'voj'o
montana	montan'a
montano	montan'o
montanoj	montan'o'j
montekarlo	montekarl'o
montenegra	montenegr'a
montenegraj	montenegr'a'j
montenegro	montenegr'o
montenegron	montenegr'o'n
montenegranoj	montenegr'an'o'j
montero	monter'o
montevideo	montevide'o
montmartre	montmartr'e
montmartro	montmartr'o
montpeliero	montpelier'o
montra	montr'a
montraj	montr'a'j
montras	montr'as
montri	montr'i
montris	montr'is
montro	montr'o
montroj	montr'o'j
montron	montr'o'n
montros	montr'os
montru	montr'u
montrus	montr'us
montradis	montr'ad'is
montrado	montr'ad'o
montradoj	montr'ad'o'j
montradojn	montr'ad'o'j'n
montradon	montr'ad'o'n
montraĵo	montr'aĵ'o
montraĵoj	montr'aĵ'o'j
montranta	montr'ant'a
montrantaj	montr'ant'a'j
montrantajn	montr'ant'a'j'n
montrantan	montr'ant'a'n
montrante	montr'ant'e
montrata	montr'at'a
montrataj	montr'at'a'j
montratas	montr'at'as
montrebla	montr'ebl'a
montregi	montr'eg'i
montriĝas	montr'iĝ'as
montriĝi	montr'iĝ'i
montriĝis	montr'iĝ'is
montriĝo	montr'iĝ'o
montriĝos	montr'iĝ'os
montriĝu	montr'iĝ'u
montriĝus	montr'iĝ'us
montrilo	montr'il'o
montriloj	montr'il'o'j
montrilojn	montr'il'o'j'n
montrilon	montr'il'o'n
montrinta	montr'int'a
montrinte	montr'int'e
montrita	montr'it'a
montritaj	montr'it'a'j
montritajn	montr'it'a'j'n
montritan	montr'it'a'n
montrite	montr'it'e
montrofenestro	montr'o'fenestr'o
montrofenestroj	montr'o'fenestr'o'j
montrofenestron	montr'o'fenestr'o'n
montrofingro	montr'o'fingr'o
montrofingron	montr'o'fingr'o'n
montreala	montreal'a
montrealo	montreal'o
monumenta	monument'a
monumentaj	monument'a'j
monumentajn	monument'a'j'n
monumentan	monument'a'n
monumento	monument'o
monumentoj	monument'o'j
monumentojn	monument'o'j'n
monumenton	monument'o'n
monumentprotektita	monument'protekt'it'a
mopso	mops'o
mora	mor'a
moran	mor'a'n
more	mor'e
moro	mor'o
moroj	mor'o'j
morojn	mor'o'j'n
moron	mor'o'n
morao	mora'o
moraoj	mora'o'j
morala	moral'a
moralaj	moral'a'j
moralajn	moral'a'j'n
moralan	moral'a'n
morale	moral'e
moralo	moral'o
moraloj	moral'o'j
moralon	moral'o'n
moraleco	moral'ec'o
moralecon	moral'ec'o'n
moralfilozofio	moral'filozof'i'o
moralismo	moral'ism'o
moralisto	moral'ist'o
moralistoj	moral'ist'o'j
moralprediki	moral'predik'i
moralprincipoj	moral'princip'o'j
moratorio	moratori'o
moratorion	moratori'o'n
morava	morav'a
moravo	morav'o
moravia	morav'i'a
moraviaj	morav'i'a'j
moravio	morav'i'o
moravion	morav'i'o'n
morbilo	morbil'o
morda	mord'a
mordas	mord'as
mordi	mord'i
mordis	mord'is
mordo	mord'o
mordoj	mord'o'j
mordon	mord'o'n
mordos	mord'os
mordu	mord'u
mordus	mord'us
mordadis	mord'ad'is
mordado	mord'ad'o
mordaĵo	mord'aĵ'o
mordanta	mord'ant'a
mordante	mord'ant'e
mordanto	mord'ant'o
mordema	mord'em'a
mordeti	mord'et'i
mordetis	mord'et'is
mordita	mord'it'a
morditaj	mord'it'a'j
mordeĥajo	mordeĥaj'o
morena	moren'a
moreno	moren'o
morfeo	morfe'o
morfemo	morfem'o
morfemoj	morfem'o'j
morfemojn	morfem'o'j'n
morfemon	morfem'o'n
morfino	morfin'o
morfinon	morfin'o'n
morfologia	morfologi'a
morfologiaj	morfologi'a'j
morfologiajn	morfologi'a'j'n
morfologian	morfologi'a'n
morfologie	morfologi'e
morfologio	morfologi'o
morfologioj	morfologi'o'j
morfologion	morfologi'o'n
morgaŭ	morgaŭ
morgaŭa	morgaŭ'a
morgaŭaj	morgaŭ'a'j
morgaŭan	morgaŭ'a'n
morgaŭe	morgaŭ'e
morgaŭo	morgaŭ'o
morgaŭon	morgaŭ'o'n
mormona	mormon'a
mormonaj	mormon'a'j
mormono	mormon'o
mormonoj	mormon'o'j
mormonismo	mormon'ism'o
morna	morn'a
mornaj	morn'a'j
mornan	morn'a'n
morne	morn'e
moroza	moroz'a
morsa	mors'a
morse	mors'e
morso	mors'o
morta	mort'a
mortaj	mort'a'j
mortajn	mort'a'j'n
mortan	mort'a'n
mortas	mort'as
morte	mort'e
morti	mort'i
mortis	mort'is
morto	mort'o
mortoj	mort'o'j
mortojn	mort'o'j'n
morton	mort'o'n
mortos	mort'os
mortu	mort'u
mortus	mort'us
mortadis	mort'ad'is
mortado	mort'ad'o
mortanta	mort'ant'a
mortantaj	mort'ant'a'j
mortantan	mort'ant'a'n
mortante	mort'ant'e
mortanto	mort'ant'o
mortantoj	mort'ant'o'j
mortbatas	mort'bat'as
mortbati	mort'bat'i
mortbatis	mort'bat'is
mortbatos	mort'bat'os
morteco	mort'ec'o
mortecon	mort'ec'o'n
mortema	mort'em'a
mortemaj	mort'em'a'j
morteman	mort'em'a'n
mortemulo	mort'em'ul'o
mortemuloj	mort'em'ul'o'j
mortenketo	mort'enket'o
mortipovuloj	mort'i'pov'ul'o'j
mortiga	mort'ig'a
mortigaj	mort'ig'a'j
mortigajn	mort'ig'a'j'n
mortigan	mort'ig'a'n
mortigas	mort'ig'as
mortige	mort'ig'e
mortigi	mort'ig'i
mortigis	mort'ig'is
mortigo	mort'ig'o
mortigoj	mort'ig'o'j
mortigojn	mort'ig'o'j'n
mortigon	mort'ig'o'n
mortigos	mort'ig'os
mortigu	mort'ig'u
mortigus	mort'ig'us
mortigadis	mort'ig'ad'is
mortigado	mort'ig'ad'o
mortiganta	mort'ig'ant'a
mortigante	mort'ig'ant'e
mortiganto	mort'ig'ant'o
mortigata	mort'ig'at'a
mortigataj	mort'ig'at'a'j
mortiginta	mort'ig'int'a
mortiginte	mort'ig'int'e
mortiginto	mort'ig'int'o
mortigisto	mort'ig'ist'o
mortigita	mort'ig'it'a
mortigitaj	mort'ig'it'a'j
mortigitajn	mort'ig'it'a'j'n
mortigitis	mort'ig'it'is
mortigito	mort'ig'it'o
mortigitoj	mort'ig'it'o'j
mortiĝas	mort'iĝ'as
mortiĝi	mort'iĝ'i
mortiĝis	mort'iĝ'is
mortiĝo	mort'iĝ'o
mortiĝoj	mort'iĝ'o'j
mortindico	mort'indic'o
mortinta	mort'int'a
mortintaj	mort'int'a'j
mortintajn	mort'int'a'j'n
mortintan	mort'int'a'n
mortintas	mort'int'as
mortinte	mort'int'e
mortinto	mort'int'o
mortintoj	mort'int'o'j
mortintojn	mort'int'o'j'n
mortinton	mort'int'o'n
mortintus	mort'int'us
mortintino	mort'int'in'o
mortintinon	mort'int'in'o'n
mortintotuko	mort'int'o'tuk'o
mortita	mort'it'a
mortitaj	mort'it'a'j
mortkondamnis	mort'kondamn'is
mortkondamno	mort'kondamn'o
mortkondamnon	mort'kondamn'o'n
mortkondamnita	mort'kondamn'it'a
mortlito	mort'lit'o
mortmemoro	mort'memor'o
mortnombro	mort'nombr'o
mortokaŭzo	mort'o'kaŭz'o
mortokaŭzoj	mort'o'kaŭz'o'j
mortokaŭzon	mort'o'kaŭz'o'n
mortokondamno	mort'o'kondamn'o
mortokvanto	mort'o'kvant'o
mortolito	mort'o'lit'o
mortoprocentaĵo	mort'o'procent'aĵ'o
mortoprocentaĵoj	mort'o'procent'aĵ'o'j
mortopuno	mort'o'pun'o
mortopunon	mort'o'pun'o'n
mortotimo	mort'o'tim'o
mortotuko	mort'o'tuk'o
mortofteco	mort'oft'ec'o
mortoftecoj	mort'oft'ec'o'j
mortonta	mort'ont'a
mortontaj	mort'ont'a'j
mortonte	mort'ont'e
mortonto	mort'ont'o
mortontoj	mort'ont'o'j
mortpafas	mort'paf'as
mortpafi	mort'paf'i
mortpafis	mort'paf'is
mortpafos	mort'paf'os
mortpafita	mort'paf'it'a
mortpafitaj	mort'paf'it'a'j
mortpiki	mort'pik'i
mortpuno	mort'pun'o
mortpunon	mort'pun'o'n
mortula	mort'ul'a
mortulo	mort'ul'o
mortuloj	mort'ul'o'j
mortero	morter'o
morteroj	morter'o'j
morteron	morter'o'n
mortezo	mortez'o
moruo	moru'o
moruoj	moru'o'j
morusarboj	morus'arb'o'j
morvan	morv'a'n
moska	mosk'a
mosko	mosk'o
moskulo	mosk'ul'o
moskeo	moske'o
moskeoj	moske'o'j
moskeojn	moske'o'j'n
moskeon	moske'o'n
moskito	moskit'o
moskitoj	moskit'o'j
moskitojn	moskit'o'j'n
moskva	moskv'a
moskvaj	moskv'a'j
moskvan	moskv'a'n
moskvo	moskv'o
moskvon	moskv'o'n
moskvano	moskv'an'o
moskvanoj	moskv'an'o'j
mosta	most'a
mosto	most'o
moŝta	moŝt'a
moŝto	moŝt'o
moŝtoj	moŝt'o'j
moŝton	moŝt'o'n
moŝtino	moŝt'in'o
moŝtuloj	moŝt'ul'o'j
moto	mot'o
motoj	mot'o'j
moton	mot'o'n
moteto	mot'et'o
motetoj	mot'et'o'j
motacilo	motacil'o
motaciloj	motacil'o'j
motelo	motel'o
moteto	motet'o
motetoj	motet'o'j
motiva	motiv'a
motivas	motiv'as
motivi	motiv'i
motivis	motiv'is
motivo	motiv'o
motivoj	motiv'o'j
motivojn	motiv'o'j'n
motivon	motiv'o'n
motivado	motiv'ad'o
motivigas	motiv'ig'as
motivigi	motiv'ig'i
motivigis	motiv'ig'is
motivigo	motiv'ig'o
motivigoj	motiv'ig'o'j
motivigon	motiv'ig'o'n
motivigita	motiv'ig'it'a
motivigitaj	motiv'ig'it'a'j
motiviĝo	motiv'iĝ'o
motivita	motiv'it'a
motivitaj	motiv'it'a'j
motora	motor'a
motoraj	motor'a'j
motorajn	motor'a'j'n
motoran	motor'a'n
motoro	motor'o
motoroj	motor'o'j
motorojn	motor'o'j'n
motoron	motor'o'n
motorbiciklo	motor'bicikl'o
motorbiciklon	motor'bicikl'o'n
motorboato	motor'boat'o
motorboatoj	motor'boat'o'j
motorcikla	motor'cikl'a
motorciklo	motor'cikl'o
motorcikloj	motor'cikl'o'j
motorciklojn	motor'cikl'o'j'n
motorciklon	motor'cikl'o'n
motorciklistoj	motor'cikl'ist'o'j
motordezajno	motor'dezajn'o
motorizita	motor'iz'it'a
motorizitaj	motor'iz'it'a'j
motorizitan	motor'iz'it'a'n
motorkontrolo	motor'kontrol'o
motorkortekso	motor'korteks'o
motorpaneo	motor'pane'o
motorrapideco	motor'rapid'ec'o
motortrajnoj	motor'trajn'o'j
motorveturilo	motor'vetur'il'o
motorveturiloj	motor'vetur'il'o'j
mova	mov'a
movaj	mov'a'j
movajn	mov'a'j'n
movan	mov'a'n
movas	mov'as
movi	mov'i
movis	mov'is
movo	mov'o
movoj	mov'o'j
movojn	mov'o'j'n
movon	mov'o'n
movos	mov'os
movu	mov'u
movus	mov'us
movada	mov'ad'a
movadaj	mov'ad'a'j
movadajn	mov'ad'a'j'n
movadan	mov'ad'a'n
movade	mov'ad'e
movadis	mov'ad'is
movado	mov'ad'o
movadoj	mov'ad'o'j
movadojn	mov'ad'o'j'n
movadon	mov'ad'o'n
movadano	mov'ad'an'o
movadanoj	mov'ad'an'o'j
movadeca	mov'ad'ec'a
movadestroj	mov'ad'estr'o'j
movanta	mov'ant'a
movantaj	mov'ant'a'j
movantajn	mov'ant'a'j'n
movantan	mov'ant'a'n
movante	mov'ant'e
movaparato	mov'aparat'o
movata	mov'at'a
movataj	mov'at'a'j
movbilda	mov'bild'a
movebla	mov'ebl'a
moveblaj	mov'ebl'a'j
moveblajn	mov'ebl'a'j'n
moveblan	mov'ebl'a'n
movebleco	mov'ebl'ec'o
movetis	mov'et'is
movforto	mov'fort'o
movforton	mov'fort'o'n
movigas	mov'ig'as
movigi	mov'ig'i
moviĝas	mov'iĝ'as
moviĝi	mov'iĝ'i
moviĝis	mov'iĝ'is
moviĝo	mov'iĝ'o
moviĝoj	mov'iĝ'o'j
moviĝojn	mov'iĝ'o'j'n
moviĝon	mov'iĝ'o'n
moviĝos	mov'iĝ'os
moviĝu	mov'iĝ'u
moviĝus	mov'iĝ'us
moviĝadis	mov'iĝ'ad'is
moviĝado	mov'iĝ'ad'o
moviĝanta	mov'iĝ'ant'a
moviĝantaj	mov'iĝ'ant'a'j
moviĝantajn	mov'iĝ'ant'a'j'n
moviĝantan	mov'iĝ'ant'a'n
moviĝante	mov'iĝ'ant'e
moviĝeblo	mov'iĝ'ebl'o
moviĝeblon	mov'iĝ'ebl'o'n
moviĝema	mov'iĝ'em'a
moviĝemaj	mov'iĝ'em'a'j
moviĝemajn	mov'iĝ'em'a'j'n
moviĝeman	mov'iĝ'em'a'n
moviĝemo	mov'iĝ'em'o
moviĝemon	mov'iĝ'em'o'n
movinte	mov'int'e
movita	mov'it'a
movitaj	mov'it'a'j
movitajn	mov'it'a'j'n
movitan	mov'it'a'n
movite	mov'it'e
movkapablo	mov'kapabl'o
movmalkapablo	mov'mal'kapabl'o
movmalsano	mov'mal'san'o
movoforton	mov'o'fort'o'n
movokvanto	mov'o'kvant'o
movokvanton	mov'o'kvant'o'n
movoplena	mov'o'plen'a
movimento	moviment'o
movimentoj	moviment'o'j
movimentojn	moviment'o'j'n
movimenton	moviment'o'n
mozo	moz'o
mozaika	mozaik'a
mozaiko	mozaik'o
mozaikoj	mozaik'o'j
mozaikojn	mozaik'o'j'n
mozaikon	mozaik'o'n
mozambika	mozambik'a
mozambiko	mozambik'o
mozaraboj	mozarab'o'j
mozarto	mozart'o
mozelo	mozel'o
mozio	mozi'o
mucida	mucid'a
muela	muel'a
muelas	muel'as
mueli	muel'i
muelis	muel'is
muelado	muel'ad'o
muelante	muel'ant'e
muelejo	muel'ej'o
muelejoj	muel'ej'o'j
muelejojn	muel'ej'o'j'n
muelejon	muel'ej'o'n
muelilo	muel'il'o
mueliloj	muel'il'o'j
muelilojn	muel'il'o'j'n
muelisto	muel'ist'o
muelistoj	muel'ist'o'j
muelita	muel'it'a
muelitaj	muel'it'a'j
muelitan	muel'it'a'n
muelŝtonoj	muel'ŝton'o'j
muezino	muezin'o
muftio	mufti'o
muĝas	muĝ'as
muĝi	muĝ'i
muĝis	muĝ'is
muĝo	muĝ'o
muĝon	muĝ'o'n
muĝado	muĝ'ad'o
muĝadon	muĝ'ad'o'n
muĝanta	muĝ'ant'a
muĝante	muĝ'ant'e
muka	muk'a
muko	muk'o
mukon	muk'o'n
mukoviskozeco	muk'o'viskoz'ec'o
mukoza	mukoz'a
mukozaj	mukoz'a'j
mukozo	mukoz'o
mukozoj	mukoz'o'j
mula	mul'a
mulan	mul'a'n
mulo	mul'o
muloj	mul'o'j
mulon	mul'o'n
mulaoj	mula'o'j
mulato	mulat'o
mulatoj	mulat'o'j
muldi	muld'i
muldis	muld'is
muldado	muld'ad'o
muldebla	muld'ebl'a
muldilo	muld'il'o
muldiloj	muld'il'o'j
muldilon	muld'il'o'n
muldita	muld'it'a
mulditaj	muld'it'a'j
multa	mult'a
multaj	mult'a'j
multajn	mult'a'j'n
multan	mult'a'n
multas	mult'as
multe	mult'e
multi	mult'i
multis	mult'is
multo	mult'o
multoj	mult'o'j
multojn	mult'o'j'n
multon	mult'o'n
multĉela	mult'ĉel'a
multĉelaj	mult'ĉel'a'j
multefoje	mult'e'foj'e
multekosta	mult'e'kost'a
multekostaj	mult'e'kost'a'j
multekostajn	mult'e'kost'a'j'n
multekostan	mult'e'kost'a'n
multekostas	mult'e'kost'as
multekoste	mult'e'kost'e
multekosteco	mult'e'kost'ec'o
multekuirilo	mult'e'kuir'il'o
multenombra	mult'e'nombr'a
multenombraj	mult'e'nombr'a'j
multenombrajn	mult'e'nombr'a'j'n
multenombran	mult'e'nombr'a'n
multenombre	mult'e'nombr'e
multenombro	mult'e'nombr'o
multenombron	mult'e'nombr'o'n
multeco	mult'ec'o
multecon	mult'ec'o'n
multega	mult'eg'a
multegaj	mult'eg'a'j
multegajn	mult'eg'a'j'n
multegan	mult'eg'a'n
multege	mult'eg'e
multego	mult'eg'o
multegon	mult'eg'o'n
multetaĝaj	mult'etaĝ'a'j
multetna	mult'etn'a
multfaceta	mult'fac'et'a
multfacetaj	mult'fac'et'a'j
multfacetajn	mult'fac'et'a'j'n
multfacetan	mult'fac'et'a'n
multfacete	mult'fac'et'e
multfacetita	mult'fac'et'it'a
multfaka	mult'fak'a
multflanka	mult'flank'a
multflankaj	mult'flank'a'j
multflankan	mult'flank'a'n
multflanke	mult'flank'e
multflankeco	mult'flank'ec'o
multfoja	mult'foj'a
multfojaj	mult'foj'a'j
multfoje	mult'foj'e
multforma	mult'form'a
multidisciplina	mult'i'disciplin'a
multidisciplinaj	mult'i'disciplin'a'j
multidisciplinan	mult'i'disciplin'a'n
multiludanto	mult'i'lud'ant'o
multimodala	mult'i'modal'a
multimodaleco	mult'i'modal'ec'o
multigas	mult'ig'as
multigi	mult'ig'i
multigis	mult'ig'is
multigo	mult'ig'o
multigos	mult'ig'os
multigu	mult'ig'u
multigado	mult'ig'ad'o
multiĝas	mult'iĝ'as
multiĝi	mult'iĝ'i
multiĝis	mult'iĝ'is
multiĝo	mult'iĝ'o
multiĝos	mult'iĝ'os
multiĝu	mult'iĝ'u
multjara	mult'jar'a
multjaraj	mult'jar'a'j
multjarajn	mult'jar'a'j'n
multjaran	mult'jar'a'n
multjare	mult'jar'e
multjarcenta	mult'jar'cent'a
multkolora	mult'kolor'a
multkoloraj	mult'kolor'a'j
multkolorajn	mult'kolor'a'j'n
multkoloran	mult'kolor'a'n
multkosta	mult'kost'a
multkostaj	mult'kost'a'j
multkultura	mult'kultur'a
multkulturaj	mult'kultur'a'j
multkulturan	mult'kultur'a'n
multkultureco	mult'kultur'ec'o
multkulturismo	mult'kultur'ism'o
multkulturismon	mult'kultur'ism'o'n
multlingva	mult'lingv'a
multlingvaj	mult'lingv'a'j
multlingvan	mult'lingv'a'n
multlingve	mult'lingv'e
multlingveco	mult'lingv'ec'o
multlingvecon	mult'lingv'ec'o'n
multlingvismo	mult'lingv'ism'o
multloka	mult'lok'a
multloke	mult'lok'e
multmaniere	mult'manier'e
multmedia	mult'medi'a
multmediaj	mult'medi'a'j
multmediajn	mult'medi'a'j'n
multmedian	mult'medi'a'n
multmediludilo	mult'medi'lud'il'o
multnacia	mult'naci'a
multnaciaj	mult'naci'a'j
multnombra	mult'nombr'a
multnombraj	mult'nombr'a'j
multnombrajn	mult'nombr'a'j'n
multnombran	mult'nombr'a'n
multnombre	mult'nombr'e
multnombro	mult'nombr'o
multnombron	mult'nombr'o'n
multnombroformularo	mult'nombr'o'formul'ar'o
multobla	mult'obl'a
multoblaj	mult'obl'a'j
multoblajn	mult'obl'a'j'n
multoblan	mult'obl'a'n
multoble	mult'obl'e
multoblo	mult'obl'o
multobloj	mult'obl'o'j
multoblon	mult'obl'o'n
multobligas	mult'obl'ig'as
multobligi	mult'obl'ig'i
multobligis	mult'obl'ig'is
multobligo	mult'obl'ig'o
multobligon	mult'obl'ig'o'n
multobligado	mult'obl'ig'ad'o
multobligante	mult'obl'ig'ant'e
multobligita	mult'obl'ig'it'a
multobligitaj	mult'obl'ig'it'a'j
multobliĝas	mult'obl'iĝ'as
multobliĝi	mult'obl'iĝ'i
multobliĝis	mult'obl'iĝ'is
multobliĝo	mult'obl'iĝ'o
multope	mult'op'e
multrasa	mult'ras'a
multrasaj	mult'ras'a'j
multrilate	mult'rilat'e
multrimedaj	mult'rimed'a'j
multspeca	mult'spec'a
multspecaj	mult'spec'a'j
multspecajn	mult'spec'a'j'n
multuloj	mult'ul'o'j
multuniverso	mult'univers'o
multvalora	mult'valor'a
multvaloraj	mult'valor'a'j
multvaloran	mult'valor'a'n
multano	multan'o
multiplika	multiplik'a
multipliko	multiplik'o
multiplikon	multiplik'o'n
multiplikato	multiplik'at'o
multiplikita	multiplik'it'a
mumio	mumi'o
mumioj	mumi'o'j
mumiojn	mumi'o'j'n
mumion	mumi'o'n
municio	munici'o
municioj	munici'o'j
municiojn	munici'o'j'n
municion	munici'o'n
municipa	municip'a
municipaj	municip'a'j
municipajn	municip'a'j'n
municipan	municip'a'n
municipo	municip'o
municipoj	municip'o'j
municipojn	municip'o'j'n
municipon	municip'o'n
muntas	munt'as
munti	munt'i
muntis	munt'is
muntado	munt'ad'o
muntadoj	munt'ad'o'j
muntadon	munt'ad'o'n
muntaĵo	munt'aĵ'o
muntisto	munt'ist'o
muntita	munt'it'a
muntitaj	munt'it'a'j
muntoĉeno	munt'o'ĉen'o
mura	mur'a
muraj	mur'a'j
mure	mur'e
muro	mur'o
muroj	mur'o'j
murojn	mur'o'j'n
muron	mur'o'n
murangulo	mur'angul'o
muraro	mur'ar'o
murego	mur'eg'o
muregoj	mur'eg'o'j
muregojn	mur'eg'o'j'n
muregon	mur'eg'o'n
mureto	mur'et'o
murhorloĝo	mur'horloĝ'o
murpentraĵo	mur'pentr'aĵ'o
murpentraĵoj	mur'pentr'aĵ'o'j
murŝranko	mur'ŝrank'o
murda	murd'a
murdas	murd'as
murdi	murd'i
murdis	murd'is
murdo	murd'o
murdoj	murd'o'j
murdojn	murd'o'j'n
murdon	murd'o'n
murdos	murd'os
murdu	murd'u
murdus	murd'us
murdado	murd'ad'o
murdadon	murd'ad'o'n
murdante	murd'ant'e
murdanto	murd'ant'o
murdata	murd'at'a
murdema	murd'em'a
murdinto	murd'int'o
murdintoj	murd'int'o'j
murdintojn	murd'int'o'j'n
murdinton	murd'int'o'n
murdisto	murd'ist'o
murdistoj	murd'ist'o'j
murdistojn	murd'ist'o'j'n
murdiston	murd'ist'o'n
murdita	murd'it'a
murditaj	murd'it'a'j
murdito	murd'it'o
murditoj	murd'it'o'j
murmuras	murmur'as
murmure	murmur'e
murmuri	murmur'i
murmuris	murmur'is
murmuro	murmur'o
murmuroj	murmur'o'j
murmuron	murmur'o'n
murmurado	murmur'ad'o
murmuradon	murmur'ad'o'n
murmurante	murmur'ant'e
murmuregas	murmur'eg'as
murmuretis	murmur'et'is
musa	mus'a
muse	mus'e
muso	mus'o
musoj	mus'o'j
musojn	mus'o'j'n
muson	mus'o'n
museto	mus'et'o
musklaku	mus'klak'u
muska	musk'a
musko	musk'o
muskoj	musk'o'j
muskon	musk'o'n
muskokovrita	musk'o'kovr'it'a
muskato	muskat'o
muskatfloro	muskat'flor'o
muskedistoj	musked'ist'o'j
muskola	muskol'a
muskolaj	muskol'a'j
muskolajn	muskol'a'j'n
muskolan	muskol'a'n
muskolo	muskol'o
muskoloj	muskol'o'j
muskolojn	muskol'o'j'n
muskolon	muskol'o'n
muskolaro	muskol'ar'o
muskolaron	muskol'ar'o'n
muskolĉeloj	muskol'ĉel'o'j
muskolfibro	muskol'fibr'o
muskolfibroj	muskol'fibr'o'j
muskolforto	muskol'fort'o
muskolhava	muskol'hav'a
muslimoj	muslim'o'j
muslino	muslin'o
musona	muson'a
musono	muson'o
musonoj	muson'o'j
musonsezono	muson'sezon'o
mustardo	mustard'o
mustardon	mustard'o'n
mustela	mustel'a
mustelo	mustel'o
musteloj	mustel'o'j
mustelon	mustel'o'n
musteledoj	mustel'ed'o'j
mustelidoj	mustel'id'o'j
musho	muŝ'o
muŝo	muŝ'o
muŝoj	muŝ'o'j
muŝojn	muŝ'o'j'n
muŝon	muŝ'o'n
muŝkaptulo	muŝ'kapt'ul'o
muŝkaptuledoj	muŝ'kapt'ul'ed'o'j
muta	mut'a
mutaj	mut'a'j
mutajn	mut'a'j'n
mutan	mut'a'n
mutas	mut'as
mute	mut'e
mutis	mut'is
muteco	mut'ec'o
mutecon	mut'ec'o'n
mutigis	mut'ig'is
mutiĝis	mut'iĝ'is
mutulo	mut'ul'o
mutuloj	mut'ul'o'j
mutacia	mutaci'a
mutacias	mutaci'as
mutacii	mutaci'i
mutacio	mutaci'o
mutacioj	mutaci'o'j
mutaciojn	mutaci'o'j'n
mutacion	mutaci'o'n
mutaciitaj	mutaci'it'a'j
mutaciuloj	mutaci'ul'o'j
mutilis	mutil'is
mutilita	mutil'it'a
mutuala	mutual'a
mutualismo	mutual'ism'o
muzo	muz'o
muzoj	muz'o'j
muzon	muz'o'n
muzea	muze'a
muzeaj	muze'a'j
muzean	muze'a'n
muzeo	muze'o
muzeoj	muze'o'j
muzeojn	muze'o'j'n
muzeon	muze'o'n
muzelo	muzel'o
muzeloj	muzel'o'j
muzelojn	muzel'o'j'n
muzelon	muzel'o'n
muzika	muzik'a
muzikaj	muzik'a'j
muzikajn	muzik'a'j'n
muzikan	muzik'a'n
muzikas	muzik'as
muzike	muzik'e
muziki	muzik'i
muzikis	muzik'is
muziko	muzik'o
muzikoj	muzik'o'j
muzikojn	muzik'o'j'n
muzikon	muzik'o'n
muzikado	muzik'ad'o
muzikadon	muzik'ad'o'n
muzikaĵo	muzik'aĵ'o
muzikaĵoj	muzik'aĵ'o'j
muzikaĵojn	muzik'aĵ'o'j'n
muzikaĵon	muzik'aĵ'o'n
muzikalbumo	muzik'album'o
muzikamantoj	muzik'am'ant'o'j
muzikanto	muzik'ant'o
muzikantoj	muzik'ant'o'j
muzikbando	muzik'band'o
muzikdirektoro	muzik'direktor'o
muzikedukado	muzik'eduk'ad'o
muzikeldonejo	muzik'el'don'ej'o
muzikeldonejoj	muzik'el'don'ej'o'j
muzikema	muzik'em'a
muzikfilmeto	muzik'film'et'o
muzikfilmetoj	muzik'film'et'o'j
muzikgrupo	muzik'grup'o
muzikgrupoj	muzik'grup'o'j
muzikĝenro	muzik'ĝenr'o
muzikĝenroj	muzik'ĝenr'o'j
muzikhistorio	muzik'histori'o
muzikigis	muzik'ig'is
muzikigo	muzik'ig'o
muzikila	muzik'il'a
muzikilo	muzik'il'o
muzikiloj	muzik'il'o'j
muzikilojn	muzik'il'o'j'n
muzikilon	muzik'il'o'n
muzikinstruisto	muzik'instru'ist'o
muzikinstrumento	muzik'instrument'o
muzikinstrumentoj	muzik'instrument'o'j
muzikinstrumentojn	muzik'instrument'o'j'n
muzikinstrumenton	muzik'instrument'o'n
muzikista	muzik'ist'a
muzikisto	muzik'ist'o
muzikistoj	muzik'ist'o'j
muzikistojn	muzik'ist'o'j'n
muzikiston	muzik'ist'o'n
muzikistaro	muzik'ist'ar'o
muzikistino	muzik'ist'in'o
muzikkulturo	muzik'kultur'o
muziklernejo	muzik'lern'ej'o
muziklernejoj	muzik'lern'ej'o'j
muziknota	muzik'not'a
muziknotoj	muzik'not'o'j
muziknotojn	muzik'not'o'j'n
muzikoterapio	muzik'o'terapi'o
muzikologio	muzik'olog'i'o
muzikpeco	muzik'pec'o
muzikpecoj	muzik'pec'o'j
muzikpecojn	muzik'pec'o'j'n
muzikscienco	muzik'scienc'o
muzikstilo	muzik'stil'o
muzikstiloj	muzik'stil'o'j
muzikteorio	muzik'teori'o
muziktradicioj	muzik'tradici'o'j
muzikalo	muzikal'o
muzikaloj	muzikal'o'j
muzulmana	muzulman'a
muzulmanaj	muzulman'a'j
muzulmanoj	muzulman'o'j