nabo	nab'o
naboj	nab'o'j
nabon	nab'o'n
nabateo	nabate'o
nacia	naci'a
naciaj	naci'a'j
naciajn	naci'a'j'n
nacian	naci'a'n
nacie	naci'e
nacio	naci'o
nacioj	naci'o'j
naciojn	naci'o'j'n
nacion	naci'o'n
nacialeĝoj	naci'a'leĝ'o'j
nacianoj	naci'an'o'j
naciaro	naci'ar'o
nacidefenda	naci'defend'a
nacidefendo	naci'defend'o
nacieca	naci'ec'a
naciecaj	naci'ec'a'j
naciecajn	naci'ec'a'j'n
naciecan	naci'ec'a'n
nacieco	naci'ec'o
naciecoj	naci'ec'o'j
naciecojn	naci'ec'o'j'n
naciecon	naci'ec'o'n
naciecanoj	naci'ec'an'o'j
naciema	naci'em'a
naciestroj	naci'estr'o'j
nacigvardio	naci'gvardi'o
naciigi	naci'ig'i
naciigis	naci'ig'is
naciigita	naci'ig'it'a
naciigitaj	naci'ig'it'a'j
naciisma	naci'ism'a
naciismaj	naci'ism'a'j
naciismajn	naci'ism'a'j'n
naciisman	naci'ism'a'n
naciismo	naci'ism'o
naciismoj	naci'ism'o'j
naciismon	naci'ism'o'n
naciista	naci'ist'a
naciistaj	naci'ist'a'j
naciisto	naci'ist'o
naciistoj	naci'ist'o'j
naciistojn	naci'ist'o'j'n
naciistmovado	naci'ist'mov'ad'o
naciliberiga	naci'liber'ig'a
nacilingva	naci'lingv'a
nacilingvaj	naci'lingv'a'j
nacilingvajn	naci'lingv'a'j'n
nacilingvan	naci'lingv'a'n
nacilingve	naci'lingv'e
nacilingven	naci'lingv'e'n
nacilingvo	naci'lingv'o
nacilingvoj	naci'lingv'o'j
nacimalplimulta	naci'mal'pli'mult'a
nacimalplimultaj	naci'mal'pli'mult'a'j
nacimalplimultoj	naci'mal'pli'mult'o'j
naciminoritata	naci'minoritat'a
naciminoritataj	naci'minoritat'a'j
naciminoritato	naci'minoritat'o
naciminoritatoj	naci'minoritat'o'j
nacinivelaj	naci'nivel'a'j
nacioŝtato	naci'o'ŝtat'o
nacioŝtatoj	naci'o'ŝtat'o'j
nacisava	naci'sav'a
naciskale	naci'skal'e
nacisocialisma	naci'social'ism'a
nacisocialismo	naci'social'ism'o
nacisocialistoj	naci'social'ist'o'j
naciŝtato	naci'ŝtat'o
naciŝtatoj	naci'ŝtat'o'j
nacionalismo	nacionalism'o
nadiro	nadir'o
nadlo	nadl'o
nadloj	nadl'o'j
nadlon	nadl'o'n
nafta	naft'a
naftaj	naft'a'j
nafto	naft'o
naftoj	naft'o'j
nafton	naft'o'n
naftejoj	naft'ej'o'j
naftodukto	naft'o'dukt'o
naftogasa	naft'o'gas'a
naftogasaj	naft'o'gas'a'j
naftoindustrio	naft'o'industri'o
naftokampoj	naft'o'kamp'o'j
naftokompanio	naft'o'kompani'o
naftokompanioj	naft'o'kompani'o'j
naftomarĝenoj	naft'o'marĝen'o'j
naftoprezo	naft'o'prez'o
naftoprezoj	naft'o'prez'o'j
naftoproduktado	naft'o'produkt'ad'o
naftoputoj	naft'o'put'o'j
naftorafinado	naft'o'rafin'ad'o
naftorezervoj	naft'o'rezerv'o'j
naftoŝipo	naft'o'ŝip'o
naftaleno	naftalen'o
naĝas	naĝ'as
naĝi	naĝ'i
naĝis	naĝ'is
naĝo	naĝ'o
naĝos	naĝ'os
naĝu	naĝ'u
naĝadis	naĝ'ad'is
naĝado	naĝ'ad'o
naĝadon	naĝ'ad'o'n
naĝanta	naĝ'ant'a
naĝantaj	naĝ'ant'a'j
naĝantajn	naĝ'ant'a'j'n
naĝantan	naĝ'ant'a'n
naĝante	naĝ'ant'e
naĝanto	naĝ'ant'o
naĝantoj	naĝ'ant'o'j
naĝbaseno	naĝ'basen'o
naĝejo	naĝ'ej'o
naĝejoj	naĝ'ej'o'j
naĝejojn	naĝ'ej'o'j'n
naĝejon	naĝ'ej'o'n
naĝilo	naĝ'il'o
naĝiloj	naĝ'il'o'j
naĝilojn	naĝ'il'o'j'n
naĝilon	naĝ'il'o'n
naĝisto	naĝ'ist'o
naĝistoj	naĝ'ist'o'j
naĝujo	naĝ'uj'o
naĝujon	naĝ'uj'o'n
naiva	naiv'a
naivaj	naiv'a'j
naivajn	naiv'a'j'n
naivan	naiv'a'n
naivas	naiv'as
naive	naiv'e
naivo	naiv'o
naiveco	naiv'ec'o
naivecon	naiv'ec'o'n
naivulo	naiv'ul'o
naivuloj	naiv'ul'o'j
naivulojn	naiv'ul'o'j'n
naivulino	naiv'ul'in'o
najado	najad'o
najadoj	najad'o'j
najbara	najbar'a
najbaraj	najbar'a'j
najbarajn	najbar'a'j'n
najbaran	najbar'a'n
najbaras	najbar'as
najbare	najbar'e
najbaro	najbar'o
najbaroj	najbar'o'j
najbarojn	najbar'o'j'n
najbaron	najbar'o'n
najbaraĵo	najbar'aĵ'o
najbararo	najbar'ar'o
najbareco	najbar'ec'o
najbarecoj	najbar'ec'o'j
najbarecojn	najbar'ec'o'j'n
najbarecon	najbar'ec'o'n
najbarejo	najbar'ej'o
najbarino	najbar'in'o
najbarinoj	najbar'in'o'j
najbarinon	najbar'in'o'n
najbarlandoj	najbar'land'o'j
najlis	najl'is
najlo	najl'o
najloj	najl'o'j
najlojn	najl'o'j'n
najlon	najl'o'n
najlita	najl'it'a
najlitaj	najl'it'a'j
najtingalo	najtingal'o
najtingaloj	najtingal'o'j
najtingalon	najtingal'o'n
namuro	namur'o
nana	nan'a
nanaj	nan'a'j
nanajn	nan'a'j'n
nanan	nan'a'n
nano	nan'o
nanoj	nan'o'j
naneco	nan'ec'o
nanoplanedo	nan'o'planed'o
nancio	nanci'o
nankina	nankin'a
nankino	nankin'o
nanodratoj	nano'drat'o'j
nanofarado	nano'farad'o
nanokristaloj	nano'kristal'o'j
nanomaterialoj	nano'material'o'j
nanometro	nano'metr'o
nanometroj	nano'metr'o'j
nanopartikloj	nano'partikl'o'j
nanopartiklojn	nano'partikl'o'j'n
nanoporo	nano'por'o
nanosekundoj	nano'sekund'o'j
nanoskalo	nano'skal'o
nanostrukturoj	nano'struktur'o'j
nanoteknologio	nano'teknologi'o
nanoteknologion	nano'teknologi'o'n
nanotubo	nano'tub'o
nanotuboj	nano'tub'o'j
nanotubojn	nano'tub'o'j'n
napa	nap'a
napo	nap'o
napoj	nap'o'j
napola	napol'a
napolaj	napol'a'j
napolo	napol'o
napolon	napol'o'n
napoleona	napoleon'a
napoleonaj	napoleon'a'j
napoleono	napoleon'o
napoleonon	napoleon'o'n
narciso	narcis'o
narcisoj	narcis'o'j
narcisisma	narcis'ism'a
narcisismaj	narcis'ism'a'j
narcisismo	narcis'ism'o
nargileo	nargile'o
narkota	narkot'a
narkotas	narkot'as
narkotaĵo	narkot'aĵ'o
narkotaĵoj	narkot'aĵ'o'j
narkotaĵojn	narkot'aĵ'o'j'n
narkotaĵon	narkot'aĵ'o'n
narkotiĝo	narkot'iĝ'o
nasa	nas'a
naso	nas'o
naska	nask'a
naskaj	nask'a'j
naskas	nask'as
naski	nask'i
naskis	nask'is
nasko	nask'o
naskoj	nask'o'j
naskon	nask'o'n
naskos	nask'os
nasku	nask'u
naskus	nask'us
naskado	nask'ad'o
naskadon	nask'ad'o'n
naskanta	nask'ant'a
naskante	nask'ant'e
naskfrekvenco	nask'frekvenc'o
naskfrekvencoj	nask'frekvenc'o'j
naskigas	nask'ig'as
naskigi	nask'ig'i
naskigis	nask'ig'is
naskiĝa	nask'iĝ'a
naskiĝas	nask'iĝ'as
naskiĝi	nask'iĝ'i
naskiĝis	nask'iĝ'is
naskigho	nask'iĝ'o
naskiĝo	nask'iĝ'o
naskiĝoj	nask'iĝ'o'j
naskiĝojn	nask'iĝ'o'j'n
naskiĝon	nask'iĝ'o'n
naskiĝos	nask'iĝ'os
naskiĝu	nask'iĝ'u
naskiĝus	nask'iĝ'us
naskiĝanta	nask'iĝ'ant'a
naskiĝdato	nask'iĝ'dat'o
naskiĝdaton	nask'iĝ'dat'o'n
naskiĝdatreveno	nask'iĝ'dat'rev'en'o
naskiĝdatrevenon	nask'iĝ'dat'rev'en'o'n
naskiĝdomo	nask'iĝ'dom'o
naskiĝejo	nask'iĝ'ej'o
naskiĝfesto	nask'iĝ'fest'o
naskiĝinta	nask'iĝ'int'a
naskiĝintaj	nask'iĝ'int'a'j
naskiĝintan	nask'iĝ'int'a'n
naskiĝinte	nask'iĝ'int'e
naskiĝjaro	nask'iĝ'jar'o
naskiĝlando	nask'iĝ'land'o
naskiĝlandon	nask'iĝ'land'o'n
naskiĝloko	nask'iĝ'lok'o
naskiĝlokoj	nask'iĝ'lok'o'j
naskiĝlokon	nask'iĝ'lok'o'n
naskiĝnomo	nask'iĝ'nom'o
naskiĝofesto	nask'iĝ'o'fest'o
naskiĝotago	nask'iĝ'o'tag'o
naskiĝonta	nask'iĝ'ont'a
naskiĝtaga	nask'iĝ'tag'a
naskiĝtagan	nask'iĝ'tag'a'n
naskiĝtago	nask'iĝ'tag'o
naskiĝtagoj	nask'iĝ'tag'o'j
naskiĝtagon	nask'iĝ'tag'o'n
naskiĝtagfesto	nask'iĝ'tag'fest'o
naskiĝurbo	nask'iĝ'urb'o
naskiĝurbon	nask'iĝ'urb'o'n
naskiĝvilaĝo	nask'iĝ'vilaĝ'o
naskinta	nask'int'a
naskita	nask'it'a
naskitaj	nask'it'a'j
naskitajn	nask'it'a'j'n
naskitan	nask'it'a'n
naskito	nask'it'o
naskitoj	nask'it'o'j
naskokanalo	nask'o'kanal'o
naskokvanto	nask'o'kvant'o
naskolando	nask'o'land'o
naskolimigo	nask'o'lim'ig'o
naskoloko	nask'o'lok'o
naskonome	nask'o'nom'e
naskotago	nask'o'tag'o
naskonta	nask'ont'a
natria	natri'a
natriaj	natri'a'j
natrian	natri'a'n
natrio	natri'o
natrion	natri'o'n
natura	natur'a
naturaj	natur'a'j
naturajn	natur'a'j'n
naturan	natur'a'n
nature	natur'e
naturo	natur'o
naturoj	natur'o'j
naturojn	natur'o'j'n
naturon	natur'o'n
naturaĵoj	natur'aĵ'o'j
naturamika	natur'amik'a
naturamikoj	natur'amik'o'j
naturamikaro	natur'amik'ar'o
naturdotita	natur'dot'it'a
natureca	natur'ec'a
natureco	natur'ec'o
naturecon	natur'ec'o'n
naturfenomenoj	natur'fenomen'o'j
naturgasa	natur'gas'a
naturgaso	natur'gas'o
naturhistoria	natur'histori'a
naturhistorio	natur'histori'o
naturisma	natur'ism'a
naturismo	natur'ism'o
naturisto	natur'ist'o
naturistoj	natur'ist'o'j
naturkatastrofo	natur'katastrof'o
naturkatastrofoj	natur'katastrof'o'j
naturkatastrofojn	natur'katastrof'o'j'n
naturkonservado	natur'konserv'ad'o
naturkuracado	natur'kurac'ad'o
naturleĝo	natur'leĝ'o
naturleĝoj	natur'leĝ'o'j
naturleĝon	natur'leĝ'o'n
naturlingva	natur'lingv'a
naturlingvaj	natur'lingv'a'j
naturmaterialoj	natur'material'o'j
naturmedia	natur'medi'a
naturmedio	natur'medi'o
naturmedion	natur'medi'o'n
naturparko	natur'park'o
naturprocezo	natur'procez'o
naturprocezoj	natur'procez'o'j
naturproduktoj	natur'produkt'o'j
naturprotekta	natur'protekt'a
naturprotekto	natur'protekt'o
naturprotektado	natur'protekt'ad'o
naturprotektejo	natur'protekt'ej'o
naturprotektejoj	natur'protekt'ej'o'j
naturrajtoj	natur'rajt'o'j
naturregiono	natur'region'o
naturrezervejo	natur'rezerv'ej'o
naturrezervejoj	natur'rezerv'ej'o'j
naturscienca	natur'scienc'a
natursciencaj	natur'scienc'a'j
naturscienco	natur'scienc'o
natursciencoj	natur'scienc'o'j
natursciencojn	natur'scienc'o'j'n
natursciencisto	natur'scienc'ist'o
natursciencistoj	natur'scienc'ist'o'j
naturstato	natur'stat'o
naturŝtonoj	natur'ŝton'o'j
naturulo	natur'ul'o
naturuloj	natur'ul'o'j
naturalisma	naturalism'a
naturalismaj	naturalism'a'j
naturalisman	naturalism'a'n
naturalismo	naturalism'o
naturalismon	naturalism'o'n
naturalisto	naturalist'o
naturalistoj	naturalist'o'j
naura	naur'a
nauro	naur'o
naŭ	naŭ
naŭa	naŭ'a
naŭan	naŭ'a'n
naŭcent	naŭ'cent
naŭdek	naŭ'dek
naŭo	naŭ'o
naŭdekaj	naŭ'dek'a'j
naŭdekjara	naŭ'dek'jar'a
naŭjara	naŭ'jar'a
naŭono	naŭ'on'o
naŭpiedulo	naŭ'pied'ul'o
naŭplio	naŭpli'o
naŭtika	naŭtik'a
naŭtikaj	naŭtik'a'j
naŭtiko	naŭtik'o
naŭza	naŭz'a
naŭzaj	naŭz'a'j
naŭzan	naŭz'a'n
naŭzas	naŭz'as
naŭze	naŭz'e
naŭzis	naŭz'is
naŭzo	naŭz'o
naŭzojn	naŭz'o'j'n
naŭzon	naŭz'o'n
naŭzita	naŭz'it'a
naŭzite	naŭz'it'e
nava	nav'a
navo	nav'o
navoj	nav'o'j
navojn	nav'o'j'n
navon	nav'o'n
navero	nav'er'o
naveroj	nav'er'o'j
navokruciĝo	nav'o'kruc'iĝ'o
navaha	navah'a
navaho	navah'o
navahoj	navah'o'j
navaro	navar'o
naveda	naved'a
navedas	naved'as
navedi	naved'i
navedo	naved'o
navedoj	naved'o'j
navedon	naved'o'n
navedado	naved'ad'o
navedantoj	naved'ant'o'j
naviga	navig'a
navigas	navig'as
navigi	navig'i
navigis	navig'is
navigos	navig'os
navigada	navig'ad'a
navigado	navig'ad'o
navigadon	navig'ad'o'n
naviganta	navig'ant'a
navigantoj	navig'ant'o'j
navigebla	navig'ebl'a
navigeblaj	navig'ebl'a'j
navigilo	navig'il'o
navigiloj	navig'il'o'j
navigisto	navig'ist'o
navigistoj	navig'ist'o'j
navigacia	navigaci'a
navigaciaj	navigaci'a'j
navigaciajn	navigaci'a'j'n
navigacio	navigaci'o
navigacion	navigaci'o'n
naza	naz'a
nazaj	naz'a'j
nazajn	naz'a'j'n
nazan	naz'a'n
nazo	naz'o
nazoj	naz'o'j
nazojn	naz'o'j'n
nazon	naz'o'n
nazkataro	naz'katar'o
nazkataron	naz'katar'o'n
nazkaverno	naz'kavern'o
nazotruoj	naz'o'tru'o'j
nazotruojn	naz'o'tru'o'j'n
naztruoj	naz'tru'o'j
naztruojn	naz'tru'o'j'n
naztuko	naz'tuk'o
naztukoj	naz'tuk'o'j
naztukon	naz'tuk'o'n
nazumo	naz'um'o
nazala	nazal'a
nazalaj	nazal'a'j
nazalo	nazal'o
nazaloj	nazal'o'j
nazaligo	nazal'ig'o
nazaligitaj	nazal'ig'it'a'j
nazareo	nazare'o
nazareto	nazaret'o
nazia	nazi'a
naziaj	nazi'a'j
naziajn	nazi'a'j'n
nazian	nazi'a'n
nazio	nazi'o
nazioj	nazi'o'j
naziojn	nazi'o'j'n
naziisma	nazi'ism'a
naziismo	nazi'ism'o
naziistoj	nazi'ist'o'j
nazireĝimo	nazi'reĝim'o
nazrano	nazran'o
ne	ne
nea	ne'a
neaj	ne'a'j
neajn	ne'a'j'n
nean	ne'a'n
neas	ne'as
nee	ne'e
nei	ne'i
neis	ne'is
neos	ne'os
neu	ne'u
neus	ne'us
neado	ne'ad'o
neadon	ne'ad'o'n
neadekvata	ne'adekvat'a
neadekvataj	ne'adekvat'a'j
neadekvatan	ne'adekvat'a'n
neadekvate	ne'adekvat'e
neadekvateco	ne'adekvat'ec'o
neafektebla	ne'afekt'ebl'a
neaga	ne'ag'a
neagnoskita	ne'agnosk'it'a
neagnoskitaj	ne'agnosk'it'a'j
neagordigebleco	ne'agord'ig'ebl'ec'o
neagrabla	ne'agrabl'a
neaĵo	ne'aĵ'o
neakademiaj	ne'akademi'a'j
neakcentita	ne'akcent'it'a
neakcentitaj	ne'akcent'it'a'j
neakceptebla	ne'akcept'ebl'a
neakcepteblaj	ne'akcept'ebl'a'j
neakcepteblajn	ne'akcept'ebl'a'j'n
neakcepteblan	ne'akcept'ebl'a'n
neakcepteble	ne'akcept'ebl'e
neakompanata	ne'akompan'at'a
neakordigebla	ne'akord'ig'ebl'a
neakordigeblaj	ne'akord'ig'ebl'a'j
neakra	ne'akr'a
neaktiva	ne'aktiv'a
neaktivaj	ne'aktiv'a'j
neaktivan	ne'aktiv'a'n
neaktiveco	ne'aktiv'ec'o
nealirebla	ne'al'ir'ebl'a
nealireblaj	ne'al'ir'ebl'a'j
neallasebla	ne'al'las'ebl'a
nealloga	ne'al'log'a
neallogaj	ne'al'log'a'j
nealkoholaĵoj	ne'alkohol'aĵ'o'j
nealta	ne'alt'a
nealtaj	ne'alt'a'j
neamika	ne'amik'a
neanoj	ne'an'o'j
neanglaj	ne'angl'a'j
neanglalingvaj	ne'angl'a'lingv'a'j
neanglalingvanoj	ne'angl'a'lingv'an'o'j
neanstataŭebla	ne'anstataŭ'ebl'a
neanstataŭigebla	ne'anstataŭ'ig'ebl'a
neanstataŭigeblan	ne'anstataŭ'ig'ebl'a'n
neante	ne'ant'e
neantaŭdirebleco	ne'antaŭ'dir'ebl'ec'o
neantaŭvidebla	ne'antaŭ'vid'ebl'a
neantaŭvideblaj	ne'antaŭ'vid'ebl'a'j
neantaŭvideble	ne'antaŭ'vid'ebl'e
neantaŭvidita	ne'antaŭ'vid'it'a
neantaŭviditaj	ne'antaŭ'vid'it'a'j
neantaŭviditajn	ne'antaŭ'vid'it'a'j'n
neantaŭviditan	ne'antaŭ'vid'it'a'n
neapartigebla	ne'apart'ig'ebl'a
neapartigeblaj	ne'apart'ig'ebl'a'j
neapero	ne'aper'o
neaprobita	ne'aprob'it'a
nearabaj	ne'arab'a'j
nearmita	ne'arm'it'a
neasimilitaj	ne'asimil'it'a'j
neata	ne'at'a
neatendita	ne'atend'it'a
neatenditaj	ne'atend'it'a'j
neatenditajn	ne'atend'it'a'j'n
neatenditan	ne'atend'it'a'n
neatendite	ne'atend'it'e
neatenditeco	ne'atend'it'ec'o
neatenta	ne'atent'a
neatento	ne'atent'o
neatentemo	ne'atent'em'o
neatestita	ne'atest'it'a
neatingebla	ne'ating'ebl'a
neatingeblaj	ne'ating'ebl'a'j
neatingeblajn	ne'ating'ebl'a'j'n
neatingeblan	ne'ating'ebl'a'n
neaŭdebla	ne'aŭd'ebl'a
neaŭdeblaj	ne'aŭd'ebl'a'j
neaŭdeble	ne'aŭd'ebl'e
neaŭdita	ne'aŭd'it'a
neaŭtorizita	ne'aŭtoriz'it'a
neaŭtorizitaj	ne'aŭtoriz'it'a'j
neaŭtorizitan	ne'aŭtoriz'it'a'n
nebela	ne'bel'a
nebezonata	ne'bezon'at'a
nebezonataj	ne'bezon'at'a'j
nebindita	ne'bind'it'a
nebinditaj	ne'bind'it'a'j
neblanka	ne'blank'a
neblankaj	ne'blank'a'j
neblankuloj	ne'blank'ul'o'j
nebona	ne'bon'a
nebonaj	ne'bon'a'j
nebonan	ne'bon'a'n
nebone	ne'bon'e
nebonvena	ne'bon'ven'a
nebrila	ne'bril'a
nebrulema	ne'brul'em'a
necedema	ne'ced'em'a
necedeman	ne'ced'em'a'n
necerta	ne'cert'a
necertaj	ne'cert'a'j
necertan	ne'cert'a'n
necerte	ne'cert'e
necerteco	ne'cert'ec'o
necertecoj	ne'cert'ec'o'j
necertecojn	ne'cert'ec'o'j'n
necertecon	ne'cert'ec'o'n
necertecoprincipo	ne'cert'ec'o'princip'o
necivilizita	ne'civiliz'it'a
necivilizitaj	ne'civiliz'it'a'j
necivitanoj	ne'civit'an'o'j
neĉeesto	ne'ĉe'est'o
neĉeeston	ne'ĉe'est'o'n
neĉinaj	ne'ĉin'a'j
nedamaĝita	ne'damaĝ'it'a
nedanĝera	ne'danĝer'a
nedankema	ne'dank'em'a
nedankinde	ne'dank'ind'e
nedaŭra	ne'daŭr'a
nedaŭraj	ne'daŭr'a'j
nedaŭre	ne'daŭr'e
nedaŭrigebla	ne'daŭr'ig'ebl'a
nedaŭrigeblaj	ne'daŭr'ig'ebl'a'j
nedenaskaj	ne'de'nask'a'j
nedenaskuloj	ne'de'nask'ul'o'j
nedependa	ne'de'pend'a
nedependaj	ne'de'pend'a'j
nedeca	ne'dec'a
nedecaj	ne'dec'a'j
nedecan	ne'dec'a'n
nedece	ne'dec'e
nedecidebla	ne'decid'ebl'a
nedecideme	ne'decid'em'e
nedecidemo	ne'decid'em'o
nedecidita	ne'decid'it'a
nedeciditaj	ne'decid'it'a'j
nedeklarita	ne'deklar'it'a
nedemanda	ne'demand'a
nedemokrataj	ne'demokrat'a'j
nedemokratia	ne'demokrat'i'a
nedemokratiaj	ne'demokrat'i'a'j
nedeterminisma	ne'determin'ism'a
nedeterminita	ne'determin'it'a
nedeterminitaj	ne'determin'it'a'j
nedetrua	ne'detru'a
nedetruebla	ne'detru'ebl'a
nedetrueblaj	ne'detru'ebl'a'j
nedeviga	ne'dev'ig'a
nedevigaj	ne'dev'ig'a'j
nedevigan	ne'dev'ig'a'n
nedezirata	ne'dezir'at'a
nedezirataj	ne'dezir'at'a'j
nedeziratajn	ne'dezir'at'a'j'n
nedeziratan	ne'dezir'at'a'n
nedezirinda	ne'dezir'ind'a
nedezirindaj	ne'dezir'ind'a'j
nedezirindajn	ne'dezir'ind'a'j'n
nedezirindan	ne'dezir'ind'a'n
nedifektita	ne'difekt'it'a
nedifektitaj	ne'difekt'it'a'j
nedifina	ne'difin'a
nedifinebla	ne'difin'ebl'a
nedifineblan	ne'difin'ebl'a'n
nedifinita	ne'difin'it'a
nedifinitaj	ne'difin'it'a'j
nedifinitan	ne'difin'it'a'n
nedifinitecon	ne'difin'it'ec'o'n
nedirebla	ne'dir'ebl'a
nedireble	ne'dir'ebl'e
nedirita	ne'dir'it'a
nediritaj	ne'dir'it'a'j
nedisigebla	ne'dis'ig'ebl'a
nedisigeblaj	ne'dis'ig'ebl'a'j
nedisigeblan	ne'dis'ig'ebl'a'n
nedisigeble	ne'dis'ig'ebl'e
nedisvastigo	ne'dis'vast'ig'o
nediskriminacio	ne'diskriminaci'o
nediskutebla	ne'diskut'ebl'a
nediskuteblaj	ne'diskut'ebl'a'j
nediskuteble	ne'diskut'ebl'e
nedisputebla	ne'disput'ebl'a
nedisputeble	ne'disput'ebl'e
nedistingebla	ne'disting'ebl'a
nedistingeblaj	ne'disting'ebl'a'j
nedividebla	ne'divid'ebl'a
nedivideblaj	ne'divid'ebl'a'j
nedividita	ne'divid'it'a
nedividitaj	ne'divid'it'a'j
nedokumentita	ne'dokument'it'a
nedokumentitaj	ne'dokument'it'a'j
nedorma	ne'dorm'a
nedormaj	ne'dorm'a'j
neduuma	ne'du'um'a
neduumaj	ne'du'um'a'j
nedubebla	ne'dub'ebl'a
nedubeble	ne'dub'ebl'e
neebla	ne'ebl'a
neeblaj	ne'ebl'a'j
neeblan	ne'ebl'a'n
neeblas	ne'ebl'as
neeble	ne'ebl'e
neeblo	ne'ebl'o
neeblon	ne'ebl'o'n
neeblaĵo	ne'ebl'aĵ'o
neeblaĵoj	ne'ebl'aĵ'o'j
neeblaĵon	ne'ebl'aĵ'o'n
neebleco	ne'ebl'ec'o
neebligas	ne'ebl'ig'as
neebligi	ne'ebl'ig'i
neebligis	ne'ebl'ig'is
needukita	ne'eduk'it'a
needukitaj	ne'eduk'it'a'j
neefektivigebla	ne'efektiv'ig'ebl'a
neefika	ne'efik'a
neefikaj	ne'efik'a'j
neefikeco	ne'efik'ec'o
neefikecoj	ne'efik'ec'o'j
neefikecon	ne'efik'ec'o'n
neegala	ne'egal'a
neegalaj	ne'egal'a'j
neegalan	ne'egal'a'n
neegalaĵo	ne'egal'aĵ'o
neegalaĵoj	ne'egal'aĵ'o'j
neegalaĵojn	ne'egal'aĵ'o'j'n
neegaleco	ne'egal'ec'o
neegalecoj	ne'egal'ec'o'j
neegalecon	ne'egal'ec'o'n
neekspertoj	ne'ekspert'o'j
neekvilibra	ne'ekvilibr'a
neekzisto	ne'ekzist'o
neekziston	ne'ekzist'o'n
neekzistado	ne'ekzist'ad'o
neekzistanta	ne'ekzist'ant'a
neekzistantaj	ne'ekzist'ant'a'j
neekzistantajn	ne'ekzist'ant'a'j'n
neekzistantan	ne'ekzist'ant'a'n
neelĉerpebla	ne'el'ĉerp'ebl'a
neelĉerpeblaj	ne'el'ĉerp'ebl'a'j
neelĉerpeblan	ne'el'ĉerp'ebl'a'n
neeldirebla	ne'el'dir'ebl'a
neeldonita	ne'el'don'it'a
neeldonitaj	ne'el'don'it'a'j
neelportebla	ne'el'port'ebl'a
neeltenebla	ne'el'ten'ebl'a
neelteneblaj	ne'el'ten'ebl'a'j
neelteneblan	ne'el'ten'ebl'a'n
neelteneble	ne'el'ten'ebl'e
neelektebla	ne'elekt'ebl'a
neelekteblaj	ne'elekt'ebl'a'j
neeraripova	ne'erar'i'pov'a
neeraripovaj	ne'erar'i'pov'a'j
neeraripovo	ne'erar'i'pov'o
neeraripovon	ne'erar'i'pov'o'n
neesperanta	ne'esperant'a
neesperantaj	ne'esperant'a'j
neesperantigitaj	ne'esperant'ig'it'a'j
neesperantista	ne'esperant'ist'a
neesperantistaj	ne'esperant'ist'a'j
neesperantistajn	ne'esperant'ist'a'j'n
neesperantisto	ne'esperant'ist'o
neesperantistoj	ne'esperant'ist'o'j
neesperantistojn	ne'esperant'ist'o'j'n
neesplorita	ne'esplor'it'a
neesploritaj	ne'esplor'it'a'j
neesprimebla	ne'esprim'ebl'a
neesprimeble	ne'esprim'ebl'e
neesprimita	ne'esprim'it'a
neesprimitaj	ne'esprim'it'a'j
neeŭropa	ne'eŭrop'a
neeŭropaj	ne'eŭrop'a'j
neeŭropanoj	ne'eŭrop'an'o'j
neevitebla	ne'evit'ebl'a
neeviteblaj	ne'evit'ebl'a'j
neeviteblajn	ne'evit'ebl'a'j'n
neeviteblan	ne'evit'ebl'a'n
neeviteblas	ne'evit'ebl'as
neeviteble	ne'evit'ebl'e
neeviteblo	ne'evit'ebl'o
neevitebleco	ne'evit'ebl'ec'o
neevoluinta	ne'evolu'int'a
neevoluintaj	ne'evolu'int'a'j
nefacila	ne'facil'a
nefacile	ne'facil'e
nefakulo	ne'fak'ul'o
nefakuloj	ne'fak'ul'o'j
nefarebla	ne'far'ebl'a
nefareblaj	ne'far'ebl'a'j
nefarita	ne'far'it'a
nefaritaj	ne'far'it'a'j
nefekundaj	ne'fekund'a'j
nefera	ne'fer'a
neferaj	ne'fer'a'j
nefermita	ne'ferm'it'a
nefermitaj	ne'ferm'it'a'j
nefermitan	ne'ferm'it'a'n
nefidinda	ne'fid'ind'a
nefidindaj	ne'fid'ind'a'j
nefidindeco	ne'fid'ind'ec'o
nefikcia	ne'fikci'a
nefikciaj	ne'fikci'a'j
nefikcio	ne'fikci'o
nefina	ne'fin'a
nefinhava	ne'fin'hav'a
nefinhavaj	ne'fin'hav'a'j
nefinita	ne'fin'it'a
nefinitaj	ne'fin'it'a'j
nefinitajn	ne'fin'it'a'j'n
nefinitan	ne'fin'it'a'n
nefinie	ne'fini'e
nefleksebla	ne'fleks'ebl'a
neflekseblaj	ne'fleks'ebl'a'j
nefluga	ne'flug'a
neflugaj	ne'flug'a'j
neflugantaj	ne'flug'ant'a'j
neforigebla	ne'for'ig'ebl'a
neforigeblaj	ne'for'ig'ebl'a'j
neforigeblan	ne'for'ig'ebl'a'n
neforviŝebla	ne'for'viŝ'ebl'a
neforviŝeblan	ne'for'viŝ'ebl'a'n
neforgesebla	ne'forges'ebl'a
neforgeseblaj	ne'forges'ebl'a'j
neforgeseblajn	ne'forges'ebl'a'j'n
neforgeseblan	ne'forges'ebl'a'n
neforgeseble	ne'forges'ebl'e
neformala	ne'formal'a
neformalaj	ne'formal'a'j
neformalajn	ne'formal'a'j'n
neformalan	ne'formal'a'n
neformale	ne'formal'e
neforta	ne'fort'a
nefumantoj	ne'fum'ant'o'j
nefunkcia	ne'funkci'a
nefunkciaj	ne'funkci'a'j
nefunkcianta	ne'funkci'ant'a
nefunkciigita	ne'funkci'ig'it'a
negranda	ne'grand'a
negrandaj	ne'grand'a'j
negrandajn	ne'grand'a'j'n
negrandan	ne'grand'a'n
negrava	ne'grav'a
negravaj	ne'grav'a'j
negravajn	ne'grav'a'j'n
negravan	ne'grav'a'n
negrave	ne'grav'e
neĝenata	ne'ĝen'at'a
neĝenataj	ne'ĝen'at'a'j
neĝentila	ne'ĝentil'a
neĝentile	ne'ĝentil'e
neĝusta	ne'ĝust'a
neĝustaj	ne'ĝust'a'j
neĝustan	ne'ĝust'a'n
neĝuste	ne'ĝust'e
nehaltigebla	ne'halt'ig'ebl'a
nehaltigeble	ne'halt'ig'ebl'e
nehaste	ne'hast'e
nehazarde	ne'hazard'e
nehelpema	ne'help'em'a
nehoma	ne'hom'a
nehomaj	ne'hom'a'j
nehomajn	ne'hom'a'j'n
nehoman	ne'hom'a'n
nehome	ne'hom'e
nehomoj	ne'hom'o'j
nehonesta	ne'honest'a
neidentigita	ne'ident'ig'it'a
neidentigitaj	ne'ident'ig'it'a'j
neimagebla	ne'imag'ebl'a
neimageblaj	ne'imag'ebl'a'j
neimageblajn	ne'imag'ebl'a'j'n
neimageblan	ne'imag'ebl'a'n
neimageble	ne'imag'ebl'e
neimitebla	ne'imit'ebl'a
neimpresita	ne'impres'it'a
neinda	ne'ind'a
neindiĝena	ne'indiĝen'a
neindiĝenaj	ne'indiĝen'a'j
neindiĝenoj	ne'indiĝen'o'j
neinfluita	ne'influ'it'a
neinformita	ne'inform'it'a
neinformitaj	ne'inform'it'a'j
neinteligenta	ne'inteligent'a
neintenca	ne'intenc'a
neintence	ne'intenc'e
neintencita	ne'intenc'it'a
neintencitaj	ne'intenc'it'a'j
neintencitajn	ne'intenc'it'a'j'n
neintencitan	ne'intenc'it'a'n
neinteresa	ne'interes'a
neinteresaj	ne'interes'a'j
neintereso	ne'interes'o
neinteresita	ne'interes'it'a
neinteresitaj	ne'interes'it'a'j
neinterfero	ne'interfer'o
neinversigebla	ne'invers'ig'ebl'a
neinversigeblaj	ne'invers'ig'ebl'a'j
neinvitita	ne'invit'it'a
neislama	ne'islam'a
neislamaj	ne'islam'a'j
neislamajn	ne'islam'a'j'n
neislamanoj	ne'islam'an'o'j
neita	ne'it'a
neitaj	ne'it'a'j
nejuda	ne'jud'a
nejudaj	ne'jud'a'j
nejudoj	ne'jud'o'j
nejuna	ne'jun'a
nejunaj	ne'jun'a'j
nejusta	ne'just'a
nejustaj	ne'just'a'j
nejustajn	ne'just'a'j'n
nejustan	ne'just'a'n
nejuste	ne'just'e
nekalkulebla	ne'kalkul'ebl'a
nekalkuleblaj	ne'kalkul'ebl'a'j
nekalkuleblajn	ne'kalkul'ebl'a'j'n
nekalkuleblan	ne'kalkul'ebl'a'n
nekandidatita	ne'kandidat'it'a
nekandidatitaj	ne'kandidat'it'a'j
nekapabla	ne'kapabl'a
nekapablaj	ne'kapabl'a'j
nekapable	ne'kapabl'e
nekapablo	ne'kapabl'o
nekapablon	ne'kapabl'o'n
nekaptebla	ne'kapt'ebl'a
nekaŝita	ne'kaŝ'it'a
nekatolikaj	ne'katolik'a'j
nekatolikoj	ne'katolik'o'j
neklara	ne'klar'a
neklaraj	ne'klar'a'j
neklarajn	ne'klar'a'j'n
neklaran	ne'klar'a'n
neklare	ne'klar'e
neklareco	ne'klar'ec'o
neklarigebla	ne'klar'ig'ebl'a
neklarigeblaj	ne'klar'ig'ebl'a'j
neklarigeblan	ne'klar'ig'ebl'a'n
neklarigeble	ne'klar'ig'ebl'e
neklarigita	ne'klar'ig'it'a
neklarigitaj	ne'klar'ig'it'a'j
neklera	ne'kler'a
nekleraj	ne'kler'a'j
nekohera	ne'koher'a
nekoheraj	ne'koher'a'j
nekoheran	ne'koher'a'n
nekomerca	ne'komerc'a
nekomercaj	ne'komerc'a'j
nekomforta	ne'komfort'a
nekomparebla	ne'kompar'ebl'a
nekompareblaj	ne'kompar'ebl'a'j
nekompareblan	ne'kompar'ebl'a'n
nekompareble	ne'kompar'ebl'e
nekompetenta	ne'kompetent'a
nekompetentaj	ne'kompetent'a'j
nekompetenteco	ne'kompetent'ec'o
nekompleta	ne'komplet'a
nekompletaj	ne'komplet'a'j
nekompletajn	ne'komplet'a'j'n
nekompletan	ne'komplet'a'n
nekomplete	ne'komplet'e
nekompleteco	ne'komplet'ec'o
nekomprene	ne'kompren'e
nekompreno	ne'kompren'o
nekomprenon	ne'kompren'o'n
nekomprenata	ne'kompren'at'a
nekomprenebla	ne'kompren'ebl'a
nekompreneblaj	ne'kompren'ebl'a'j
nekompreneblajn	ne'kompren'ebl'a'j'n
nekompreneblan	ne'kompren'ebl'a'n
nekompreneble	ne'kompren'ebl'e
nekomprenebleco	ne'kompren'ebl'ec'o
nekomprenema	ne'kompren'em'a
nekomprenita	ne'kompren'it'a
nekomuna	ne'komun'a
nekomunistaj	ne'komun'ist'a'j
nekono	ne'kon'o
nekonata	ne'kon'at'a
nekonataj	ne'kon'at'a'j
nekonatajn	ne'kon'at'a'j'n
nekonatan	ne'kon'at'a'n
nekonate	ne'kon'at'e
nekonato	ne'kon'at'o
nekonatoj	ne'kon'at'o'j
nekonatojn	ne'kon'at'o'j'n
nekonaton	ne'kon'at'o'n
nekonataĵo	ne'kon'at'aĵ'o
nekonataĵoj	ne'kon'at'aĵ'o'j
nekonataĵon	ne'kon'at'aĵ'o'n
nekonateco	ne'kon'at'ec'o
nekonatulo	ne'kon'at'ul'o
nekonatuloj	ne'kon'at'ul'o'j
nekonebla	ne'kon'ebl'a
nekonita	ne'kon'it'a
nekonceptebla	ne'koncept'ebl'a
nekonfirmita	ne'konfirm'it'a
nekonfirmitaj	ne'konfirm'it'a'j
nekonforma	ne'konform'a
nekonfuzebla	ne'konfuz'ebl'a
nekongrua	ne'kongru'a
nekongruaj	ne'kongru'a'j
nekonkerebla	ne'konker'ebl'a
nekonkludebla	ne'konklud'ebl'a
nekonkludeblaj	ne'konklud'ebl'a'j
nekonscia	ne'konsci'a
nekonsciaj	ne'konsci'a'j
nekonscie	ne'konsci'e
nekonscio	ne'konsci'o
nekonsekvenca	ne'konsekvenc'a
nekonsekvence	ne'konsekvenc'e
nekonsiderante	ne'konsider'ant'e
nekonsiderinda	ne'konsider'ind'a
nekonsiderindaj	ne'konsider'ind'a'j
nekonsiderindan	ne'konsider'ind'a'n
nekonsolebla	ne'konsol'ebl'a
nekonstanta	ne'konstant'a
nekonstantaj	ne'konstant'a'j
nekontenta	ne'kontent'a
nekontentiga	ne'kontent'ig'a
nekontentigaj	ne'kontent'ig'a'j
nekontestata	ne'kontest'at'a
nekontestebla	ne'kontest'ebl'a
nekontesteblaj	ne'kontest'ebl'a'j
nekontesteblan	ne'kontest'ebl'a'n
nekontesteble	ne'kontest'ebl'e
nekontraŭdiro	ne'kontraŭ'dir'o
nekontraŭstarebla	ne'kontraŭ'star'ebl'a
nekontrolebla	ne'kontrol'ebl'a
nekontroleblaj	ne'kontrol'ebl'a'j
nekontrolita	ne'kontrol'it'a
nekonvena	ne'konven'a
nekonvenaj	ne'konven'a'j
nekonvene	ne'konven'e
nekonvencia	ne'konvenci'a
nekorekta	ne'korekt'a
nekorekte	ne'korekt'e
nekorektebla	ne'korekt'ebl'a
nekorelaciitaj	ne'korelaci'it'a'j
nekoruptebla	ne'korupt'ebl'a
nekosta	ne'kost'a
nekostaj	ne'kost'a'j
nekostajn	ne'kost'a'j'n
nekostan	ne'kost'a'n
nekoste	ne'kost'e
nekovrita	ne'kovr'it'a
nekovritaj	ne'kovr'it'a'j
nekreita	ne'kre'it'a
nekredo	ne'kred'o
nekredantaj	ne'kred'ant'a'j
nekredanto	ne'kred'ant'o
nekredantoj	ne'kred'ant'o'j
nekredantojn	ne'kred'ant'o'j'n
nekredebla	ne'kred'ebl'a
nekredeblaj	ne'kred'ebl'a'j
nekredeblajn	ne'kred'ebl'a'j'n
nekredeblan	ne'kred'ebl'a'n
nekredeblas	ne'kred'ebl'as
nekredeble	ne'kred'ebl'e
nekredeblaĵo	ne'kred'ebl'aĵ'o
nekredema	ne'kred'em'a
nekredeme	ne'kred'em'e
nekredemo	ne'kred'em'o
nekredemon	ne'kred'em'o'n
nekredinda	ne'kred'ind'a
nekreditita	ne'kredit'it'a
nekristana	ne'krist'an'a
nekristanaj	ne'krist'an'a'j
nekristanajn	ne'krist'an'a'j'n
nekristanoj	ne'krist'an'o'j
nekuirita	ne'kuir'it'a
nekuiritaj	ne'kuir'it'a'j
nekuiritajn	ne'kuir'it'a'j'n
nekuiritan	ne'kuir'it'a'n
nekulpa	ne'kulp'a
nekulpas	ne'kulp'as
nekultivataj	ne'kultiv'at'a'j
nekultivita	ne'kultiv'it'a
nekultivitaj	ne'kultiv'it'a'j
nekunmetitaj	ne'kun'met'it'a'j
nekunpremebla	ne'kun'prem'ebl'a
nekunpremita	ne'kun'prem'it'a
nekuracebla	ne'kurac'ebl'a
nekuraceblaj	ne'kurac'ebl'a'j
nekutima	ne'kutim'a
nekutimaj	ne'kutim'a'j
nekutimajn	ne'kutim'a'j'n
nekutiman	ne'kutim'a'n
nekutime	ne'kutim'e
nekvalifikita	ne'kvalifik'it'a
nekvalifikitaj	ne'kvalifik'it'a'j
nelacigebla	ne'lac'ig'ebl'a
nelacigeble	ne'lac'ig'ebl'e
nelaste	ne'last'e
nelatinaj	ne'latin'a'j
nelaŭta	ne'laŭt'a
nelaŭte	ne'laŭt'e
nelegebla	ne'leg'ebl'a
nelegeblaj	ne'leg'ebl'a'j
nelegeble	ne'leg'ebl'e
nelegipova	ne'leg'i'pov'a
nelegitima	ne'legitim'a
nelegitimaj	ne'legitim'a'j
neleĝa	ne'leĝ'a
neleĝaj	ne'leĝ'a'j
neleĝajn	ne'leĝ'a'j'n
neleĝe	ne'leĝ'e
nelerta	ne'lert'a
nelertaj	ne'lert'a'j
nelibera	ne'liber'a
neligita	ne'lig'it'a
neligitaj	ne'lig'it'a'j
nelimigita	ne'lim'ig'it'a
nelimigitaj	ne'lim'ig'it'a'j
nelimigitan	ne'lim'ig'it'a'n
nelineara	ne'linear'a
nelinearaj	ne'linear'a'j
nelineareco	ne'linear'ec'o
nelingva	ne'lingv'a
nelingvaj	ne'lingv'a'j
nelinia	ne'lini'a
neliniaj	ne'lini'a'j
neliniajn	ne'lini'a'j'n
nelinian	ne'lini'a'n
nelogika	ne'logik'a
nelogikaj	ne'logik'a'j
nelogikajn	ne'logik'a'j'n
nelogike	ne'logik'e
neloĝata	ne'loĝ'at'a
neloĝataj	ne'loĝ'at'a'j
neloĝebla	ne'loĝ'ebl'a
neloka	ne'lok'a
nelonga	ne'long'a
nelongaj	ne'long'a'j
nelonge	ne'long'e
neludantaj	ne'lud'ant'a'j
neludistoj	ne'lud'ist'o'j
nemalbona	ne'mal'bon'a
nemalbone	ne'mal'bon'e
nemalfacile	ne'mal'facil'e
nemalgranda	ne'mal'grand'a
nemalgrandan	ne'mal'grand'a'n
nemalgrande	ne'mal'grand'e
nemalhavebla	ne'mal'hav'ebl'a
nemalhaveblaj	ne'mal'hav'ebl'a'j
nemalhaveblan	ne'mal'hav'ebl'a'n
nemalhaveblas	ne'mal'hav'ebl'as
nemaligebla	ne'mal'ig'ebl'a
nemaligeblaj	ne'mal'ig'ebl'a'j
nemaligeblan	ne'mal'ig'ebl'a'n
nemaligeble	ne'mal'ig'ebl'e
nemalkomponebla	ne'mal'kompon'ebl'a
nemalkovritaj	ne'mal'kovr'it'a'j
nemalmultaj	ne'mal'mult'a'j
nemalmultajn	ne'mal'mult'a'j'n
nemalmulte	ne'mal'mult'e
nemalofte	ne'mal'oft'e
nemalplena	ne'mal'plen'a
nemalproksima	ne'mal'proksim'a
nemalproksime	ne'mal'proksim'e
nemanĝebla	ne'manĝ'ebl'a
nemanĝeblaj	ne'manĝ'ebl'a'j
nemankigebla	ne'mank'ig'ebl'a
nemankigeblaj	ne'mank'ig'ebl'a'j
nemarkita	ne'mark'it'a
nemarkitaj	ne'mark'it'a'j
nemateria	ne'materi'a
nemateriaj	ne'materi'a'j
nematerian	ne'materi'a'n
nemateriala	ne'material'a
nematura	ne'matur'a
nematuraj	ne'matur'a'j
nemature	ne'matur'e
nematureco	ne'matur'ec'o
nematurulo	ne'matur'ul'o
nematuruloj	ne'matur'ul'o'j
nememspegulsimetrieco	ne'mem'spegul'simetri'ec'o
nemembroj	ne'membr'o'j
nememorebla	ne'memor'ebl'a
nemetala	ne'metal'a
nemetalaj	ne'metal'a'j
nemetalo	ne'metal'o
nemetaloj	ne'metal'o'j
nemezurebla	ne'mezur'ebl'a
nemezureblan	ne'mezur'ebl'a'n
nemezureble	ne'mezur'ebl'e
nemigranta	ne'migr'ant'a
nemigrantaj	ne'migr'ant'a'j
nemikseblaj	ne'miks'ebl'a'j
nemiksita	ne'miks'it'a
nemiskomprenebla	ne'mis'kompren'ebl'a
nemiskompreneble	ne'mis'kompren'ebl'e
nemodifita	ne'modif'it'a
nemodifitaj	ne'modif'it'a'j
nemovebla	ne'mov'ebl'a
nemoveblaj	ne'mov'ebl'a'j
nemoveblan	ne'mov'ebl'a'n
nemoveblaĵo	ne'mov'ebl'aĵ'o
nemoveblaĵoj	ne'mov'ebl'aĵ'o'j
nemoveblaĵojn	ne'mov'ebl'aĵ'o'j'n
nemultaj	ne'mult'a'j
nemultajn	ne'mult'a'j'n
nemulte	ne'mult'e
nemulton	ne'mult'o'n
nemultekosta	ne'mult'e'kost'a
nenaskita	ne'nask'it'a
nenatura	ne'natur'a
nenaturaj	ne'natur'a'j
nenaturajn	ne'natur'a'j'n
nenaturan	ne'natur'a'n
nenature	ne'natur'e
nenecesa	ne'neces'a
nenecesaj	ne'neces'a'j
nenecesajn	ne'neces'a'j'n
nenecesan	ne'neces'a'n
nenecese	ne'neces'e
nenegativa	ne'negativ'a
neneŭtrala	ne'neŭtral'a
neneŭtralaj	ne'neŭtral'a'j
nenomita	ne'nom'it'a
nenomitaj	ne'nom'it'a'j
nenombrebla	ne'nombr'ebl'a
nenombreblaj	ne'nombr'ebl'a'j
nenombreblajn	ne'nombr'ebl'a'j'n
nenorma	ne'norm'a
nenormaj	ne'norm'a'j
nenorman	ne'norm'a'n
nenormala	ne'normal'a
nenormalaj	ne'normal'a'j
nenormalajn	ne'normal'a'j'n
nenormalan	ne'normal'a'n
nenormale	ne'normal'e
nenovan	ne'nov'a'n
nenula	ne'nul'a
nenulaj	ne'nul'a'j
nenulan	ne'nul'a'n
neoficiala	ne'oficial'a
neoficialaj	ne'oficial'a'j
neoficialajn	ne'oficial'a'j'n
neoficialan	ne'oficial'a'n
neoficiale	ne'oficial'e
neofte	ne'oft'e
neokcidenta	ne'okcident'a
neokcidentaj	ne'okcident'a'j
neokupata	ne'okup'at'a
neokupita	ne'okup'it'a
neoportuna	ne'oportun'a
neoportune	ne'oportun'e
neordigita	ne'ord'ig'it'a
neordigitaj	ne'ord'ig'it'a'j
neordinara	ne'ordinar'a
neordinaraj	ne'ordinar'a'j
neordinarajn	ne'ordinar'a'j'n
neordinaran	ne'ordinar'a'n
neordinare	ne'ordinar'e
neordinaraĵo	ne'ordinar'aĵ'o
neordinaraĵoj	ne'ordinar'aĵ'o'j
neordinaraĵon	ne'ordinar'aĵ'o'n
neorganika	ne'organik'a
neorganikaj	ne'organik'a'j
neorganikajn	ne'organik'a'j'n
neorganizita	ne'organiz'it'a
neorganizitaj	ne'organiz'it'a'j
neortodoksa	ne'ortodoks'a
neortodoksaj	ne'ortodoks'a'j
nepago	ne'pag'o
nepagebla	ne'pag'ebl'a
nepageblaj	ne'pag'ebl'a'j
nepagipovaj	ne'pag'i'pov'a'j
nepagita	ne'pag'it'a
nepagitaj	ne'pag'it'a'j
nepara	ne'par'a
neparaj	ne'par'a'j
neparajn	ne'par'a'j'n
neparan	ne'par'a'n
nepare	ne'par'e
nepardonebla	ne'pardon'ebl'a
nepardoneble	ne'pardon'ebl'e
nepardonema	ne'pardon'em'a
neparenca	ne'parenc'a
neparencaj	ne'parenc'a'j
neparolantaj	ne'parol'ant'a'j
neparolema	ne'parol'em'a
nepartopreno	ne'part'o'pren'o
nepartia	ne'parti'a
nepartiaj	ne'parti'a'j
nepartianoj	ne'parti'an'o'j
nepartieco	ne'parti'ec'o
nepenetrebla	ne'penetr'ebl'a
nepenetreblaj	ne'penetr'ebl'a'j
nepenetreblan	ne'penetr'ebl'a'n
nepensebla	ne'pens'ebl'a
nepenseble	ne'pens'ebl'e
neperforta	ne'per'fort'a
neperfortaj	ne'per'fort'a'j
neperforto	ne'per'fort'o
neperforton	ne'per'fort'o'n
neperceptebla	ne'percept'ebl'a
neperfekta	ne'perfekt'a
neperfektaj	ne'perfekt'a'j
neperfektajn	ne'perfekt'a'j'n
neperfektan	ne'perfekt'a'n
neperfekte	ne'perfekt'e
neperfektaĵoj	ne'perfekt'aĵ'o'j
neperfektaĵojn	ne'perfekt'aĵ'o'j'n
neperfekteco	ne'perfekt'ec'o
neperfektecon	ne'perfekt'ec'o'n
nepermesebla	ne'permes'ebl'a
nepersona	ne'person'a
nepersonaj	ne'person'a'j
nepersonan	ne'person'a'n
nepetite	ne'pet'it'e
neplanita	ne'plan'it'a
neplanitaj	ne'plan'it'a'j
neplena	ne'plen'a
neplenaj	ne'plen'a'j
neplenaĝa	ne'plen'aĝ'a
neplenaĝaj	ne'plen'aĝ'a'j
neplenaĝulo	ne'plen'aĝ'ul'o
neplenaĝuloj	ne'plen'aĝ'ul'o'j
neplenumo	ne'plen'um'o
neplenumebla	ne'plen'um'ebl'a
neplenumita	ne'plen'um'it'a
neplenumitaj	ne'plen'um'it'a'j
nepolaraj	ne'polar'a'j
nepolitika	ne'politik'a
nepoluitaj	ne'polu'it'a'j
nepolusaj	ne'polus'a'j
nepopulara	ne'popular'a
nepopularaj	ne'popular'a'j
nepovo	ne'pov'o
nepraktika	ne'praktik'a
nepraktikaj	ne'praktik'a'j
nepraktike	ne'praktik'e
nepravigebla	ne'prav'ig'ebl'a
nepravigeblaj	ne'prav'ig'ebl'a'j
nepravigeblan	ne'prav'ig'ebl'a'n
nepreciza	ne'preciz'a
neprecizaj	ne'preciz'a'j
nepreparita	ne'prepar'it'a
nepreparitaj	ne'prepar'it'a'j
nepripensita	ne'pri'pens'it'a
nepriskribebla	ne'pri'skrib'ebl'a
nepriskribeblaj	ne'pri'skrib'ebl'a'j
nepriskribeblan	ne'pri'skrib'ebl'a'n
nepriskribeble	ne'pri'skrib'ebl'e
neprobabla	ne'probabl'a
neprobable	ne'probabl'e
neproduktema	ne'produkt'em'a
neprofesia	ne'profesi'a
neprofesiaj	ne'profesi'a'j
neprofesiuloj	ne'profesi'ul'o'j
neprofita	ne'profit'a
neprofitaj	ne'profit'a'j
neprofitcela	ne'profit'cel'a
neprofitcelaj	ne'profit'cel'a'j
neprofitema	ne'profit'em'a
neprofitocela	ne'profit'o'cel'a
neprofitocelaj	ne'profit'o'cel'a'j
neprofunda	ne'profund'a
neprofundaj	ne'profund'a'j
neproporcia	ne'proporci'a
neproporciaj	ne'proporci'a'j
neproporcian	ne'proporci'a'n
neproporcie	ne'proporci'e
neprovitaj	ne'prov'it'a'j
neprudenta	ne'prudent'a
neprudente	ne'prudent'e
nepruvebla	ne'pruv'ebl'a
nepruvita	ne'pruv'it'a
nepruvitaj	ne'pruv'it'a'j
nepublika	ne'publik'a
nepublikaj	ne'publik'a'j
nepublikigita	ne'publik'ig'it'a
nepublikigitaj	ne'publik'ig'it'a'j
nepura	ne'pur'a
nepuraj	ne'pur'a'j
neracia	ne'raci'a
neraciaj	ne'raci'a'j
neracian	ne'raci'a'n
neracie	ne'raci'e
neracieco	ne'raci'ec'o
nerafinita	ne'rafin'it'a
nerapide	ne'rapid'e
neraportitaj	ne'raport'it'a'j
nerazita	ne'raz'it'a
nereaktiva	ne're'aktiv'a
nerekonebla	ne're'kon'ebl'a
nerekoneblaj	ne're'kon'ebl'a'j
nerekonita	ne're'kon'it'a
nerekonitaj	ne're'kon'it'a'j
nerenovigebla	ne're'nov'ig'ebl'a
nerenovigeblaj	ne're'nov'ig'ebl'a'j
nereprodukta	ne're'produkt'a
nereproduktaj	ne're'produkt'a'j
nereproduktuloj	ne're'produkt'ul'o'j
neretenebla	ne're'ten'ebl'a
nereteneble	ne're'ten'ebl'e
nerevokebla	ne're'vok'ebl'a
nereala	ne'real'a
nerealaj	ne'real'a'j
nerealan	ne'real'a'n
nerealeco	ne'real'ec'o
nerealigebla	ne'real'ig'ebl'a
nerealiĝinta	ne'real'iĝ'int'a
nerealisma	ne'real'ism'a
nerealismaj	ne'real'ism'a'j
nerealisme	ne'real'ism'e
nereduktebla	ne'redukt'ebl'a
nereduktita	ne'redukt'it'a
nereduktitaj	ne'redukt'it'a'j
nerefutebla	ne'refut'ebl'a
nerefuteblaj	ne'refut'ebl'a'j
nerefuteblan	ne'refut'ebl'a'n
nerefuteble	ne'refut'ebl'e
neregebla	ne'reg'ebl'a
neregeblaj	ne'reg'ebl'a'j
neregeble	ne'reg'ebl'e
neregistara	ne'reg'ist'ar'a
neregistaraj	ne'reg'ist'ar'a'j
neregistarajn	ne'reg'ist'ar'a'j'n
neregistrita	ne'registr'it'a
neregula	ne'regul'a
neregulaj	ne'regul'a'j
neregulajn	ne'regul'a'j'n
neregulan	ne'regul'a'n
neregule	ne'regul'e
neregulaĵoj	ne'regul'aĵ'o'j
neregulaĵojn	ne'regul'aĵ'o'j'n
nereguleco	ne'regul'ec'o
nereguligita	ne'regul'ig'it'a
nerekta	ne'rekt'a
nerektaj	ne'rekt'a'j
nerektajn	ne'rekt'a'j'n
nerektan	ne'rekt'a'n
nerekte	ne'rekt'e
nerelativista	ne'relativ'ist'a
nereligia	ne'religi'a
nereligiaj	ne'religi'a'j
nereligiajn	ne'religi'a'j'n
nerespekto	ne'respekt'o
nerespondo	ne'respond'o
nerespondebla	ne'respond'ebl'a
nerespondeca	ne'respond'ec'a
nerespondecaj	ne'respond'ec'a'j
nerespondita	ne'respond'it'a
neresponditaj	ne'respond'it'a'j
nerezistebla	ne'rezist'ebl'a
nerezisteblan	ne'rezist'ebl'a'n
nerezisteble	ne'rezist'ebl'e
neriĉa	ne'riĉ'a
nerilata	ne'rilat'a
nerilataj	ne'rilat'a'j
nerimarkata	ne'rimark'at'a
nerimarkataj	ne'rimark'at'a'j
nerimarkate	ne'rimark'at'e
nerimarkebla	ne'rimark'ebl'a
nerimarkeblaj	ne'rimark'ebl'a'j
nerimarkeble	ne'rimark'ebl'e
nerimarkinda	ne'rimark'ind'a
nerimarkita	ne'rimark'it'a
nerimarkitaj	ne'rimark'it'a'j
nerimarkite	ne'rimark'it'e
neriparebla	ne'ripar'ebl'a
neripareblan	ne'ripar'ebl'a'n
neripareble	ne'ripar'ebl'e
neripetebla	ne'ripet'ebl'a
neripeteblan	ne'ripet'ebl'a'n
neriproĉebla	ne'riproĉ'ebl'a
nerompebla	ne'romp'ebl'a
nerompeblaj	ne'romp'ebl'a'j
nerompeblan	ne'romp'ebl'a'n
nerompita	ne'romp'it'a
nerompitaj	ne'romp'it'a'j
nesala	ne'sal'a
nesalaj	ne'sal'a'j
nesalakva	ne'sal'akv'a
nesalakvaj	ne'sal'akv'a'j
nesana	ne'san'a
nesanaj	ne'san'a'j
nesanigaj	ne'san'ig'a'j
nesatigebla	ne'sat'ig'ebl'a
nesaturita	ne'satur'it'a
nesaturitaj	ne'satur'it'a'j
nescia	ne'sci'a
nescias	ne'sci'as
nescio	ne'sci'o
nescion	ne'sci'o'n
nesciado	ne'sci'ad'o
nescianta	ne'sci'ant'a
nesciante	ne'sci'ant'e
nesciantoj	ne'sci'ant'o'j
nesciata	ne'sci'at'a
nesciataj	ne'sci'at'a'j
nesciate	ne'sci'at'e
nesciebla	ne'sci'ebl'a
nescienca	ne'scienc'a
nesciencaj	ne'scienc'a'j
nesekreta	ne'sekret'a
neseksa	ne'seks'a
nesekura	ne'sekur'a
nesekuraj	ne'sekur'a'j
nesekurajn	ne'sekur'a'j'n
nesekureco	ne'sekur'ec'o
nesekurigita	ne'sekur'ig'it'a
nesensignifa	ne'sen'signif'a
nesentema	ne'sent'em'a
neserioza	ne'serioz'a
neseriozaj	ne'serioz'a'j
neserioze	ne'serioz'e
nesingarda	ne'si'n'gard'a
nesingarde	ne'si'n'gard'e
nesimetria	ne'simetri'a
nesimetriaj	ne'simetri'a'j
nesincera	ne'sincer'a
nesinkrona	ne'sinkron'a
nesinkronaj	ne'sinkron'a'j
neskribita	ne'skrib'it'a
neskribitaj	ne'skrib'it'a'j
neskuebla	ne'sku'ebl'a
nesolvebla	ne'solv'ebl'a
nesolveblaj	ne'solv'ebl'a'j
nesolveblan	ne'solv'ebl'a'n
nesolveble	ne'solv'ebl'e
nesolvita	ne'solv'it'a
nesolvitaj	ne'solv'it'a'j
nespecifa	ne'specif'a
nespecifaj	ne'specif'a'j
nespecifita	ne'specif'it'a
nespecifitaj	ne'specif'it'a'j
nesperta	ne'spert'a
nespertaj	ne'spert'a'j
nestabila	ne'stabil'a
nestabilaj	ne'stabil'a'j
nestabilan	ne'stabil'a'n
nestabileco	ne'stabil'ec'o
nesufiĉa	ne'sufiĉ'a
nesufiĉaj	ne'sufiĉ'a'j
nesufiĉajn	ne'sufiĉ'a'j'n
nesufiĉan	ne'sufiĉ'a'n
nesufiĉe	ne'sufiĉ'e
nesufiĉo	ne'sufiĉ'o
nesufiĉeco	ne'sufiĉ'ec'o
nesufiĉecon	ne'sufiĉ'ec'o'n
nesukcesa	ne'sukces'a
nesuperebla	ne'super'ebl'a
nesupereblaj	ne'super'ebl'a'j
nesupereblan	ne'super'ebl'a'n
nesuperita	ne'super'it'a
neŝancelebla	ne'ŝancel'ebl'a
neŝanĝebla	ne'ŝanĝ'ebl'a
neŝanĝeblaj	ne'ŝanĝ'ebl'a'j
neŝanĝeblan	ne'ŝanĝ'ebl'a'n
neŝanĝita	ne'ŝanĝ'it'a
neŝlosita	ne'ŝlos'it'a
neŝtata	ne'ŝtat'a
neŝtataj	ne'ŝtat'a'j
netaksebla	ne'taks'ebl'a
netakseblan	ne'taks'ebl'a'n
netakseble	ne'taks'ebl'e
netaŭga	ne'taŭg'a
netaŭgaj	ne'taŭg'a'j
netaŭgajn	ne'taŭg'a'j'n
neteksaĵoj	ne'teks'aĵ'o'j
netenebla	ne'ten'ebl'a
netipa	ne'tip'a
netolerebla	ne'toler'ebl'a
netolereblaj	ne'toler'ebl'a'j
netolereblan	ne'toler'ebl'a'n
netolereble	ne'toler'ebl'e
netolerema	ne'toler'em'a
netoleremaj	ne'toler'em'a'j
netoleremo	ne'toler'em'o
netrairebla	ne'tra'ir'ebl'a
netraireblaj	ne'tra'ir'ebl'a'j
netralasemaj	ne'tra'las'em'a'j
netravidebla	ne'tra'vid'ebl'a
netravideblan	ne'tra'vid'ebl'a'n
netradicia	ne'tradici'a
netradiciaj	ne'tradici'a'j
netradiciajn	ne'tradici'a'j'n
netradician	ne'tradici'a'n
netradukebla	ne'traduk'ebl'a
netradukeblaj	ne'traduk'ebl'a'j
netradukita	ne'traduk'it'a
netradukitaj	ne'traduk'it'a'j
netraktita	ne'trakt'it'a
netraktitaj	ne'trakt'it'a'j
netransitiva	ne'transitiv'a
netransitivaj	ne'transitiv'a'j
netransitive	ne'transitiv'e
netrinkebla	ne'trink'ebl'a
netrovebla	ne'trov'ebl'a
netuŝebla	ne'tuŝ'ebl'a
netuŝeblaj	ne'tuŝ'ebl'a'j
netuŝeblan	ne'tuŝ'ebl'a'n
netuŝebleco	ne'tuŝ'ebl'ec'o
netuŝita	ne'tuŝ'it'a
netuŝitaj	ne'tuŝ'it'a'j
netuŝitan	ne'tuŝ'it'a'n
neunuforma	ne'unu'form'a
neutila	ne'util'a
neutilaj	ne'util'a'j
neutile	ne'util'e
neuzo	ne'uz'o
neuzado	ne'uz'ad'o
neuzata	ne'uz'at'a
neuzataj	ne'uz'at'a'j
neuzatajn	ne'uz'at'a'j'n
neuzatan	ne'uz'at'a'n
neuzateco	ne'uz'at'ec'o
neuzebla	ne'uz'ebl'a
neuzeblaj	ne'uz'ebl'a'j
neuzeblan	ne'uz'ebl'a'n
neuzinda	ne'uz'ind'a
neuzita	ne'uz'it'a
neuzitaj	ne'uz'it'a'j
neuzitajn	ne'uz'it'a'j'n
nevalida	ne'valid'a
nevalidaj	ne'valid'a'j
nevalideco	ne'valid'ec'o
nevegetaraj	ne'vegetar'a'j
neveno	ne'ven'o
nevenditaj	ne'vend'it'a'j
nevenkebla	ne'venk'ebl'a
nevenkeblaj	ne'venk'ebl'a'j
nevenkeblan	ne'venk'ebl'a'n
nevenkebleco	ne'venk'ebl'ec'o
nevenkita	ne'venk'it'a
nevera	ne'ver'a
neveraj	ne'ver'a'j
neverŝajna	ne'ver'ŝajn'a
neverŝajnaj	ne'ver'ŝajn'a'j
neverŝajne	ne'ver'ŝajn'e
nevidantaj	ne'vid'ant'a'j
nevidata	ne'vid'at'a
nevidate	ne'vid'at'e
nevidebla	ne'vid'ebl'a
nevideblaj	ne'vid'ebl'a'j
nevideblajn	ne'vid'ebl'a'j'n
nevideblan	ne'vid'ebl'a'n
nevideble	ne'vid'ebl'e
nevidebleco	ne'vid'ebl'ec'o
nevidita	ne'vid'it'a
neviditaj	ne'vid'it'a'j
nevidite	ne'vid'it'e
neviolenta	ne'violent'a
neviolentaj	ne'violent'a'j
nevivaj	ne'viv'a'j
nevola	ne'vol'a
nevolaj	ne'vol'a'j
nevole	ne'vol'e
nevolemo	ne'vol'em'o
nevolatila	ne'volatil'a
nevolonte	ne'volont'e
nevorta	ne'vort'a
nevortaj	ne'vort'a'j
nevundebla	ne'vund'ebl'a
nevundita	ne'vund'it'a
nezorgema	ne'zorg'em'a
neandertala	neandertal'a
neandertalaj	neandertal'a'j
neandertaloj	neandertal'o'j
nearktisa	nearktis'a
nearktiso	nearktis'o
nebula	nebul'a
nebulaj	nebul'a'j
nebulajn	nebul'a'j'n
nebulan	nebul'a'n
nebule	nebul'e
nebulo	nebul'o
nebuloj	nebul'o'j
nebulon	nebul'o'n
nebuleca	nebul'ec'a
nebulecaj	nebul'ec'a'j
nebuleto	nebul'et'o
nebuleton	nebul'et'o'n
nebuligis	nebul'ig'is
nebuliĝis	nebul'iĝ'is
nebullampoj	nebul'lamp'o'j
nebulozo	nebuloz'o
nebulozoj	nebuloz'o'j
necesa	neces'a
necesaj	neces'a'j
necesajn	neces'a'j'n
necesan	neces'a'n
necesas	neces'as
necese	neces'e
necesis	neces'is
neceso	neces'o
necesoj	neces'o'j
necesojn	neces'o'j'n
neceson	neces'o'n
necesos	neces'os
necesus	neces'us
necesaĵo	neces'aĵ'o
necesaĵoj	neces'aĵ'o'j
necesaĵojn	neces'aĵ'o'j'n
neceseco	neces'ec'o
necesecon	neces'ec'o'n
necesega	neces'eg'a
neceseja	neces'ej'a
necesejan	neces'ej'a'n
necesejen	neces'ej'e'n
necesejo	neces'ej'o
necesejoj	neces'ej'o'j
necesejojn	neces'ej'o'j'n
necesejon	neces'ej'o'n
necesigas	neces'ig'as
necesigi	neces'ig'i
necesigis	neces'ig'is
necesigos	neces'ig'os
necesigus	neces'ig'us
necesigante	neces'ig'ant'e
necesigita	neces'ig'it'a
necesujon	neces'uj'o'n
neciklopedio	neciklopedi'o
nederlanda	nederland'a
nederlandaj	nederland'a'j
nederlandajn	nederland'a'j'n
nederlandan	nederland'a'n
nederlande	nederland'e
nederlando	nederland'o
nederlandoj	nederland'o'j
nederlandon	nederland'o'n
nederlandano	nederland'an'o
nederlandanoj	nederland'an'o'j
nederlandanojn	nederland'an'o'j'n
nederlandlingva	nederland'lingv'a
nederlandlingvaj	nederland'lingv'a'j
nefelo	nefel'o
nefrito	nefr'it'o
negas	neg'as
nege	neg'e
negi	neg'i
negis	neg'is
nego	neg'o
negado	neg'ad'o
negacio	negaci'o
negacion	negaci'o'n
negativa	negativ'a
negativaj	negativ'a'j
negativajn	negativ'a'j'n
negativan	negativ'a'n
negative	negativ'e
negativo	negativ'o
negativoj	negativ'o'j
negativojn	negativ'o'j'n
negativon	negativ'o'n
negativeco	negativ'ec'o
neglekta	neglekt'a
neglektas	neglekt'as
neglekte	neglekt'e
neglekti	neglekt'i
neglektis	neglekt'is
neglekto	neglekt'o
neglekton	neglekt'o'n
neglektos	neglekt'os
neglektu	neglekt'u
neglektado	neglekt'ad'o
neglektanta	neglekt'ant'a
neglektante	neglekt'ant'e
neglektata	neglekt'at'a
neglektataj	neglekt'at'a'j
neglektebla	neglekt'ebl'a
neglektema	neglekt'em'a
neglektemo	neglekt'em'o
neglektinda	neglekt'ind'a
neglektita	neglekt'it'a
neglektitaj	neglekt'it'a'j
negliĝo	negliĝ'o
negoca	negoc'a
negocaj	negoc'a'j
negocan	negoc'a'n
negocas	negoc'as
negoci	negoc'i
negocis	negoc'is
negoco	negoc'o
negocoj	negoc'o'j
negocojn	negoc'o'j'n
negocon	negoc'o'n
negocado	negoc'ad'o
negocadon	negoc'ad'o'n
negocisto	negoc'ist'o
negocistoj	negoc'ist'o'j
negocita	negoc'it'a
negocitaj	negoc'it'a'j
negombo	negomb'o
negra	negr'a
negraj	negr'a'j
negran	negr'a'n
negro	negr'o
negroj	negr'o'j
negrojn	negr'o'j'n
negron	negr'o'n
negha	neĝ'a
neĝa	neĝ'a
neĝaj	neĝ'a'j
neĝajn	neĝ'a'j'n
neĝan	neĝ'a'n
neĝas	neĝ'as
neĝe	neĝ'e
neĝi	neĝ'i
neĝis	neĝ'is
negho	neĝ'o
neĝo	neĝ'o
neĝoj	neĝ'o'j
neĝon	neĝ'o'n
neĝos	neĝ'os
neĝadis	neĝ'ad'is
neĝado	neĝ'ad'o
neĝadoj	neĝ'ad'o'j
neĝadon	neĝ'ad'o'n
neĝblanka	neĝ'blank'a
neĝbulo	neĝ'bul'o
neĝero	neĝ'er'o
neĝeroj	neĝ'er'o'j
neĝhomo	neĝ'hom'o
neĝhomon	neĝ'hom'o'n
neĝkovrita	neĝ'kovr'it'a
neĝofalo	neĝ'o'fal'o
neĝokovrita	neĝ'o'kovr'it'a
neĝokovritaj	neĝ'o'kovr'it'a'j
neĝoŝtormo	neĝ'o'ŝtorm'o
neĝoŝtormoj	neĝ'o'ŝtorm'o'j
neĝotavolo	neĝ'o'tavol'o
neĝulo	neĝ'ul'o
neghulino	neĝ'ul'in'o
neĝulino	neĝ'ul'in'o
neĝulinon	neĝ'ul'in'o'n
nek	nek
nekrologo	nekrolog'o
nekrologoj	nekrolog'o'j
nekrologon	nekrolog'o'n
nekromancio	nekromanci'o
nekropolo	nekropol'o
nekropsio	nekropsi'o
nekropsion	nekropsi'o'n
nekrozo	nekroz'o
nektaro	nektar'o
nektaron	nektar'o'n
nemezo	nemez'o
nenia	neni'a
neniaj	neni'a'j
neniajn	neni'a'j'n
nenian	neni'a'n
nenio	neni'o
nenion	neni'o'n
neniamaniere	neni'a'manier'e
nenieco	neni'ec'o
neniecon	neni'ec'o'n
nenifarado	neni'far'ad'o
neniigas	neni'ig'as
neniigi	neni'ig'i
neniigis	neni'ig'is
neniigo	neni'ig'o
neniigon	neni'ig'o'n
neniigos	neni'ig'os
neniigus	neni'ig'us
neniigante	neni'ig'ant'e
neniigita	neni'ig'it'a
neniigitaj	neni'ig'it'a'j
neniiĝis	neni'iĝ'is
neniiĝo	neni'iĝ'o
nenimaniere	neni'manier'e
neniofarado	neni'o'far'ad'o
neniokaze	neni'o'kaz'e
nenivorto	neni'vort'o
nenial	nenial
neniam	neniam
neniamo	neniam'o
nenie	nenie
nenien	nenie'n
neniel	neniel
nenies	nenies
nenieslando	nenies'land'o
neniom	neniom
neniu	neniu
neniuj	neniu'j
neniun	neniu'n
neniujn	neniu'j'n
neniukaze	neniu'kaz'e
neniuokaze	neniu'okaz'e
neoklasika	neoklasik'a
neoklasikaj	neoklasik'a'j
neokortekso	neokorteks'o
neoliberala	neoliberal'a
neolitika	neolitik'a
neolitikaj	neolitik'a'j
neolitiko	neolitik'o
neologisma	neolog'ism'a
neologisme	neolog'ism'e
neologismo	neolog'ism'o
neologismoj	neolog'ism'o'j
neologismojn	neolog'ism'o'j'n
neologismon	neolog'ism'o'n
neono	neon'o
neoplastaj	neoplast'a'j
neoptolemo	neoptolem'o
neotropika	neotropik'a
neotropisa	neotropis'a
neotropiso	neotropis'o
nepa	nep'a
nepo	nep'o
nepoj	nep'o'j
nepojn	nep'o'j'n
nepon	nep'o'n
nepeto	nep'et'o
nepeton	nep'et'o'n
nepino	nep'in'o
nepinoj	nep'in'o'j
nepinon	nep'in'o'n
nepala	nepal'a
nepalaj	nepal'a'j
nepalan	nepal'a'n
nepalo	nepal'o
nepalon	nepal'o'n
nepalanoj	nepal'an'o'j
nepotismo	nepotism'o
nepra	nepr'a
nepraj	nepr'a'j
neprajn	nepr'a'j'n
nepran	nepr'a'n
nepras	nepr'as
nepre	nepr'e
nepris	nepr'is
nepraĵo	nepr'aĵ'o
nepreco	nepr'ec'o
neprigas	nepr'ig'as
neprigi	nepr'ig'i
neptuno	neptun'o
nerva	nerv'a
nervaj	nerv'a'j
nervajn	nerv'a'j'n
nervan	nerv'a'n
nerve	nerv'e
nervo	nerv'o
nervoj	nerv'o'j
nervojn	nerv'o'j'n
nervon	nerv'o'n
nervoĉeloj	nerv'o'ĉel'o'j
nervofibroj	nerv'o'fibr'o'j
nervofinaĵoj	nerv'o'fin'aĵ'o'j
nervosistemo	nerv'o'sistem'o
nervosistemon	nerv'o'sistem'o'n
nervoza	nervoz'a
nervozaj	nervoz'a'j
nervozan	nervoz'a'n
nervozas	nervoz'as
nervoze	nervoz'e
nervozis	nervoz'is
nervozeco	nervoz'ec'o
nervoziga	nervoz'ig'a
nervozigas	nervoz'ig'as
nervozigi	nervoz'ig'i
nervozigis	nervoz'ig'is
nervoziĝas	nervoz'iĝ'as
nervoziĝi	nervoz'iĝ'i
nervoziĝis	nervoz'iĝ'is
nervoziĝu	nervoz'iĝ'u
nervuro	nervur'o
nervuroj	nervur'o'j
nesta	nest'a
nestaj	nest'a'j
nestas	nest'as
nesti	nest'i
nestis	nest'is
nesto	nest'o
nestoj	nest'o'j
nestojn	nest'o'j'n
neston	nest'o'n
nestado	nest'ad'o
nestamasulo	nest'amas'ul'o
nestamasuloj	nest'amas'ul'o'j
nestantajn	nest'ant'a'j'n
nestejo	nest'ej'o
nestejoj	nest'ej'o'j
nestita	nest'it'a
nestitaj	nest'it'a'j
nestkaverno	nest'kavern'o
nestkavernoj	nest'kavern'o'j
nestkavernojn	nest'kavern'o'j'n
nestkavernon	nest'kavern'o'n
nestokonstruado	nest'o'konstru'ad'o
nestoloko	nest'o'lok'o
nestolokoj	nest'o'lok'o'j
nestolokojn	nest'o'lok'o'j'n
nestolokon	nest'o'lok'o'n
nestotruo	nest'o'tru'o
nestotruoj	nest'o'tru'o'j
nestotruojn	nest'o'tru'o'j'n
nestumas	nest'um'as
nestumi	nest'um'i
nestumado	nest'um'ad'o
nestumante	nest'um'ant'e
nestoro	nestor'o
nestorian	nestori'a'n
nestorio	nestori'o
nestorianoj	nestori'an'o'j
nestorianismo	nestori'an'ism'o
neta	net'a
netaj	net'a'j
netajn	net'a'j'n
netan	net'a'n
nete	net'e
neto	net'o
netefiko	net'efik'o
neŭrologo	neŭr'olog'o
neŭrologoj	neŭr'olog'o'j
neŭrologia	neŭr'olog'i'a
neŭrologiaj	neŭr'olog'i'a'j
neŭrologiajn	neŭr'olog'i'a'j'n
neŭrologian	neŭr'olog'i'a'n
neŭrologio	neŭr'olog'i'o
neŭronaj	neŭr'on'a'j
neŭrono	neŭr'on'o
neŭronoj	neŭr'on'o'j
neŭronojn	neŭr'on'o'j'n
neŭronon	neŭr'on'o'n
neŭrozo	neŭr'oz'o
neŭrozoj	neŭr'oz'o'j
neŭtona	neŭton'a
neŭtono	neŭton'o
neŭtra	neŭtr'a
neŭtraj	neŭtr'a'j
neŭtrajn	neŭtr'a'j'n
neŭtran	neŭtr'a'n
neŭtrala	neŭtral'a
neŭtralaj	neŭtral'a'j
neŭtralajn	neŭtral'a'j'n
neŭtralan	neŭtral'a'n
neŭtrale	neŭtral'e
neŭtraleco	neŭtral'ec'o
neŭtralecon	neŭtral'ec'o'n
neŭtraligas	neŭtral'ig'as
neŭtraligi	neŭtral'ig'i
neŭtraligo	neŭtral'ig'o
neŭtraligado	neŭtral'ig'ad'o
neŭtraligita	neŭtral'ig'it'a
neŭtraligitaj	neŭtral'ig'it'a'j
neŭtralismo	neŭtral'ism'o
neŭtralismon	neŭtral'ism'o'n
neŭtralulo	neŭtral'ul'o
neŭtraluloj	neŭtral'ul'o'j
neŭtrino	neŭtrin'o
neŭtrinoj	neŭtrin'o'j
neŭtrona	neŭtron'a
neŭtronaj	neŭtron'a'j
neŭtrono	neŭtron'o
neŭtronoj	neŭtron'o'j
neŭtronojn	neŭtron'o'j'n
neŭtronon	neŭtron'o'n
neva	nev'a
nevo	nev'o
nevoj	nev'o'j
nevojn	nev'o'j'n
nevon	nev'o'n
nevino	nev'in'o
nevinoj	nev'in'o'j
nevinojn	nev'in'o'j'n
nevinon	nev'in'o'n
nevada	nevad'a
nevado	nevad'o
neviso	nevis'o
ni	ni
nia	ni'a
niaj	ni'a'j
niajn	ni'a'j'n
nian	ni'a'n
nin	ni'n
niaflanke	ni'a'flank'e
niahejme	ni'a'hejm'e
niahejmen	ni'a'hejm'e'n
nialanda	ni'a'land'a
niaopinie	ni'a'opini'e
niatempe	ni'a'temp'e
niagara	niagar'a
niagaro	niagar'o
niĉo	niĉ'o
niĉoj	niĉ'o'j
niĉojn	niĉ'o'j'n
niĉon	niĉ'o'n
niĉita	niĉ'it'a
niĉitaj	niĉ'it'a'j
niĉeo	niĉe'o
nifo	nif'o
nifoj	nif'o'j
nifon	nif'o'n
nigra	nigr'a
nigraj	nigr'a'j
nigrajn	nigr'a'j'n
nigran	nigr'a'n
nigras	nigr'as
nigre	nigr'e
nigris	nigr'is
nigro	nigr'o
nigron	nigr'o'n
nigrablanka	nigr'a'blank'a
nigrablankaj	nigr'a'blank'a'j
nigrablankajn	nigr'a'blank'a'j'n
nigrablankan	nigr'a'blank'a'n
nigrablankaĵo	nigr'a'blank'aĵ'o
nigragorĝa	nigr'a'gorĝ'a
nigrahara	nigr'a'har'a
nigrakapa	nigr'a'kap'a
nigramara	nigr'a'mar'a
nigrametalo	nigr'a'metal'o
nigrapieda	nigr'a'pied'a
nigreca	nigr'ec'a
nigrecaj	nigr'ec'a'j
nigrecajn	nigr'ec'a'j'n
nigrecan	nigr'ec'a'n
nigreco	nigr'ec'o
nigrecon	nigr'ec'o'n
nigreta	nigr'et'a
nigrigas	nigr'ig'as
nigrigi	nigr'ig'i
nigrigis	nigr'ig'is
nigrigita	nigr'ig'it'a
nigrigitaj	nigr'ig'it'a'j
nigriĝas	nigr'iĝ'as
nigriĝi	nigr'iĝ'i
nigriĝis	nigr'iĝ'is
nigroblanka	nigr'o'blank'a
nigrula	nigr'ul'a
nigrulaj	nigr'ul'a'j
nigrulo	nigr'ul'o
nigruloj	nigr'ul'o'j
nigrulojn	nigr'ul'o'j'n
nigrulon	nigr'ul'o'n
nigrulino	nigr'ul'in'o
nigrursoj	nigr'urs'o'j
niĝera	niĝer'a
niĝero	niĝer'o
niĝeria	niĝer'i'a
niĝeriaj	niĝer'i'a'j
niĝerian	niĝer'i'a'n
niĝerio	niĝer'i'o
niĝerion	niĝer'i'o'n
niĝerianoj	niĝer'i'an'o'j
niĝerkonga	niĝer'kong'a
nihilismo	nihilism'o
niko	nik'o
nikanoro	nikanor'o
nikaragva	nikaragv'a
nikaragvo	nikaragv'o
nikeforo	nikefor'o
nikela	nikel'a
nikelo	nikel'o
nikobaraj	nikobar'a'j
nikobaroj	nikobar'o'j
nikodemo	nikodem'o
nikola	nikol'a
nikolao	nikola'o
nikolaon	nikola'o'n
nikotino	nikotin'o
nikso	niks'o
niksino	niks'in'o
niksinoj	niks'in'o'j
nikteo	nikte'o
nila	nil'a
nilo	nil'o
nilon	nil'o'n
nildelto	nil'delt'o
nilvalo	nil'val'o
nilonajn	nilon'a'j'n
nilono	nilon'o
nimbo	nimb'o
nimfo	nimf'o
nimfoj	nimf'o'j
nimfojn	nimf'o'j'n
nimfon	nimf'o'n
nimfeo	nimfe'o
nimfeoj	nimfe'o'j
nina	nina
ninevo	ninev'o
niobo	niob'o
niobio	niobi'o
nirvana	nirvan'a
nirvano	nirvan'o
nirvanon	nirvan'o'n
nito	nit'o
nitoj	nit'o'j
nitojn	nit'o'j'n
niton	nit'o'n
nitado	nit'ad'o
nititaj	nit'it'a'j
nitra	nitr'a
nitro	nitr'o
nitrata	nitr'at'a
nitratan	nitr'at'a'n
nitrato	nitr'at'o
nitratoj	nitr'at'o'j
nitrido	nitr'id'o
nitrito	nitr'it'o
nitritoj	nitr'it'o'j
nitrila	nitril'a
nitriloj	nitril'o'j
nitrobenzoato	nitro'benzo'at'o
nitrocelulozo	nitro'celuloz'o
nitroglicerino	nitro'glicer'in'o
nitrogena	nitrogen'a
nitrogenaj	nitrogen'a'j
nitrogeno	nitrogen'o
nitrogenon	nitrogen'o'n
nitrogenatomo	nitrogen'atom'o
niuo	niu'o
nivela	nivel'a
nivelaj	nivel'a'j
nivele	nivel'e
nivelo	nivel'o
niveloj	nivel'o'j
nivelojn	nivel'o'j'n
nivelon	nivel'o'n
niza	niz'a
nizo	niz'o
nizoj	niz'o'j
nobela	nobel'a
nobelaj	nobel'a'j
nobelajn	nobel'a'j'n
nobelan	nobel'a'n
nobelo	nobel'o
nobeloj	nobel'o'j
nobelojn	nobel'o'j'n
nobelon	nobel'o'n
nobelaro	nobel'ar'o
nobelaron	nobel'ar'o'n
nobeleco	nobel'ec'o
nobelecon	nobel'ec'o'n
nobelgento	nobel'gent'o
nobelgentoj	nobel'gent'o'j
nobelino	nobel'in'o
nobelkomitato	nobel'komitat'o
nobelpremio	nobel'premi'o
nobelpremioj	nobel'premi'o'j
nobelpremion	nobel'premi'o'n
nobelpremiito	nobel'premi'it'o
nobelpremiitoj	nobel'premi'it'o'j
nobelulo	nobel'ul'o
nobeluloj	nobel'ul'o'j
nobelulojn	nobel'ul'o'j'n
nobelularo	nobel'ul'ar'o
nobla	nobl'a
noblaj	nobl'a'j
noblajn	nobl'a'j'n
noblan	nobl'a'n
noble	nobl'e
nobleco	nobl'ec'o
noblecon	nobl'ec'o'n
noblega	nobl'eg'a
nobligas	nobl'ig'as
nobluloj	nobl'ul'o'j
noca	noc'a
nocaj	noc'a'j
nocajn	noc'a'j'n
nocas	noc'as
noci	noc'i
nocia	noci'a
nocio	noci'o
nocioj	noci'o'j
nociojn	noci'o'j'n
nocion	noci'o'n
noda	nod'a
nodas	nod'as
nodi	nod'i
nodis	nod'is
nodo	nod'o
nodoj	nod'o'j
nodojn	nod'o'j'n
nodon	nod'o'n
nodita	nod'it'a
noditaj	nod'it'a'j
nokta	nokt'a
noktaj	nokt'a'j
noktajn	nokt'a'j'n
noktan	nokt'a'n
noktas	nokt'as
nokte	nokt'e
nokti	nokt'i
noktis	nokt'is
nokto	nokt'o
noktoj	nokt'o'j
noktojn	nokt'o'j'n
nokton	nokt'o'n
noktado	nokt'ad'o
noktflanko	nokt'flank'o
noktiĝas	nokt'iĝ'as
noktiĝis	nokt'iĝ'is
noktiĝo	nokt'iĝ'o
noktmezo	nokt'mez'o
noktoklubo	nokt'o'klub'o
noktokluboj	nokt'o'klub'o'j
noktomeza	nokt'o'mez'a
noktomeze	nokt'o'mez'e
noktomezo	nokt'o'mez'o
noktomezon	nokt'o'mez'o'n
noktovazo	nokt'o'vaz'o
noktuloj	nokt'ul'o'j
noktumi	nokt'um'i
noktuo	noktu'o
noma	nom'a
nomaj	nom'a'j
noman	nom'a'n
nomas	nom'as
nome	nom'e
nomi	nom'i
nomis	nom'is
nomo	nom'o
nomoj	nom'o'j
nomojn	nom'o'j'n
nomon	nom'o'n
nomos	nom'os
nomu	nom'u
nomus	nom'us
nomaĉis	nom'aĉ'is
nomanta	nom'ant'a
nomantaj	nom'ant'a'j
nomantan	nom'ant'a'n
nomante	nom'ant'e
nomaro	nom'ar'o
nomaron	nom'ar'o'n
nomata	nom'at'a
nomataj	nom'at'a'j
nomatajn	nom'at'a'j'n
nomatan	nom'at'a'n
nomatas	nom'at'as
nomdonanto	nom'don'ant'o
nomebla	nom'ebl'a
nomformo	nom'form'o
nomiga	nom'ig'a
nomigas	nom'ig'as
nomigi	nom'ig'i
nomigis	nom'ig'is
nomigo	nom'ig'o
nomigita	nom'ig'it'a
nomigitaj	nom'ig'it'a'j
nomiĝas	nom'iĝ'as
nomiĝi	nom'iĝ'i
nomiĝis	nom'iĝ'is
nomiĝos	nom'iĝ'os
nomiĝu	nom'iĝ'u
nomiĝus	nom'iĝ'us
nomiĝanta	nom'iĝ'ant'a
nomiĝinta	nom'iĝ'int'a
nomiĝintaj	nom'iĝ'int'a'j
nominta	nom'int'a
nomita	nom'it'a
nomitaj	nom'it'a'j
nomitajn	nom'it'a'j'n
nomitan	nom'it'a'n
nomite	nom'it'e
nomitis	nom'it'is
nomkarto	nom'kart'o
nomlisto	nom'list'o
nomliston	nom'list'o'n
nomota	nom'ot'a
nomsistemo	nom'sistem'o
nomspaco	nom'spac'o
nomŝanĝo	nom'ŝanĝ'o
nomŝildon	nom'ŝild'o'n
nomumas	nom'um'as
nomumi	nom'um'i
nomumis	nom'um'is
nomumo	nom'um'o
nomumoj	nom'um'o'j
nomumojn	nom'um'o'j'n
nomumon	nom'um'o'n
nomumos	nom'um'os
nomumus	nom'um'us
nomumado	nom'um'ad'o
nomumanta	nom'um'ant'a
nomumante	nom'um'ant'e
nomumata	nom'um'at'a
nomumiĝis	nom'um'iĝ'is
nomumita	nom'um'it'a
nomumitaj	nom'um'it'a'j
nomumitajn	nom'um'it'a'j'n
nomumite	nom'um'it'e
nomumito	nom'um'it'o
nomumitoj	nom'um'it'o'j
nomvarianto	nom'variant'o
nomvortoj	nom'vort'o'j
nomada	nomad'a
nomadaj	nomad'a'j
nomadajn	nomad'a'j'n
nomadan	nomad'a'n
nomadis	nomad'is
nomado	nomad'o
nomadoj	nomad'o'j
nomadojn	nomad'o'j'n
nomadon	nomad'o'n
nomadismo	nomad'ism'o
nombra	nombr'a
nombraj	nombr'a'j
nombrajn	nombr'a'j'n
nombran	nombr'a'n
nombras	nombr'as
nombre	nombr'e
nombri	nombr'i
nombris	nombr'is
nombro	nombr'o
nombroj	nombr'o'j
nombrojn	nombr'o'j'n
nombron	nombr'o'n
nombros	nombr'os
nombru	nombr'u
nombrado	nombr'ad'o
nombradon	nombr'ad'o'n
nombranta	nombr'ant'a
nombrante	nombr'ant'e
nombrebla	nombr'ebl'a
nombregoj	nombr'eg'o'j
nombregojn	nombr'eg'o'j'n
nombriĝas	nombr'iĝ'as
nombrilo	nombr'il'o
nombrita	nombr'it'a
nombritaj	nombr'it'a'j
nombrosistemo	nombr'o'sistem'o
nombrosistemoj	nombr'o'sistem'o'j
nombroteorio	nombr'o'teori'o
nombrovorto	nombr'o'vort'o
nombrovortoj	nombr'o'vort'o'j
nombrovortojn	nombr'o'vort'o'j'n
nombrvaloro	nombr'valor'o
nomenklaturo	nomenklatur'o
nomenklaturon	nomenklatur'o'n
nominala	nominal'a
nominalaj	nominal'a'j
nominalajn	nominal'a'j'n
nominalan	nominal'a'n
nominale	nominal'e
nominaloj	nominal'o'j
nominalismo	nominal'ism'o
nominativa	nominativ'a
nominativo	nominativ'o
nominativon	nominativ'o'n
norda	nord'a
nordaj	nord'a'j
nordajn	nord'a'j'n
nordan	nord'a'n
norde	nord'e
norden	nord'e'n
nordo	nord'o
nordon	nord'o'n
nordasuda	nord'a'sud'a
nordafrika	nord'afrik'a
nordafrikaj	nord'afrik'a'j
nordafriko	nord'afrik'o
nordafrikanoj	nord'afrik'an'o'j
nordamerika	nord'amerik'a
nordamerikaj	nord'amerik'a'j
nordamerikajn	nord'amerik'a'j'n
nordamerikan	nord'amerik'a'n
nordameriko	nord'amerik'o
nordamerikon	nord'amerik'o'n
nordamerikano	nord'amerik'an'o
nordamerikanoj	nord'amerik'an'o'j
nordano	nord'an'o
nordanoj	nord'an'o'j
nordatlantika	nord'atlantik'a
nordbrabanto	nord'brabant'o
nordcentra	nord'centr'a
nordeŭropa	nord'eŭrop'a
nordeŭropaj	nord'eŭrop'a'j
nordeŭropo	nord'eŭrop'o
nordgermana	nord'german'a
nordĝermana	nord'ĝerman'a
nordholando	nord'holand'o
nordia	nord'i'a
nordiaj	nord'i'a'j
nordian	nord'i'a'n
nordio	nord'i'o
nordianoj	nord'i'an'o'j
nordirlanda	nord'irland'a
nordirlando	nord'irland'o
nordkorea	nord'kore'a
nordkoreaj	nord'kore'a'j
nordkoreajn	nord'kore'a'j'n
nordkoreanoj	nord'kore'an'o'j
nordkoreio	nord'kore'i'o
nordkoreion	nord'kore'i'o'n
nordkoreujo	nord'kore'uj'o
nordmakedonio	nord'makedon'i'o
nordmara	nord'mar'a
nordokcidenta	nord'okcident'a
nordokcidentaj	nord'okcident'a'j
nordokcidentan	nord'okcident'a'n
nordokcidente	nord'okcident'e
nordokcidenten	nord'okcident'e'n
nordokcidento	nord'okcident'o
nordokcidenton	nord'okcident'o'n
nordorienta	nord'orient'a
nordorientaj	nord'orient'a'j
nordorientan	nord'orient'a'n
nordoriente	nord'orient'e
nordorienten	nord'orient'e'n
nordoriento	nord'orient'o
nordorienton	nord'orient'o'n
nordosetio	nord'oset'i'o
nordsuda	nord'sud'a
nordsudaj	nord'sud'a'j
nordsude	nord'sud'e
nordsuden	nord'sud'e'n
nordvjetnamo	nord'vjetnam'o
norfolkinsulo	norfolk'insul'o
norio	nori'o
noriega	nori'eg'a
norma	norm'a
normaj	norm'a'j
normajn	norm'a'j'n
norman	norm'a'n
norme	norm'e
normo	norm'o
normoj	norm'o'j
normojn	norm'o'j'n
normon	norm'o'n
normangla	norm'angl'a
normdana	norm'dan'a
normiga	norm'ig'a
normigaj	norm'ig'a'j
normigajn	norm'ig'a'j'n
normigan	norm'ig'a'n
normigas	norm'ig'as
normigi	norm'ig'i
normigis	norm'ig'is
normigo	norm'ig'o
normigado	norm'ig'ad'o
normigadon	norm'ig'ad'o'n
normigita	norm'ig'it'a
normigitaj	norm'ig'it'a'j
normigitajn	norm'ig'it'a'j'n
normigitan	norm'ig'it'a'n
normismo	norm'ism'o
normkantoj	norm'kant'o'j
normlingvo	norm'lingv'o
normogermano	norm'o'german'o
normala	normal'a
normalaj	normal'a'j
normalajn	normal'a'j'n
normalan	normal'a'n
normalas	normal'as
normale	normal'e
normalo	normal'o
normaloj	normal'o'j
normalon	normal'o'n
normaleco	normal'ec'o
normaliga	normal'ig'a
normaligi	normal'ig'i
normaligis	normal'ig'is
normaligo	normal'ig'o
normaligon	normal'ig'o'n
normaligita	normal'ig'it'a
normaligitaj	normal'ig'it'a'j
normaliĝo	normal'iĝ'o
normalkaze	normal'kaz'e
normalokaze	normal'okaz'e
normalstatoj	normal'stat'o'j
normaluloj	normal'ul'o'j
normana	norman'a
normanoj	norman'o'j
normanda	normand'a
normando	normand'o
normandie	normand'i'e
normandio	normand'i'o
normandion	normand'i'o'n
norvega	norveg'a
norvegaj	norveg'a'j
norvegajn	norveg'a'j'n
norvegan	norveg'a'n
norvege	norveg'e
norvego	norveg'o
norvegoj	norveg'o'j
norvegio	norveg'i'o
norvegion	norveg'i'o'n
norvegujo	norveg'uj'o
nostalgia	nostalgi'a
nostalgiaj	nostalgi'a'j
nostalgian	nostalgi'a'n
nostalgie	nostalgi'e
nostalgio	nostalgi'o
nostalgion	nostalgi'o'n
nota	not'a
notas	not'as
note	not'e
noti	not'i
notis	not'is
noto	not'o
notoj	not'o'j
notojn	not'o'j'n
noton	not'o'n
notos	not'os
notu	not'u
notus	not'us
notado	not'ad'o
notaĵoj	not'aĵ'o'j
notaĵojn	not'aĵ'o'j'n
notanta	not'ant'a
notante	not'ant'e
notbloko	not'blok'o
notiĝas	not'iĝ'as
notiĝi	not'iĝ'i
notiĝis	not'iĝ'is
notinda	not'ind'a
notindaj	not'ind'a'j
notindajn	not'ind'a'j'n
notindan	not'ind'a'n
notindas	not'ind'as
notinde	not'ind'e
notita	not'it'a
notitaj	not'it'a'j
notite	not'it'e
notlibro	not'libr'o
notlibroj	not'libr'o'j
notlibrojn	not'libr'o'j'n
notlibron	not'libr'o'n
notlibreto	not'libr'et'o
notlibreton	not'libr'et'o'n
notliniaro	not'lini'ar'o
notokordo	not'o'kord'o
notvaloroj	not'valor'o'j
notacio	notaci'o
notacioj	notaci'o'j
notaciojn	notaci'o'j'n
notacion	notaci'o'n
notaria	notari'a
notario	notari'o
notarioj	notari'o'j
notico	notic'o
noticoj	notic'o'j
nova	nov'a
novaj	nov'a'j
novajn	nov'a'j'n
novan	nov'a'n
novas	nov'as
nove	nov'e
novi	nov'i
novo	nov'o
novon	nov'o'n
novaĵa	nov'aĵ'a
novaĵaj	nov'aĵ'a'j
novajho	nov'aĵ'o
novaĵo	nov'aĵ'o
novaĵoj	nov'aĵ'o'j
novaĵojn	nov'aĵ'o'j'n
novaĵon	nov'aĵ'o'n
novaĵagentejo	nov'aĵ'agent'ej'o
novaĵagentejoj	nov'aĵ'agent'ej'o'j
novaĵartikoloj	nov'aĵ'artikol'o'j
novaĵaŭdienco	nov'aĵ'aŭdienc'o
novaĵdisvastigo	nov'aĵ'dis'vast'ig'o
novaĵejo	nov'aĵ'ej'o
novaĵelsendo	nov'aĵ'el'send'o
novaĵelsendoj	nov'aĵ'el'send'o'j
novaĵfontoj	nov'aĵ'font'o'j
novaĵgrupoj	nov'aĵ'grup'o'j
novaĵhistorioj	nov'aĵ'histori'o'j
novaĵletero	nov'aĵ'leter'o
novaĵleterojn	nov'aĵ'leter'o'j'n
novaĵleteron	nov'aĵ'leter'o'n
novaĵmedioj	nov'aĵ'medi'o'j
novaĵoplatformoj	nov'aĵ'o'platform'o'j
novaĵorganizoj	nov'aĵ'organiz'o'j
novaĵprogramoj	nov'aĵ'program'o'j
novaĵretejo	nov'aĵ'ret'ej'o
novaĵretejoj	nov'aĵ'ret'ej'o'j
novaĵservo	nov'aĵ'serv'o
novalvenintoj	nov'al'ven'int'o'j
novanglia	nov'angl'i'a
novanglio	nov'angl'i'o
novbakita	nov'bak'it'a
noveca	nov'ec'a
noveco	nov'ec'o
novedza	nov'edz'a
novedzo	nov'edz'o
novedzon	nov'edz'o'n
novedzino	nov'edz'in'o
novedzinoj	nov'edz'in'o'j
novedzinon	nov'edz'in'o'n
novega	nov'eg'a
novegaj	nov'eg'a'j
novelektita	nov'elekt'it'a
noventrepreno	nov'entrepren'o
noventreprenoj	nov'entrepren'o'j
novepoka	nov'epok'a
novepoko	nov'epok'o
novfondita	nov'fond'it'a
novgeedzoj	nov'ge'edz'o'j
novgotika	nov'gotik'a
novgreka	nov'grek'a
novgvineo	nov'gvine'o
novhispanio	nov'hispan'i'o
noviga	nov'ig'a
novigaj	nov'ig'a'j
novigajn	nov'ig'a'j'n
novigan	nov'ig'a'n
novigis	nov'ig'is
novigo	nov'ig'o
novigoj	nov'ig'o'j
novigon	nov'ig'o'n
novigado	nov'ig'ad'o
novigadon	nov'ig'ad'o'n
noviganto	nov'ig'ant'o
novigantoj	nov'ig'ant'o'j
novjara	nov'jar'a
novjaraj	nov'jar'a'j
novjarajn	nov'jar'a'j'n
novjaran	nov'jar'a'n
novjaro	nov'jar'o
novjaron	nov'jar'o'n
novĵerzejo	nov'ĵerzej'o
novkaledonio	nov'kaledoni'o
novkastelo	nov'kastel'o
novklasika	nov'klasik'a
novklasikismo	nov'klasik'ism'o
novkomunikilaj	nov'komunik'il'a'j
novkonstruaĵo	nov'konstru'aĵ'o
novkonstruita	nov'konstru'it'a
novkrei	nov'kre'i
novkreita	nov'kre'it'a
novliberala	nov'liberal'a
novliberalismo	nov'liberal'ism'o
novluno	nov'lun'o
novmeksiko	nov'meksik'o
novmoskva	nov'moskv'a
novnaskita	nov'nask'it'a
novnaskitaj	nov'nask'it'a'j
novnaskitan	nov'nask'it'a'n
novnaskito	nov'nask'it'o
novnaskitoj	nov'nask'it'o'j
novnaskiton	nov'nask'it'o'n
novnazioj	nov'nazi'o'j
novorleana	nov'orlean'a
novorleano	nov'orlean'o
novpaganismo	nov'pagan'ism'o
novparolo	nov'parol'o
novplatonismo	nov'platon'ism'o
novskotio	nov'skot'i'o
novspeca	nov'spec'a
novspecaj	nov'spec'a'j
novstila	nov'stil'a
novtempa	nov'temp'a
novtipa	nov'tip'a
novtipaj	nov'tip'a'j
novtipan	nov'tip'a'n
novulo	nov'ul'o
novuloj	nov'ul'o'j
novulojn	nov'ul'o'j'n
novulon	nov'ul'o'n
novzelanda	nov'zeland'a
novzelandaj	nov'zeland'a'j
novzelandan	nov'zeland'a'n
novzelando	nov'zeland'o
novzelandon	nov'zeland'o'n
novzelandanoj	nov'zeland'an'o'j
novao	nova'o
novalis	noval'is
novalo	noval'o
novalis	novalis
novelo	novel'o
noveloj	novel'o'j
novelojn	novel'o'j'n
novelon	novel'o'n
novelaro	novel'ar'o
novelaroj	novel'ar'o'j
novelaron	novel'ar'o'n
noveletoj	novel'et'o'j
novelisto	novel'ist'o
novembra	novembr'a
novembre	novembr'e
novembro	novembr'o
novembron	novembr'o'n
novica	novic'a
novico	novic'o
novicoj	novic'o'j
novicojn	novic'o'j'n
novjorka	novjork'a
novjorkaj	novjork'a'j
novjorkan	novjork'a'n
novjorko	novjork'o
novjorkon	novjork'o'n
novjorkanoj	novjork'an'o'j
novjorkio	novjork'i'o
novlanda	novland'a
novlando	novland'o
novosibirska	novosibirsk'a
novosibirsko	novosibirsk'o
nu	nu
nuanca	nuanc'a
nuancas	nuanc'as
nuance	nuanc'e
nuanci	nuanc'i
nuanco	nuanc'o
nuancoj	nuanc'o'j
nuancojn	nuanc'o'j'n
nuancon	nuanc'o'n
nuancado	nuanc'ad'o
nuancigi	nuanc'ig'i
nuanciĝas	nuanc'iĝ'as
nuancilo	nuanc'il'o
nuanciloj	nuanc'il'o'j
nuancilojn	nuanc'il'o'j'n
nuancita	nuanc'it'a
nuancitaj	nuanc'it'a'j
nuancitajn	nuanc'it'a'j'n
nuancitan	nuanc'it'a'n
nuba	nub'a
nubaj	nub'a'j
nuban	nub'a'n
nube	nub'e
nubo	nub'o
nuboj	nub'o'j
nubojn	nub'o'j'n
nubon	nub'o'n
nubaro	nub'ar'o
nubaron	nub'ar'o'n
nubeca	nub'ec'a
nubego	nub'eg'o
nubeto	nub'et'o
nubetoj	nub'et'o'j
nubgutetoj	nub'gut'et'o'j
nubskrapulo	nub'skrap'ul'o
nubskrapuloj	nub'skrap'ul'o'j
nubia	nubi'a
nubiaj	nubi'a'j
nubio	nubi'o
nubianoj	nubi'an'o'j
nuda	nud'a
nudaj	nud'a'j
nudajn	nud'a'j'n
nudan	nud'a'n
nudas	nud'as
nude	nud'e
nudeco	nud'ec'o
nudecon	nud'ec'o'n
nudigas	nud'ig'as
nudigi	nud'ig'i
nudigis	nud'ig'is
nudigo	nud'ig'o
nudiganta	nud'ig'ant'a
nudigante	nud'ig'ant'e
nudigita	nud'ig'it'a
nudigitaj	nud'ig'it'a'j
nudisma	nud'ism'a
nudismaj	nud'ism'a'j
nudismo	nud'ism'o
nudistoj	nud'ist'o'j
nudokule	nud'okul'e
nudpieda	nud'pied'a
nudpiedaj	nud'pied'a'j
nudpiede	nud'pied'e
nuduloj	nud'ul'o'j
nudelo	nudel'o
nudeloj	nudel'o'j
nudelojn	nudel'o'j'n
nudelon	nudel'o'n
nuka	nuk'a
nuko	nuk'o
nukon	nuk'o'n
nuklea	nukle'a
nukleaj	nukle'a'j
nukleajn	nukle'a'j'n
nuklean	nukle'a'n
nukleo	nukle'o
nukleoj	nukle'o'j
nukleojn	nukle'o'j'n
nukleon	nukle'o'n
nukleaenergia	nukle'a'energi'a
nukleaenergiaj	nukle'a'energi'a'j
nuklearmila	nukle'arm'il'a
nukleosintezo	nukle'o'sintez'o
nukleonoj	nukleon'o'j
nukleotido	nukleotid'o
nukleotidoj	nukleotid'o'j
nukso	nuks'o
nuksoj	nuks'o'j
nuksojn	nuks'o'j'n
nukson	nuks'o'n
nukseto	nuks'et'o
nuksetoj	nuks'et'o'j
nul	nul
nula	nul'a
nulaj	nul'a'j
nulan	nul'a'n
nulo	nul'o
nuloj	nul'o'j
nulojn	nul'o'j'n
nulon	nul'o'n
nulhipotezo	nul'hipotez'o
nuligas	nul'ig'as
nuligi	nul'ig'i
nuligis	nul'ig'is
nuligo	nul'ig'o
nuligoj	nul'ig'o'j
nuligon	nul'ig'o'n
nuligos	nul'ig'os
nuligu	nul'ig'u
nuligus	nul'ig'us
nuligado	nul'ig'ad'o
nuligante	nul'ig'ant'e
nuligata	nul'ig'at'a
nuligita	nul'ig'it'a
nuligitaj	nul'ig'it'a'j
nuliĝas	nul'iĝ'as
nuliĝis	nul'iĝ'is
nulpunkto	nul'punkt'o
nululo	nul'ul'o
numera	numer'a
numeraj	numer'a'j
numerajn	numer'a'j'n
numeran	numer'a'n
numeras	numer'as
numero	numer'o
numeroj	numer'o'j
numerojn	numer'o'j'n
numeron	numer'o'n
numerado	numer'ad'o
numerante	numer'ant'e
numerebla	numer'ebl'a
numerita	numer'it'a
numeritaj	numer'it'a'j
numerplato	numer'plat'o
numeralo	numeral'o
numeraloj	numeral'o'j
numeralojn	numeral'o'j'n
numeralon	numeral'o'n
numeratoro	numerator'o
numido	numid'o
numidoj	numid'o'j
numidia	numid'i'a
numismatiko	numismat'ik'o
nun	nun
nuna	nun'a
nunaj	nun'a'j
nunajn	nun'a'j'n
nunan	nun'a'n
nune	nun'e
nuno	nun'o
nunon	nun'o'n
nunjara	nun'jar'a
nunjaraj	nun'jar'a'j
nunjare	nun'jar'e
nunmomente	nun'moment'e
nuntempa	nun'temp'a
nuntempaj	nun'temp'a'j
nuntempajn	nun'temp'a'j'n
nuntempan	nun'temp'a'n
nuntempe	nun'temp'e
nuntempo	nun'temp'o
nuntempon	nun'temp'o'n
nuntempuloj	nun'temp'ul'o'j
nuncio	nunci'o
nupta	nupt'a
nuptaj	nupt'a'j
nuptan	nupt'a'n
nupto	nupt'o
nuptoj	nupt'o'j
nupton	nupt'o'n
nuptofesto	nupt'o'fest'o
nur	nur
nura	nur'a
nuraj	nur'a'j
nurajn	nur'a'j'n
nuran	nur'a'n
nurangla	nur'angl'a
nurlegebla	nur'leg'ebl'a
nurlegeblamemora	nur'leg'ebl'a'memor'a
nurnure	nur'nur'e
nutra	nutr'a
nutraj	nutr'a'j
nutrajn	nutr'a'j'n
nutran	nutr'a'n
nutras	nutr'as
nutre	nutr'e
nutri	nutr'i
nutris	nutr'is
nutro	nutr'o
nutron	nutr'o'n
nutros	nutr'os
nutru	nutr'u
nutrus	nutr'us
nutrado	nutr'ad'o
nutradon	nutr'ad'o'n
nutraĵa	nutr'aĵ'a
nutraĵaj	nutr'aĵ'a'j
nutraĵan	nutr'aĵ'a'n
nutrajho	nutr'aĵ'o
nutraĵo	nutr'aĵ'o
nutraĵoj	nutr'aĵ'o'j
nutraĵojn	nutr'aĵ'o'j'n
nutraĵon	nutr'aĵ'o'n
nutraĵfonto	nutr'aĵ'font'o
nutraĵfontoj	nutr'aĵ'font'o'j
nutraĵfonton	nutr'aĵ'font'o'n
nutraĵhelpo	nutr'aĵ'help'o
nutraĵindustrio	nutr'aĵ'industri'o
nutraĵplanto	nutr'aĵ'plant'o
nutraĵprilaborado	nutr'aĵ'pri'labor'ad'o
nutraĵriĉa	nutr'aĵ'riĉ'a
nutraĵriĉaj	nutr'aĵ'riĉ'a'j
nutraĵsekureco	nutr'aĵ'sekur'ec'o
nutraĵvaroj	nutr'aĵ'var'o'j
nutraĵvendejo	nutr'aĵ'vend'ej'o
nutraĵvendejoj	nutr'aĵ'vend'ej'o'j
nutranta	nutr'ant'a
nutrantaj	nutr'ant'a'j
nutrante	nutr'ant'e
nutrata	nutr'at'a
nutrataj	nutr'at'a'j
nutriga	nutr'ig'a
nutriĝas	nutr'iĝ'as
nutriĝi	nutr'iĝ'i
nutristino	nutr'ist'in'o
nutrita	nutr'it'a
nutritaj	nutr'it'a'j
nutroaldonaĵo	nutr'o'al'don'aĵ'o
nutroĉeno	nutr'o'ĉen'o
nutroelementoj	nutr'o'element'o'j
nutroindustrio	nutr'o'industri'o
nutromanko	nutr'o'mank'o
nutroriĉaj	nutr'o'riĉ'a'j
nutrovaloron	nutr'o'valor'o'n
nutrovaroj	nutr'o'var'o'j