oj	o'j
ofinaĵo	o'fin'aĵ'o
ofinaĵon	o'fin'aĵ'o'n
oformo	o'form'o
ovorta	o'vort'a
ovortaj	o'vort'a'j
ovortan	o'vort'a'n
ovorto	o'vort'o
ovortoj	o'vort'o'j
ovortojn	o'vort'o'j'n
ovorton	o'vort'o'n
ovorteca	o'vort'ec'a
ovortecaj	o'vort'ec'a'j
ovortece	o'vort'ec'e
oazo	oaz'o
oazoj	oaz'o'j
oazon	oaz'o'n
obea	obe'a
obeas	obe'as
obee	obe'e
obei	obe'i
obeis	obe'is
obeo	obe'o
obeon	obe'o'n
obeos	obe'os
obeu	obe'u
obeus	obe'us
obeado	obe'ad'o
obeadon	obe'ad'o'n
obeanta	obe'ant'a
obeantaj	obe'ant'a'j
obeante	obe'ant'e
obeata	obe'at'a
obeema	obe'em'a
obeemaj	obe'em'a'j
obeemajn	obe'em'a'j'n
obeeman	obe'em'a'n
obeeme	obe'em'e
obeemo	obe'em'o
obeemon	obe'em'o'n
obeigas	obe'ig'as
obeigi	obe'ig'i
obeigo	obe'ig'o
obeintus	obe'int'us
obeita	obe'it'a
obelisko	obelisk'o
obeliskoj	obelisk'o'j
obeza	obez'a
obezaj	obez'a'j
obezeco	obez'ec'o
obezecon	obez'ec'o'n
objekta	objekt'a
objektaj	objekt'a'j
objektan	objekt'a'n
objekto	objekt'o
objektoj	objekt'o'j
objektojn	objekt'o'j'n
objekton	objekt'o'n
objektema	objekt'em'a
objektigado	objekt'ig'ad'o
objektorientita	objekt'orient'it'a
objektorientitaj	objekt'orient'it'a'j
objektiva	objektiv'a
objektivaj	objektiv'a'j
objektivajn	objektiv'a'j'n
objektivan	objektiv'a'n
objektive	objektiv'e
objektivo	objektiv'o
objektivoj	objektiv'o'j
objektivojn	objektiv'o'j'n
objektivon	objektiv'o'n
objektiveco	objektiv'ec'o
objektivecon	objektiv'ec'o'n
objektivigado	objektiv'ig'ad'o
objektivismo	objektiv'ism'o
obĵetas	obĵet'as
obĵeti	obĵet'i
obĵetis	obĵet'is
obĵeto	obĵet'o
obĵetoj	obĵet'o'j
obĵetojn	obĵet'o'j'n
obĵeton	obĵet'o'n
oble	obl'e
obleco	obl'ec'o
oblato	oblat'o
oblatoj	oblat'o'j
oblaton	oblat'o'n
obligaciaj	obligaci'a'j
obligacio	obligaci'o
obligacioj	obligaci'o'j
obligaciojn	obligaci'o'j'n
obligacion	obligaci'o'n
oblikva	oblikv'a
oblikvaj	oblikv'a'j
oblikvajn	oblikv'a'j'n
oblikvan	oblikv'a'n
oblikve	oblikv'e
oblikvo	oblikv'o
oblikvoj	oblikv'o'j
obscena	obscen'a
obscenaj	obscen'a'j
obsceneco	obscen'ec'o
obseda	obsed'a
obsedas	obsed'as
obsede	obsed'e
obsedis	obsed'is
obsedo	obsed'o
obsedoj	obsed'o'j
obsedon	obsed'o'n
obsedanta	obsed'ant'a
obsedata	obsed'at'a
obsedita	obsed'it'a
obseditaj	obsed'it'a'j
observa	observ'a
observaj	observ'a'j
observajn	observ'a'j'n
observan	observ'a'n
observas	observ'as
observe	observ'e
observi	observ'i
observis	observ'is
observo	observ'o
observoj	observ'o'j
observojn	observ'o'j'n
observon	observ'o'n
observos	observ'os
observu	observ'u
observus	observ'us
observadas	observ'ad'as
observadi	observ'ad'i
observadis	observ'ad'is
observado	observ'ad'o
observadoj	observ'ad'o'j
observadojn	observ'ad'o'j'n
observadon	observ'ad'o'n
observaĵoj	observ'aĵ'o'j
observaĵojn	observ'aĵ'o'j'n
observanta	observ'ant'a
observantaj	observ'ant'a'j
observantajn	observ'ant'a'j'n
observantan	observ'ant'a'n
observante	observ'ant'e
observanto	observ'ant'o
observantoj	observ'ant'o'j
observantojn	observ'ant'o'j'n
observanton	observ'ant'o'n
observata	observ'at'a
observataj	observ'at'a'j
observebla	observ'ebl'a
observeblaj	observ'ebl'a'j
observeblajn	observ'ebl'a'j'n
observeblan	observ'ebl'a'n
observeblas	observ'ebl'as
observejo	observ'ej'o
observejoj	observ'ej'o'j
observema	observ'em'a
observemaj	observ'em'a'j
observigas	observ'ig'as
observigi	observ'ig'i
observita	observ'it'a
observitaj	observ'it'a'j
observitajn	observ'it'a'j'n
observitan	observ'it'a'n
observite	observ'it'e
observatorio	observatori'o
observatorioj	observatori'o'j
observatoriojn	observatori'o'j'n
observatorion	observatori'o'n
obsidiano	obsidian'o
obskura	obskur'a
obskuraj	obskur'a'j
obskurajn	obskur'a'j'n
obskuran	obskur'a'n
obskuras	obskur'as
obskure	obskur'e
obskuri	obskur'i
obskuris	obskur'is
obskuro	obskur'o
obskuron	obskur'o'n
obskurante	obskur'ant'e
obskurantismo	obskur'ant'ism'o
obskureco	obskur'ec'o
obskuriĝo	obskur'iĝ'o
obskurita	obskur'it'a
obskuritaj	obskur'it'a'j
obstaklas	obstakl'as
obstakli	obstakl'i
obstaklis	obstakl'is
obstaklo	obstakl'o
obstakloj	obstakl'o'j
obstaklojn	obstakl'o'j'n
obstaklon	obstakl'o'n
obstina	obstin'a
obstinaj	obstin'a'j
obstinajn	obstin'a'j'n
obstinan	obstin'a'n
obstinas	obstin'as
obstine	obstin'e
obstini	obstin'i
obstinis	obstin'is
obstino	obstin'o
obstinon	obstin'o'n
obstineco	obstin'ec'o
obstinecon	obstin'ec'o'n
obstinulo	obstin'ul'o
obstinuloj	obstin'ul'o'j
obstrukcas	obstrukc'as
obstrukci	obstrukc'i
obstrukcis	obstrukc'is
obstrukco	obstrukc'o
obstrukcoj	obstrukc'o'j
obstrukcojn	obstrukc'o'j'n
obstrukcon	obstrukc'o'n
obstrukciĝo	obstrukc'iĝ'o
obstrukciĝon	obstrukc'iĝ'o'n
obstrukcita	obstrukc'it'a
obtenas	obten'as
obteni	obten'i
obtenis	obten'is
obtenos	obten'os
obtuza	obtuz'a
obtuzaj	obtuz'a'j
obtuzan	obtuz'a'n
obtuze	obtuz'e
obuso	obus'o
obusoj	obus'o'j
obusojn	obus'o'j'n
obuson	obus'o'n
oceana	ocean'a
oceanaj	ocean'a'j
oceanajn	ocean'a'j'n
oceanan	ocean'a'n
oceano	ocean'o
oceanoj	ocean'o'j
oceanojn	ocean'o'j'n
oceanon	ocean'o'n
oceankrusto	ocean'krust'o
oceanografio	ocean'o'graf'i'o
oceansurfaco	ocean'surfac'o
oceania	oceani'a
oceanio	oceani'o
ocela	ocel'a
oceloj	ocel'o'j
oĉjo	oĉj'o
odo	od'o
odesa	odes'a
odeso	odes'o
odiseo	odise'o
odiseon	odise'o'n
odiseado	odise'ad'o
odoakro	odoakr'o
odora	odor'a
odoraj	odor'a'j
odoras	odor'as
odori	odor'i
odoris	odor'is
odoro	odor'o
odoroj	odor'o'j
odorojn	odor'o'j'n
odoron	odor'o'n
odoraĉas	odor'aĉ'as
odoraĉis	odor'aĉ'is
odoraĉo	odor'aĉ'o
odoranta	odor'ant'a
odorantaj	odor'ant'a'j
odorigagento	odor'ig'agent'o
odorigilo	odor'ig'il'o
odro	odr'o
oestro	oestr'o
oestradiolo	oestradiol'o
oestrogeno	oestrogen'o
oestrogenoj	oestrogen'o'j
ofenda	ofend'a
ofendaj	ofend'a'j
ofendajn	ofend'a'j'n
ofendan	ofend'a'n
ofendas	ofend'as
ofende	ofend'e
ofendi	ofend'i
ofendis	ofend'is
ofendo	ofend'o
ofendoj	ofend'o'j
ofendojn	ofend'o'j'n
ofendon	ofend'o'n
ofendos	ofend'os
ofendu	ofend'u
ofendus	ofend'us
ofendado	ofend'ad'o
ofendata	ofend'at'a
ofendiĝas	ofend'iĝ'as
ofendiĝi	ofend'iĝ'i
ofendiĝis	ofend'iĝ'is
ofendiĝo	ofend'iĝ'o
ofendiĝos	ofend'iĝ'os
ofendiĝu	ofend'iĝ'u
ofendiĝus	ofend'iĝ'us
ofendiĝema	ofend'iĝ'em'a
ofendita	ofend'it'a
ofenditaj	ofend'it'a'j
ofendite	ofend'it'e
ofensiva	ofensiv'a
ofensivaj	ofensiv'a'j
ofensivan	ofensiv'a'n
ofensive	ofensiv'e
ofensivo	ofensiv'o
ofensivoj	ofensiv'o'j
ofensivon	ofensiv'o'n
ofera	ofer'a
oferas	ofer'as
oferi	ofer'i
oferis	ofer'is
ofero	ofer'o
oferoj	ofer'o'j
oferojn	ofer'o'j'n
oferon	ofer'o'n
oferos	ofer'os
oferu	ofer'u
oferus	ofer'us
oferado	ofer'ad'o
oferadon	ofer'ad'o'n
oferaĵo	ofer'aĵ'o
oferaĵoj	ofer'aĵ'o'j
oferaĵojn	ofer'aĵ'o'j'n
oferaĵon	ofer'aĵ'o'n
oferante	ofer'ant'e
oferata	ofer'at'a
oferdoni	ofer'don'i
oferema	ofer'em'a
oferemaj	ofer'em'a'j
ofereme	ofer'em'e
oferemo	ofer'em'o
oferita	ofer'it'a
oferitaj	ofer'it'a'j
oferta	ofert'a
ofertaj	ofert'a'j
ofertas	ofert'as
oferti	ofert'i
ofertis	ofert'is
oferto	ofert'o
ofertoj	ofert'o'j
ofertojn	ofert'o'j'n
oferton	ofert'o'n
ofertos	ofert'os
ofertu	ofert'u
ofertus	ofert'us
ofertado	ofert'ad'o
ofertadon	ofert'ad'o'n
ofertanta	ofert'ant'a
ofertantaj	ofert'ant'a'j
ofertante	ofert'ant'e
ofertata	ofert'at'a
ofertataj	ofert'at'a'j
ofertatas	ofert'at'as
ofertita	ofert'it'a
ofertitaj	ofert'it'a'j
ofertitajn	ofert'it'a'j'n
ofertitan	ofert'it'a'n
ofertite	ofert'it'e
ofica	ofic'a
oficaj	ofic'a'j
ofican	ofic'a'n
oficas	ofic'as
ofice	ofic'e
ofici	ofic'i
oficis	ofic'is
ofico	ofic'o
oficoj	ofic'o'j
oficojn	ofic'o'j'n
oficon	ofic'o'n
oficado	ofic'ad'o
oficanto	ofic'ant'o
oficantoj	ofic'ant'o'j
oficeja	ofic'ej'a
oficejaj	ofic'ej'a'j
oficejajn	ofic'ej'a'j'n
oficejan	ofic'ej'a'n
oficejo	ofic'ej'o
oficejoj	ofic'ej'o'j
oficejojn	ofic'ej'o'j'n
oficejon	ofic'ej'o'n
oficejspaco	ofic'ej'spac'o
oficina	ofic'in'a
oficista	ofic'ist'a
oficisto	ofic'ist'o
oficistoj	ofic'ist'o'j
oficistojn	ofic'ist'o'j'n
oficiston	ofic'ist'o'n
oficistaro	ofic'ist'ar'o
oficistino	ofic'ist'in'o
oficperiodo	ofic'period'o
oficperiodoj	ofic'period'o'j
oficperiodon	ofic'period'o'n
oficulo	ofic'ul'o
oficuloj	ofic'ul'o'j
oficulon	ofic'ul'o'n
oficuloestraro	ofic'ul'o'estr'ar'o
oficulokonsilio	ofic'ul'o'konsili'o
oficiala	oficial'a
oficialaj	oficial'a'j
oficialajn	oficial'a'j'n
oficialan	oficial'a'n
oficiale	oficial'e
oficialo	oficial'o
oficialeco	oficial'ec'o
oficialigi	oficial'ig'i
oficialigis	oficial'ig'is
oficialigo	oficial'ig'o
oficialigon	oficial'ig'o'n
oficialigita	oficial'ig'it'a
oficialigitaj	oficial'ig'it'a'j
oficialulo	oficial'ul'o
oficialuloj	oficial'ul'o'j
oficialulojn	oficial'ul'o'j'n
oficialulon	oficial'ul'o'n
oficialuldokumentoj	oficial'ul'dokument'o'j
oficira	oficir'a
oficiran	oficir'a'n
oficiro	oficir'o
oficiroj	oficir'o'j
oficirojn	oficir'o'j'n
oficiron	oficir'o'n
oficirgildoj	oficir'gild'o'j
ofta	oft'a
oftaj	oft'a'j
oftajn	oft'a'j'n
oftan	oft'a'n
oftas	oft'as
ofte	oft'e
oftis	oft'is
ofteco	oft'ec'o
oftecoj	oft'ec'o'j
oftecon	oft'ec'o'n
oftege	oft'eg'e
oftfoje	oft'foj'e
oftiĝas	oft'iĝ'as
oftiĝis	oft'iĝ'is
oftalmologio	oftalm'olog'i'o
ogivo	ogiv'o
oho	oho
ojo	oj'o
ojon	oj'o'n
ojstro	ojstr'o
ojstron	ojstr'o'n
ok	ok
oka	ok'a
okaj	ok'a'j
okan	ok'a'n
okcent	ok'cent
okdek	ok'dek
oko	ok'o
okangula	ok'angul'a
okangulaj	ok'angul'a'j
okdekaj	ok'dek'a'j
okdeko	ok'dek'o
okdekjara	ok'dek'jar'a
okedro	ok'edr'o
okfoje	ok'foj'e
okhora	ok'hor'a
okjara	ok'jar'a
oklatera	ok'later'a
oklateraj	ok'later'a'j
oklatero	ok'later'o
okobla	ok'obl'a
okono	ok'on'o
okonoj	ok'on'o'j
okamoto	okamot'o
okaza	okaz'a
okazaj	okaz'a'j
okazajn	okaz'a'j'n
okazas	okaz'as
okaze	okaz'e
okazi	okaz'i
okazis	okaz'is
okazo	okaz'o
okazoj	okaz'o'j
okazojn	okaz'o'j'n
okazon	okaz'o'n
okazos	okaz'os
okazu	okaz'u
okazus	okaz'us
okazadas	okaz'ad'as
okazadis	okaz'ad'is
okazado	okaz'ad'o
okazadon	okaz'ad'o'n
okazaĵa	okaz'aĵ'a
okazaĵaj	okaz'aĵ'a'j
okazajho	okaz'aĵ'o
okazaĵo	okaz'aĵ'o
okazaĵoj	okaz'aĵ'o'j
okazaĵojn	okaz'aĵ'o'j'n
okazaĵon	okaz'aĵ'o'n
okazanta	okaz'ant'a
okazantaj	okaz'ant'a'j
okazantajn	okaz'ant'a'j'n
okazantan	okaz'ant'a'n
okazante	okaz'ant'e
okazantaĵo	okaz'ant'aĵ'o
okazego	okaz'eg'o
okazegoj	okaz'eg'o'j
okazejo	okaz'ej'o
okazigas	okaz'ig'as
okazigi	okaz'ig'i
okazigis	okaz'ig'is
okazigo	okaz'ig'o
okazigon	okaz'ig'o'n
okazigos	okaz'ig'os
okazigu	okaz'ig'u
okazigus	okaz'ig'us
okazigante	okaz'ig'ant'e
okazigata	okaz'ig'at'a
okazigataj	okaz'ig'at'a'j
okazigita	okaz'ig'it'a
okazigitaj	okaz'ig'it'a'j
okazigitajn	okaz'ig'it'a'j'n
okazinta	okaz'int'a
okazintaj	okaz'int'a'j
okazintajn	okaz'int'a'j'n
okazintan	okaz'int'a'n
okazintus	okaz'int'us
okazintaĵo	okaz'int'aĵ'o
okazintaĵoj	okaz'int'aĵ'o'j
okazintaĵojn	okaz'int'aĵ'o'j'n
okazintaĵon	okaz'int'aĵ'o'n
okazita	okaz'it'a
okazitaj	okaz'it'a'j
okazite	okaz'it'e
okazonta	okaz'ont'a
okazontaj	okaz'ont'a'j
okazontan	okaz'ont'a'n
okcidenta	okcident'a
okcidentaj	okcident'a'j
okcidentajn	okcident'a'j'n
okcidentan	okcident'a'n
okcidente	okcident'e
okcidenten	okcident'e'n
okcidento	okcident'o
okcidenton	okcident'o'n
okcidentafrika	okcident'afrik'a
okcidentafrikaj	okcident'afrik'a'j
okcidentafriko	okcident'afrik'o
okcidentano	okcident'an'o
okcidentanoj	okcident'an'o'j
okcidentanojn	okcident'an'o'j'n
okcidentaziaj	okcident'azi'a'j
okcidentbengalio	okcident'bengal'i'o
okcidenteŭropa	okcident'eŭrop'a
okcidenteŭropaj	okcident'eŭrop'a'j
okcidenteŭropo	okcident'eŭrop'o
okcidenteŭropon	okcident'eŭrop'o'n
okcidenteŭropanoj	okcident'eŭrop'an'o'j
okcidentgermana	okcident'german'a
okcidentgermanaj	okcident'german'a'j
okcidentgotoj	okcident'got'o'j
okcidentigo	okcident'ig'o
okcidentigita	okcident'ig'it'a
okcidentmarborda	okcident'mar'bord'a
okcidentromia	okcident'romi'a
okcidentsiberia	okcident'siberi'a
okcidentstila	okcident'stil'a
okcidentstilaj	okcident'stil'a'j
okcidentstilan	okcident'stil'a'n
okcidentuloj	okcident'ul'o'j
okcidentalo	okcidental'o
okcipitala	okcipital'a
okcitana	okcitan'a
okcitanaj	okcitan'a'j
okcitanan	okcitan'a'n
okcitane	okcitan'e
okcitano	okcitan'o
okcitanio	okcitan'i'o
okemo	okem'o
okinava	okinav'a
okinavo	okinav'o
okra	okr'a
okro	okr'o
oksalato	oksalat'o
oksido	oksid'o
oksidoj	oksid'o'j
oksidojn	oksid'o'j'n
oksidon	oksid'o'n
oksidado	oksid'ad'o
oksidanto	oksid'ant'o
oksidantoj	oksid'ant'o'j
oksidiga	oksid'ig'a
oksidigaj	oksid'ig'a'j
oksidigo	oksid'ig'o
oksidigagento	oksid'ig'agent'o
oksidigagentoj	oksid'ig'agent'o'j
oksidiganto	oksid'ig'ant'o
oksidiĝa	oksid'iĝ'a
oksidiĝaj	oksid'iĝ'a'j
oksidiĝas	oksid'iĝ'as
oksidiĝo	oksid'iĝ'o
oksidotavolo	oksid'o'tavol'o
oksidativa	oksidativ'a
oksidativan	oksidativ'a'n
oksigena	oksigen'a
oksigenaj	oksigen'a'j
oksigenas	oksigen'as
oksigeni	oksigen'i
oksigeno	oksigen'o
oksigenon	oksigen'o'n
oksigenado	oksigen'ad'o
oksigenadon	oksigen'ad'o'n
oksigenanto	oksigen'ant'o
oksigenatomo	oksigen'atom'o
oksigenatomoj	oksigen'atom'o'j
oksigenita	oksigen'it'a
oksigenitaj	oksigen'it'a'j
oksigenitan	oksigen'it'a'n
oksigenmanko	oksigen'mank'o
oksigenniveloj	oksigen'nivel'o'j
oksigenriĉa	oksigen'riĉ'a
oksigenspecioj	oksigen'speci'o'j
oksimoro	oksimor'o
okto	okt'o
oktana	oktan'a
oktavo	oktav'o
oktavoj	oktav'o'j
oktavojn	oktav'o'j'n
oktavon	oktav'o'n
oktavio	oktavi'o
oktaviano	oktavian'o
oktobra	oktobr'a
oktobre	oktobr'e
oktobro	oktobr'o
oktobron	oktobr'o'n
okula	okul'a
okulaj	okul'a'j
okulan	okul'a'n
okule	okul'e
okulo	okul'o
okuloj	okul'o'j
okulojn	okul'o'j'n
okulon	okul'o'n
okuletoj	okul'et'o'j
okuletojn	okul'et'o'j'n
okulfrapa	okul'frap'a
okulfrapaj	okul'frap'a'j
okulfrapajn	okul'frap'a'j'n
okulfrapan	okul'frap'a'n
okulfrapas	okul'frap'as
okulfrape	okul'frap'e
okulfrapis	okul'frap'is
okulgloboj	okul'glob'o'j
okulharoj	okul'har'o'j
okulharojn	okul'har'o'j'n
okulisto	okul'ist'o
okulistoj	okul'ist'o'j
okulkavo	okul'kav'o
okulkavoj	okul'kav'o'j
okulkavon	okul'kav'o'n
okulkoloro	okul'kolor'o
okulkuracisto	okul'kurac'ist'o
okulmalsano	okul'mal'san'o
okulmovo	okul'mov'o
okulmovoj	okul'mov'o'j
okulpunktoj	okul'punkt'o'j
okulringo	okul'ring'o
okulringoj	okul'ring'o'j
okulringon	okul'ring'o'n
okulstrio	okul'stri'o
okulumas	okul'um'as
okulumis	okul'um'is
okulvitro	okul'vitr'o
okulvitroj	okul'vitr'o'j
okulvitrojn	okul'vitr'o'j'n
okulvitron	okul'vitr'o'n
okulario	okulari'o
okulta	okult'a
okultaj	okult'a'j
okultismo	okult'ism'o
okupa	okup'a
okupaj	okup'a'j
okupas	okup'as
okupi	okup'i
okupis	okup'is
okupo	okup'o
okupoj	okup'o'j
okupojn	okup'o'j'n
okupon	okup'o'n
okupos	okup'os
okupu	okup'u
okupus	okup'us
okupadas	okup'ad'as
okupadis	okup'ad'is
okupado	okup'ad'o
okupadoj	okup'ad'o'j
okupadon	okup'ad'o'n
okupanta	okup'ant'a
okupantaj	okup'ant'a'j
okupante	okup'ant'e
okupanto	okup'ant'o
okupantoj	okup'ant'o'j
okupata	okup'at'a
okupataj	okup'at'a'j
okupatan	okup'at'a'n
okupatas	okup'at'as
okupate	okup'at'e
okupiga	okup'ig'a
okupigas	okup'ig'as
okupigistoj	okup'ig'ist'o'j
okupiĝas	okup'iĝ'as
okupiĝi	okup'iĝ'i
okupiĝis	okup'iĝ'is
okupiĝo	okup'iĝ'o
okupiĝoj	okup'iĝ'o'j
okupiĝon	okup'iĝ'o'n
okupiĝos	okup'iĝ'os
okupiĝu	okup'iĝ'u
okupiĝus	okup'iĝ'us
okupiĝado	okup'iĝ'ad'o
okupiĝanta	okup'iĝ'ant'a
okupiĝantaj	okup'iĝ'ant'a'j
okupiĝante	okup'iĝ'ant'e
okupiĝita	okup'iĝ'it'a
okupinta	okup'int'a
okupintaj	okup'int'a'j
okupita	okup'it'a
okupitaj	okup'it'a'j
okupitajn	okup'it'a'j'n
okupitan	okup'it'a'n
okupite	okup'it'e
okupiteco	okup'it'ec'o
okupacia	okupaci'a
okupaciaj	okupaci'a'j
okupacio	okupaci'o
okupacion	okupaci'o'n
okupaciitaj	okupaci'it'a'j
okzalata	okzal'at'a
okzalato	okzal'at'o
ol	ol
olavo	olav'o
olda	old'a
oldaj	old'a'j
oldan	old'a'n
oldangla	old'angl'a
oldanglaj	old'angl'a'j
oldfranca	old'franc'a
oldulo	old'ul'o
olduloj	old'ul'o'j
oldulon	old'ul'o'n
olduleto	old'ul'et'o
oldulino	old'ul'in'o
oldulinoj	old'ul'in'o'j
oldulinon	old'ul'in'o'n
olea	ole'a
oleaj	ole'a'j
olean	ole'a'n
olei	ole'i
oleo	ole'o
oleoj	ole'o'j
oleojn	ole'o'j'n
oleon	ole'o'n
oleeca	ole'ec'a
oleita	ole'it'a
oleitaj	ole'it'a'j
olelampo	ole'lamp'o
olelampoj	ole'lamp'o'j
oleoardezo	ole'o'ardez'o
olepentraĵo	ole'pentr'aĵ'o
olepentraĵoj	ole'pentr'aĵ'o'j
olibano	oliban'o
oligarkoj	oligark'o'j
oligarkia	oligarki'a
oligarkio	oligarki'o
oligarkioj	oligarki'o'j
oligoceno	oligocen'o
oligopolo	oligopol'o
olimpa	olimp'a
olimpaj	olimp'a'j
olimpo	olimp'o
olimpon	olimp'o'n
olimpia	olimpi'a
olimpiaj	olimpi'a'j
olimpiajn	olimpi'a'j'n
olimpian	olimpi'a'n
olimpio	olimpi'o
olimpika	olimpik'a
olimpikaj	olimpik'a'j
olimpikajn	olimpik'a'j'n
olimpikan	olimpik'a'n
olimpiko	olimpik'o
olimpikoj	olimpik'o'j
olimpikojn	olimpik'o'j'n
olimpikuloj	olimpik'ul'o'j
oliva	oliv'a
olivo	oliv'o
olivoj	oliv'o'j
olivojn	oliv'o'j'n
olivarba	oliv'arb'a
olivarbo	oliv'arb'o
olivarboj	oliv'arb'o'j
olivarbaro	oliv'arb'ar'o
olivarbaroj	oliv'arb'ar'o'j
oliveca	oliv'ec'a
olivecaj	oliv'ec'a'j
olivmuelejoj	oliv'muel'ej'o'j
olivoleo	oliv'ole'o
olivoleon	oliv'ole'o'n
olivujo	oliv'uj'o
olivujoj	oliv'uj'o'j
olivero	oliver'o
olivino	olivin'o
omaĝas	omaĝ'as
omaĝe	omaĝ'e
omaĝi	omaĝ'i
omaĝis	omaĝ'is
omaĝo	omaĝ'o
omaĝoj	omaĝ'o'j
omaĝon	omaĝ'o'n
omana	oman'a
omano	oman'o
omaro	omar'o
omaroj	omar'o'j
omaron	omar'o'n
ombra	ombr'a
ombraj	ombr'a'j
ombrajn	ombr'a'j'n
ombran	ombr'a'n
ombras	ombr'as
ombre	ombr'e
ombri	ombr'i
ombris	ombr'is
ombro	ombr'o
ombroj	ombr'o'j
ombrojn	ombr'o'j'n
ombron	ombr'o'n
ombrata	ombr'at'a
ombrita	ombr'it'a
ombritaj	ombr'it'a'j
ombroriĉaj	ombr'o'riĉ'a'j
ombroteatro	ombr'o'teatr'o
ombrela	ombrel'a
ombrelo	ombrel'o
ombreloj	ombrel'o'j
ombrelojn	ombrel'o'j'n
ombrelon	ombrel'o'n
ombrelplano	ombrel'plan'o
omenlando	omen'land'o
omleto	omlet'o
omleton	omlet'o'n
omnibuso	omnibus'o
onĉjo	onĉj'o
onĉjon	onĉj'o'n
onda	ond'a
ondaj	ond'a'j
ondan	ond'a'n
ondas	ond'as
onde	ond'e
ondis	ond'is
ondo	ond'o
ondoj	ond'o'j
ondojn	ond'o'j'n
ondon	ond'o'n
ondado	ond'ad'o
ondanta	ond'ant'a
ondeca	ond'ec'a
ondego	ond'eg'o
ondegoj	ond'eg'o'j
ondegojn	ond'eg'o'j'n
ondeto	ond'et'o
ondetoj	ond'et'o'j
ondetojn	ond'et'o'j'n
ondformo	ond'form'o
ondformoj	ond'form'o'j
ondformojn	ond'form'o'j'n
ondformon	ond'form'o'n
ondfunkcio	ond'funkci'o
ondgvidisto	ond'gvid'ist'o
ondgvidistoj	ond'gvid'ist'o'j
ondiĝas	ond'iĝ'as
ondofronto	ond'o'front'o
ondokonduktilo	ond'o'kondukt'il'o
ondolongo	ond'o'long'o
ondolongoj	ond'o'long'o'j
ondolongojn	ond'o'long'o'j'n
ondolongon	ond'o'long'o'n
ondorajdado	ond'o'rajd'ad'o
ondosimilaĵa	ond'o'simil'aĵ'a
ondpakaĵeto	ond'pak'aĵ'et'o
ondumaĵo	ond'um'aĵ'o
ondumita	ond'um'it'a
oni	oni
onia	oni'a
oniaj	oni'a'j
oniajn	oni'a'j'n
onian	oni'a'n
onidira	oni'dir'a
onidire	oni'dir'e
onidiro	oni'dir'o
onidiroj	oni'dir'o'j
onidirojn	oni'dir'o'j'n
onidiron	oni'dir'o'n
onies	onies
onjo	onj'o
onkla	onkl'a
onklo	onkl'o
onkloj	onkl'o'j
onklojn	onkl'o'j'n
onklon	onkl'o'n
onklino	onkl'in'o
onklinoj	onkl'in'o'j
onklinon	onkl'in'o'n
onomatopeo	onomatope'o
onta	ont'a
ontaj	ont'a'j
ontajn	ont'a'j'n
ontan	ont'a'n
ontgeneracioj	ont'generaci'o'j
ontokazojn	ont'okaz'o'j'n
ontario	ontari'o
ontogenezo	ontogenez'o
ontologia	ontologi'a
ontologiaj	ontologi'a'j
ontologian	ontologi'a'n
ontologie	ontologi'e
ontologio	ontologi'o
ontologioj	ontologi'o'j
ontologion	ontologi'o'n
onubo	onub'o
oomoto	oomot'o
opo	op'o
opaka	opak'a
opala	opal'a
opalo	opal'o
opcio	opci'o
opcioj	opci'o'j
opciojn	opci'o'j'n
opcion	opci'o'n
opera	oper'a
operaj	oper'a'j
operan	oper'a'n
opero	oper'o
operoj	oper'o'j
operojn	oper'o'j'n
operon	oper'o'n
opereca	oper'ec'a
operejo	oper'ej'o
operejoj	oper'ej'o'j
opereto	oper'et'o
operetoj	oper'et'o'j
operkantisto	oper'kant'ist'o
operacia	operaci'a
operaciaj	operaci'a'j
operaciajn	operaci'a'j'n
operacian	operaci'a'n
operacias	operaci'as
operacie	operaci'e
operacii	operaci'i
operaciis	operaci'is
operacio	operaci'o
operacioj	operaci'o'j
operaciojn	operaci'o'j'n
operacion	operaci'o'n
operaciado	operaci'ad'o
operacianta	operaci'ant'a
operaciantaj	operaci'ant'a'j
operacianto	operaci'ant'o
operaciantoj	operaci'ant'o'j
operaciejo	operaci'ej'o
operaciita	operaci'it'a
operaciitaj	operaci'it'a'j
operaciuma	operaci'um'a
operaciumo	operaci'um'o
operaciumoj	operaci'um'o'j
operaciumojn	operaci'um'o'j'n
operaciumon	operaci'um'o'n
operandoj	operand'o'j
operatoro	operator'o
operatoroj	operator'o'j
opia	opi'a
opio	opi'o
opion	opi'o'n
opidumo	opidum'o
opinias	opini'as
opinii	opini'i
opiniis	opini'is
opinio	opini'o
opinioj	opini'o'j
opiniojn	opini'o'j'n
opinion	opini'o'n
opinios	opini'os
opiniu	opini'u
opinius	opini'us
opiniado	opini'ad'o
opiniantaj	opini'ant'a'j
opiniante	opini'ant'e
opiniantoj	opini'ant'o'j
opiniata	opini'at'a
opiniataj	opini'at'a'j
opiniesprimo	opini'esprim'o
opiniita	opini'it'a
opiniitaj	opini'it'a'j
opiniite	opini'it'e
opinioŝanĝo	opini'o'ŝanĝ'o
opiniosondadoj	opini'o'sond'ad'o'j
opinisondoj	opini'sond'o'j
opinisondado	opini'sond'ad'o
opinisondadoj	opini'sond'ad'o'j
oponas	opon'as
opone	opon'e
oponi	opon'i
oponis	opon'is
opono	opon'o
oponon	opon'o'n
oponado	opon'ad'o
oponantaj	opon'ant'a'j
oponanto	opon'ant'o
oponantoj	opon'ant'o'j
oponantojn	opon'ant'o'j'n
oponanton	opon'ant'o'n
oportuna	oportun'a
oportunaj	oportun'a'j
oportunajn	oportun'a'j'n
oportunan	oportun'a'n
oportunas	oportun'as
oportune	oportun'e
oportuno	oportun'o
oportunoj	oportun'o'j
oportunojn	oportun'o'j'n
oportunon	oportun'o'n
oportunaĵo	oportun'aĵ'o
oportunaĵoj	oportun'aĵ'o'j
oportuneco	oportun'ec'o
oportunecon	oportun'ec'o'n
oportunigi	oportun'ig'i
oportunisma	oportun'ism'a
oportunismaj	oportun'ism'a'j
oportunisme	oportun'ism'e
oportunismo	oportun'ism'o
oportunisto	oportun'ist'o
oportunistoj	oportun'ist'o'j
opozicia	opozici'a
opoziciaj	opozici'a'j
opoziciajn	opozici'a'j'n
opozician	opozici'a'n
opozicie	opozici'e
opoziciis	opozici'is
opozicio	opozici'o
opozicioj	opozici'o'j
opozicion	opozici'o'n
opozicianoj	opozici'an'o'j
opoziciantoj	opozici'ant'o'j
opoziciestro	opozici'estr'o
opoziciulo	opozici'ul'o
opoziciuloj	opozici'ul'o'j
opoziciulojn	opozici'ul'o'j'n
opreso	opres'o
optativo	optativ'o
optika	optik'a
optikaj	optik'a'j
optikajn	optik'a'j'n
optikan	optik'a'n
optike	optik'e
optiko	optik'o
optikon	optik'o'n
optikisto	optik'ist'o
optikistoj	optik'ist'o'j
optimisma	optimism'a
optimismaj	optimism'a'j
optimisman	optimism'a'n
optimisme	optimism'e
optimismo	optimism'o
optimismon	optimism'o'n
optimista	optimist'a
optimisto	optimist'o
optimistoj	optimist'o'j
optimuma	optimum'a
optimumaj	optimum'a'j
optimumajn	optimum'a'j'n
optimuman	optimum'a'n
optimume	optimum'e
optimumo	optimum'o
optimumigas	optimum'ig'as
optimumigi	optimum'ig'i
optimumigis	optimum'ig'is
optimumigo	optimum'ig'o
optimumigon	optimum'ig'o'n
optimumigado	optimum'ig'ad'o
optimumigita	optimum'ig'it'a
optimumigitaj	optimum'ig'it'a'j
optimumigitan	optimum'ig'it'a'n
opula	opul'a
ora	or'a
oraj	or'a'j
orajn	or'a'j'n
oran	or'a'n
oras	or'as
ore	or'e
ori	or'i
oro	or'o
oron	or'o'n
oraĵoj	or'aĵ'o'j
oraĵojn	or'aĵ'o'j'n
oraĵisto	or'aĵ'ist'o
oraĵistoj	or'aĵ'ist'o'j
orbazo	or'baz'o
orbriko	or'brik'o
oreca	or'ec'a
orepoko	or'epok'o
orfiŝo	or'fiŝ'o
orfiŝoj	or'fiŝ'o'j
orflava	or'flav'a
orflavaj	or'flav'a'j
orfolio	or'foli'o
orhara	or'har'a
orharaj	or'har'a'j
orita	or'it'a
oritaj	or'it'a'j
orkolora	or'kolor'a
orkoloraj	or'kolor'a'j
orkoloran	or'kolor'a'n
orkoloro	or'kolor'o
orlando	or'land'o
ormedalo	or'medal'o
ormedalon	or'medal'o'n
ormetiisto	or'meti'ist'o
orminejoj	or'min'ej'o'j
ormoneroj	or'mon'er'o'j
ornanopartikloj	or'nan'o'partikl'o'j
orserĉistoj	or'serĉ'ist'o'j
orumita	or'um'it'a
orumitaj	or'um'it'a'j
orumitan	or'um'it'a'n
orvaro	or'var'o
orakolo	orakol'o
orakoloj	orakol'o'j
orakolojn	orakol'o'j'n
orakolon	orakol'o'n
orakolejo	orakol'ej'o
oranĝa	oranĝ'a
oranĝaj	oranĝ'a'j
oranĝajn	oranĝ'a'j'n
oranĝan	oranĝ'a'n
oranĝe	oranĝ'e
oranĝo	oranĝ'o
oranĝoj	oranĝ'o'j
oranĝojn	oranĝ'o'j'n
oranĝon	oranĝ'o'n
oranĝarbo	oranĝ'arb'o
oranĝarboj	oranĝ'arb'o'j
oranĝeca	oranĝ'ec'a
oranĝecaj	oranĝ'ec'a'j
oranĝecajn	oranĝ'ec'a'j'n
oranĝkolora	oranĝ'kolor'a
oranĝkoloraj	oranĝ'kolor'a'j
oranĝkoloran	oranĝ'kolor'a'n
oranĝokolora	oranĝ'o'kolor'a
oranĝosuko	oranĝ'o'suk'o
oranĝosukon	oranĝ'o'suk'o'n
oranĝujoj	oranĝ'uj'o'j
oranĝerio	oranĝeri'o
orangutanoj	orangutan'o'j
orangutango	orangutang'o
orangutangoj	orangutang'o'j
oratora	orator'a
oratoro	orator'o
oratoroj	orator'o'j
oratoron	orator'o'n
oratorado	orator'ad'o
oratorio	oratori'o
oratorioj	oratori'o'j
orbasano	orbasan'o
orbita	orbit'a
orbitaj	orbit'a'j
orbitan	orbit'a'n
orbitas	orbit'as
orbiti	orbit'i
orbito	orbit'o
orbitoj	orbit'o'j
orbitojn	orbit'o'j'n
orbiton	orbit'o'n
orbitanta	orbit'ant'a
orbitantaj	orbit'ant'a'j
orbitofronta	orbit'o'front'a
orbitŝipo	orbit'ŝip'o
orbitala	orbital'a
orbitalaj	orbital'a'j
orbitalo	orbital'o
orbitaloj	orbital'o'j
orbitalojn	orbital'o'j'n
orcino	orcin'o
orcinoj	orcin'o'j
orda	ord'a
ordaj	ord'a'j
ordajn	ord'a'j'n
ordan	ord'a'n
orde	ord'e
ordo	ord'o
ordoj	ord'o'j
ordojn	ord'o'j'n
ordon	ord'o'n
ordos	ord'os
ordema	ord'em'a
ordemaj	ord'em'a'j
ordiga	ord'ig'a
ordigas	ord'ig'as
ordigi	ord'ig'i
ordigis	ord'ig'is
ordigo	ord'ig'o
ordigon	ord'ig'o'n
ordigos	ord'ig'os
ordigu	ord'ig'u
ordigado	ord'ig'ad'o
ordiganta	ord'ig'ant'a
ordigante	ord'ig'ant'e
ordigita	ord'ig'it'a
ordigitaj	ord'ig'it'a'j
ordigitajn	ord'ig'it'a'j'n
ordigitan	ord'ig'it'a'n
ordiĝas	ord'iĝ'as
ordena	orden'a
ordenaj	orden'a'j
ordenajn	orden'a'j'n
ordenan	orden'a'n
ordeno	orden'o
ordenoj	orden'o'j
ordenojn	orden'o'j'n
ordenon	orden'o'n
ordenanoj	orden'an'o'j
ordinas	ordin'as
ordinis	ordin'is
ordino	ordin'o
ordinoj	ordin'o'j
ordinado	ordin'ad'o
ordinita	ordin'it'a
ordinitaj	ordin'it'a'j
ordinara	ordinar'a
ordinaraj	ordinar'a'j
ordinarajn	ordinar'a'j'n
ordinaran	ordinar'a'n
ordinare	ordinar'e
ordinarlingve	ordinar'lingv'e
ordinarulo	ordinar'ul'o
ordinaruloj	ordinar'ul'o'j
ordona	ordon'a
ordonaj	ordon'a'j
ordonas	ordon'as
ordone	ordon'e
ordoni	ordon'i
ordonis	ordon'is
ordono	ordon'o
ordonoj	ordon'o'j
ordonojn	ordon'o'j'n
ordonon	ordon'o'n
ordonos	ordon'os
ordonu	ordon'u
ordonus	ordon'us
ordonanta	ordon'ant'a
ordonante	ordon'ant'e
ordonema	ordon'em'a
ordoninta	ordon'int'a
ordoninte	ordon'int'e
ordonita	ordon'it'a
ordonitaj	ordon'it'a'j
ordonite	ordon'it'e
ordonrajto	ordon'rajt'o
ordonrajton	ordon'rajt'o'n
ordovicio	ordovici'o
oregono	oregon'o
orelaj	orel'a'j
orelo	orel'o
oreloj	orel'o'j
orelojn	orel'o'j'n
orelon	orel'o'n
orelareo	orel'are'o
orelfokoj	orel'fok'o'j
orelkanalo	orel'kanal'o
orelplaĉa	orel'plaĉ'a
orelringo	orel'ring'o
orelringoj	orel'ring'o'j
orelringojn	orel'ring'o'j'n
orelringon	orel'ring'o'n
orenburga	orenburg'a
oresto	orest'o
orfa	orf'a
orfaj	orf'a'j
orfan	orf'a'n
orfe	orf'e
orfo	orf'o
orfoj	orf'o'j
orfojn	orf'o'j'n
orfon	orf'o'n
orfejo	orf'ej'o
orfejoj	orf'ej'o'j
orfejon	orf'ej'o'n
orfigitaj	orf'ig'it'a'j
orfiĝis	orf'iĝ'is
orfino	orf'in'o
orfeo	orfe'o
orfeistoj	orfe'ist'o'j
organa	organ'a
organaj	organ'a'j
organan	organ'a'n
organo	organ'o
organoj	organ'o'j
organojn	organ'o'j'n
organon	organ'o'n
organdonacanto	organ'donac'ant'o
organdonacantoj	organ'donac'ant'o'j
organdonacantojn	organ'donac'ant'o'j'n
organetoj	organ'et'o'j
organkomerco	organ'komerc'o
organodonaco	organ'o'donac'o
organsistemoj	organ'sistem'o'j
organtransplantado	organ'trans'plant'ad'o
organika	organik'a
organikaj	organik'a'j
organikajn	organik'a'j'n
organikan	organik'a'n
organike	organik'e
organisma	organism'a
organismo	organism'o
organismoj	organism'o'j
organismojn	organism'o'j'n
organismon	organism'o'n
organiza	organiz'a
organizaj	organiz'a'j
organizajn	organiz'a'j'n
organizan	organiz'a'n
organizas	organiz'as
organize	organiz'e
organizi	organiz'i
organizis	organiz'is
organizo	organiz'o
organizoj	organiz'o'j
organizojn	organiz'o'j'n
organizon	organiz'o'n
organizos	organiz'os
organizu	organiz'u
organizus	organiz'us
organizadis	organiz'ad'is
organizado	organiz'ad'o
organizadon	organiz'ad'o'n
organizajho	organiz'aĵ'o
organizaĵo	organiz'aĵ'o
organizaĵoj	organiz'aĵ'o'j
organizaĵojn	organiz'aĵ'o'j'n
organizaĵon	organiz'aĵ'o'n
organizanta	organiz'ant'a
organizante	organiz'ant'e
organizanto	organiz'ant'o
organizantoj	organiz'ant'o'j
organizantojn	organiz'ant'o'j'n
organizata	organiz'at'a
organizataj	organiz'at'a'j
organiziĝas	organiz'iĝ'as
organiziĝi	organiz'iĝ'i
organiziĝis	organiz'iĝ'is
organiziĝo	organiz'iĝ'o
organizinto	organiz'int'o
organizintoj	organiz'int'o'j
organizita	organiz'it'a
organizitaj	organiz'it'a'j
organizitajn	organiz'it'a'j'n
organizitan	organiz'it'a'n
organizite	organiz'it'e
organizacio	organizaci'o
organizacioj	organizaci'o'j
orgasmis	orgasm'is
orgasmo	orgasm'o
orgasmon	orgasm'o'n
orgena	orgen'a
orgeno	orgen'o
orgenoj	orgen'o'j
orgenojn	orgen'o'j'n
orgenon	orgen'o'n
orgenisto	orgen'ist'o
orgenistoj	orgen'ist'o'j
orgenkonstruo	orgen'konstru'o
orgenkonstruisto	orgen'konstru'ist'o
orgenmuziko	orgen'muzik'o
orgio	orgi'o
orgioj	orgi'o'j
orgojla	orgojl'a
orgojlaj	orgojl'a'j
orgojle	orgojl'e
orgojlo	orgojl'o
orgojlon	orgojl'o'n
orielo	oriel'o
orienta	orient'a
orientaj	orient'a'j
orientajn	orient'a'j'n
orientan	orient'a'n
orientas	orient'as
oriente	orient'e
orienten	orient'e'n
orienti	orient'i
orientis	orient'is
oriento	orient'o
orientoj	orient'o'j
orienton	orient'o'n
orientado	orient'ad'o
orientadon	orient'ad'o'n
orientafrika	orient'afrik'a
orientafriko	orient'afrik'o
orientanoj	orient'an'o'j
orientazia	orient'azi'a
orientaziaj	orient'azi'a'j
orientazio	orient'azi'o
orientberlino	orient'berlin'o
orientebla	orient'ebl'a
orienteŭropa	orient'eŭrop'a
orienteŭropaj	orient'eŭrop'a'j
orienteŭropo	orient'eŭrop'o
orienteŭropanoj	orient'eŭrop'an'o'j
orientfranka	orient'frank'a
orientgermana	orient'german'a
orientgermanaj	orient'german'a'j
orientgermanoj	orient'german'o'j
orientgotoj	orient'got'o'j
orienthinda	orient'hind'a
orienthindiaj	orient'hindi'a'j
orientiĝan	orient'iĝ'a'n
orientiĝas	orient'iĝ'as
orientiĝi	orient'iĝ'i
orientiĝis	orient'iĝ'is
orientiĝo	orient'iĝ'o
orientiĝoj	orient'iĝ'o'j
orientiĝojn	orient'iĝ'o'j'n
orientiĝon	orient'iĝ'o'n
orientiĝu	orient'iĝ'u
orientilo	orient'il'o
orientiloj	orient'il'o'j
orientilon	orient'il'o'n
orientita	orient'it'a
orientitaj	orient'it'a'j
orientitajn	orient'it'a'j'n
orientitan	orient'it'a'n
orientookcidento	orient'o'okcident'o
orientokcidenta	orient'okcident'a
orientokcidentaj	orient'okcident'a'j
orientokcidente	orient'okcident'e
orientpakistano	orient'pakistan'o
orientromia	orient'romi'a
orientulo	orient'ul'o
orientalisto	orientalist'o
origamio	origami'o
origano	origan'o
origina	origin'a
originaj	origin'a'j
originajn	origin'a'j'n
originan	origin'a'n
originas	origin'as
origine	origin'e
origini	origin'i
originis	origin'is
origino	origin'o
originoj	origin'o'j
originojn	origin'o'j'n
originon	origin'o'n
originanta	origin'ant'a
originantaj	origin'ant'a'j
originante	origin'ant'e
originejo	origin'ej'o
originejoj	origin'ej'o'j
originiĝis	origin'iĝ'is
origininta	origin'int'a
originita	origin'it'a
originala	original'a
originalaj	original'a'j
originalajn	original'a'j'n
originalan	original'a'n
originale	original'e
originalo	original'o
originaloj	original'o'j
originalojn	original'o'j'n
originalon	original'o'n
originalaĵo	original'aĵ'o
originalaĵoj	original'aĵ'o'j
originaleco	original'ec'o
originalecon	original'ec'o'n
originallingvo	original'lingv'o
originalteksto	original'tekst'o
originaltekston	original'tekst'o'n
originalversio	original'versi'o
orikteropo	orikterop'o
orikteropoj	orikterop'o'j
orinoko	orinok'o
oriono	orion'o
oritio	oriti'o
orkestra	orkestr'a
orkestraj	orkestr'a'j
orkestrajn	orkestr'a'j'n
orkestran	orkestr'a'n
orkestro	orkestr'o
orkestroj	orkestr'o'j
orkestrojn	orkestr'o'j'n
orkestron	orkestr'o'n
orkestrestro	orkestr'estr'o
orkido	orkid'o
orkidacoj	orkid'ac'o'j
orkideo	orkide'o
orkideoj	orkide'o'j
orkideojn	orkide'o'j'n
orlo	orl'o
orleano	orlean'o
ornama	ornam'a
ornamaj	ornam'a'j
ornamajn	ornam'a'j'n
ornaman	ornam'a'n
ornamas	ornam'as
orname	ornam'e
ornami	ornam'i
ornamis	ornam'is
ornamo	ornam'o
ornamoj	ornam'o'j
ornamojn	ornam'o'j'n
ornamon	ornam'o'n
ornamos	ornam'os
ornamu	ornam'u
ornamado	ornam'ad'o
ornamadoj	ornam'ad'o'j
ornamadojn	ornam'ad'o'j'n
ornamadon	ornam'ad'o'n
ornamajho	ornam'aĵ'o
ornamaĵo	ornam'aĵ'o
ornamaĵoj	ornam'aĵ'o'j
ornamaĵojn	ornam'aĵ'o'j'n
ornamaĵon	ornam'aĵ'o'n
ornamante	ornam'ant'e
ornamata	ornam'at'a
ornamita	ornam'it'a
ornamitaj	ornam'it'a'j
ornamitajn	ornam'it'a'j'n
ornamitan	ornam'it'a'n
ornamite	ornam'it'e
ornamplanto	ornam'plant'o
ornamplantoj	ornam'plant'o'j
ornamriĉa	ornam'riĉ'a
ornamripaj	ornam'rip'a'j
ornamripoj	ornam'rip'o'j
ornamriparo	ornam'ripar'o
ornato	ornat'o
ornatoj	ornat'o'j
ornatojn	ornat'o'j'n
ornitologo	ornitolog'o
ornitologoj	ornitolog'o'j
ornitologia	ornitologi'a
ornitologio	ornitologi'o
ornitorinko	ornitorink'o
orogenezo	orogenez'o
orogenezoj	orogenez'o'j
orografia	orografi'a
orografie	orografi'e
orografio	orografi'o
oroonoko	oroonok'o
orta	ort'a
ortaj	ort'a'j
orte	ort'e
orto	ort'o
ortoj	ort'o'j
ortangula	ort'angul'a
ortangulaj	ort'angul'a'j
ortangulan	ort'angul'a'n
ortangule	ort'angul'e
ortangulo	ort'angul'o
ortega	ort'eg'a
ortalo	ortal'o
ortodoksa	ortodoks'a
ortodoksaj	ortodoks'a'j
ortodoksajn	ortodoks'a'j'n
ortodoksan	ortodoks'a'n
ortodoksoj	ortodoks'o'j
ortodokseco	ortodoks'ec'o
ortodoksecon	ortodoks'ec'o'n
ortodoksismo	ortodoks'ism'o
ortodoksuloj	ortodoks'ul'o'j
ortodoksio	ortodoksi'o
ortogonala	ortogonal'a
ortogonalaj	ortogonal'a'j
ortografia	ortografi'a
ortografiaj	ortografi'a'j
ortografiajn	ortografi'a'j'n
ortografian	ortografi'a'n
ortografie	ortografi'e
ortografio	ortografi'o
ortografioj	ortografi'o'j
ortografion	ortografi'o'n
ortopedia	ortopedi'a
osformo	os'form'o
osaka	osak'a
osako	osak'o
oscedas	osced'as
oscedi	osced'i
oscedis	osced'is
oscedo	osced'o
oscedanta	osced'ant'a
oscedante	osced'ant'e
oscila	oscil'a
oscilas	oscil'as
oscili	oscil'i
osciloj	oscil'o'j
oscilado	oscil'ad'o
osciladoj	oscil'ad'o'j
osciladojn	oscil'ad'o'j'n
osciladon	oscil'ad'o'n
oscilanta	oscil'ant'a
oscilatoro	oscilator'o
oscilatoroj	oscilator'o'j
oscilatoron	oscilator'o'n
osciloskopo	osciloskop'o
osciloskopoj	osciloskop'o'j
oseta	oset'a
osetaj	oset'a'j
osetoj	oset'o'j
osetio	oset'i'o
oske	osk'e
oskaro	oskar'o
oskaron	oskar'o'n
osmana	osman'a
osmanida	osman'id'a
osmoza	osmoz'a
osmozo	osmoz'o
osta	ost'a
ostaj	ost'a'j
ostajn	ost'a'j'n
ostan	ost'a'n
osto	ost'o
ostoj	ost'o'j
ostojn	ost'o'j'n
oston	ost'o'n
ostamedola	ost'a'medol'a
ostaro	ost'ar'o
osteca	ost'ec'a
ostejo	ost'ej'o
osteto	ost'et'o
ostetoj	ost'et'o'j
ostostrukturo	ost'o'struktur'o
ostoza	ost'oz'a
ostrekto	ost'rekt'o
ostrektoj	ost'rekt'o'j
ostaĝo	ostaĝ'o
ostaĝoj	ostaĝ'o'j
ostaĝojn	ostaĝ'o'j'n
ostaĝon	ostaĝ'o'n
ostendo	ostend'o
osteoporozo	ostoporoz'o
ostoporozo	ostoporoz'o
ostro	ostr'o
ostroj	ostr'o'j
ostrojn	ostr'o'j'n
ostron	ostr'o'n
ostracismo	ostracism'o
ostrogotoj	ostrogot'o'j
ota	ot'a
oto	ot'o
otavo	otav'o
otelo	otel'o
otida	otid'a
otidoj	otid'o'j
otomana	otoman'a
otomanaj	otoman'a'j
otomanajn	otoman'a'j'n
otomanan	otoman'a'n
otomano	otoman'o
otomanoj	otoman'o'j
otomanojn	otoman'o'j'n
ova	ov'a
ovo	ov'o
ovoj	ov'o'j
ovojn	ov'o'j'n
ovon	ov'o'n
ovaĵo	ov'aĵ'o
ovaĵon	ov'aĵ'o'n
ovaro	ov'ar'o
ovforma	ov'form'a
ovformaj	ov'form'a'j
ovoblanko	ov'o'blank'o
ovoĉelo	ov'o'ĉel'o
ovodemetas	ov'o'de'met'as
ovodemeti	ov'o'de'met'i
ovodemetado	ov'o'de'met'ad'o
ovodemetadon	ov'o'de'met'ad'o'n
ovoflavo	ov'o'flav'o
ovoforma	ov'o'form'a
ovoformaj	ov'o'form'a'j
ovoŝelo	ov'o'ŝel'o
ovumado	ov'um'ad'o
ovacion	ovaci'o'n
ovala	oval'a
ovalaj	oval'a'j
ovalajn	oval'a'j'n
ovalan	oval'a'n
ovalo	oval'o
ovalforma	oval'form'a
ovaria	ovari'a
ovarian	ovari'a'n
ovario	ovari'o
ovarioj	ovari'o'j
ovarion	ovari'o'n
ovidio	ovidi'o
oviedo	ovied'o
ovolo	ovol'o
ovoloj	ovol'o'j
ovolojn	ovol'o'j'n
ovolon	ovol'o'n
ozo	oz'o
ozon	oz'o'n
oziriso	oziris'o
ozona	ozon'a
ozono	ozon'o
ozonon	ozon'o'n
ozonperdo	ozon'perd'o