paca	pac'a
pacaj	pac'a'j
pacajn	pac'a'j'n
pacan	pac'a'n
pace	pac'e
paco	pac'o
pacon	pac'o'n
pacakordo	pac'akord'o
pacama	pac'am'a
pacamaj	pac'am'a'j
pacema	pac'em'a
pacemaj	pac'em'a'j
paceman	pac'em'a'n
paceme	pac'em'e
pacemo	pac'em'o
paciga	pac'ig'a
pacigaj	pac'ig'a'j
pacigas	pac'ig'as
pacigi	pac'ig'i
pacigis	pac'ig'is
pacigo	pac'ig'o
paciganto	pac'ig'ant'o
pacigita	pac'ig'it'a
paciĝi	pac'iĝ'i
paciĝis	pac'iĝ'is
paciĝo	pac'iĝ'o
paciĝon	pac'iĝ'o'n
pacisma	pac'ism'a
pacismo	pac'ism'o
pacista	pac'ist'a
pacistaj	pac'ist'a'j
pacisto	pac'ist'o
pacistoj	pac'ist'o'j
packomitato	pac'komitat'o
packonferenco	pac'konferenc'o
packontrakto	pac'kontrakt'o
packontrakton	pac'kontrakt'o'n
pacmisioj	pac'misi'o'j
pacmovado	pac'mov'ad'o
pacnegocadoj	pac'negoc'ad'o'j
pacnegocadojn	pac'negoc'ad'o'j'n
pacpremio	pac'premi'o
pacpremion	pac'premi'o'n
pacprocezo	pac'procez'o
pacprocezon	pac'procez'o'n
pacprotekta	pac'protekt'a
pacprotektaj	pac'protekt'a'j
pactempo	pac'temp'o
pactraktato	pac'trakt'at'o
pactraktaton	pac'trakt'at'o'n
pactrupo	pac'trup'o
pacienca	pacienc'a
paciencaj	pacienc'a'j
paciencajn	pacienc'a'j'n
paciencan	pacienc'a'n
paciencas	pacienc'as
pacience	pacienc'e
pacienci	pacienc'i
pacienco	pacienc'o
paciencon	pacienc'o'n
paciencu	pacienc'u
pacienta	pacient'a
paciento	pacient'o
pacientoj	pacient'o'j
pacientojn	pacient'o'j'n
pacienton	pacient'o'n
pacientino	pacient'in'o
pacifika	pacifik'a
pacifikaj	pacifik'a'j
pacifikan	pacifik'a'n
pacifiko	pacifik'o
pacifikon	pacifik'o'n
pacifisma	pacifism'a
pacifismo	pacifism'o
pacifismon	pacifism'o'n
pacifista	pacifist'a
pacifisto	pacifist'o
pacifistoj	pacifist'o'j
paĉjo	paĉj'o
paĉjon	paĉj'o'n
pada	pad'a
pado	pad'o
padoj	pad'o'j
padojn	pad'o'j'n
padon	pad'o'n
padeto	pad'et'o
padlongo	pad'long'o
padelo	padel'o
padeloj	padel'o'j
padelrado	padel'rad'o
padelradoj	padel'rad'o'j
padova	padov'a
padovo	padov'o
pafa	paf'a
pafas	paf'as
pafe	paf'e
pafi	paf'i
pafis	paf'is
pafo	paf'o
pafoj	paf'o'j
pafojn	paf'o'j'n
pafon	paf'o'n
pafos	paf'os
pafu	paf'u
pafus	paf'us
pafadi	paf'ad'i
pafadis	paf'ad'is
pafado	paf'ad'o
pafadoj	paf'ad'o'j
pafadon	paf'ad'o'n
pafaĵo	paf'aĵ'o
pafaĵoj	paf'aĵ'o'j
pafaĵojn	paf'aĵ'o'j'n
pafaĵoĵetoj	paf'aĵ'o'ĵet'o'j
pafanta	paf'ant'a
pafantaj	paf'ant'a'j
pafante	paf'ant'e
pafanto	paf'ant'o
pafantoj	paf'ant'o'j
pafarko	paf'ark'o
pafarkoj	paf'ark'o'j
pafarkojn	paf'ark'o'j'n
pafarkon	paf'ark'o'n
pafarkisto	paf'ark'ist'o
pafarkistpo	paf'ark'ist'o
pafarkistoj	paf'ark'ist'o'j
pafarkistojn	paf'ark'ist'o'j'n
pafarmiloj	paf'arm'il'o'j
pafejo	paf'ej'o
pafforto	paf'fort'o
pafforton	paf'fort'o'n
pafiĝis	paf'iĝ'is
pafilo	paf'il'o
pafiloj	paf'il'o'j
pafilojn	paf'il'o'j'n
pafilon	paf'il'o'n
pafilego	paf'il'eg'o
pafilegoj	paf'il'eg'o'j
pafinto	paf'int'o
pafisto	paf'ist'o
pafistoj	paf'ist'o'j
pafita	paf'it'a
pafitaj	paf'it'a'j
pafite	paf'it'e
pafmortigi	paf'mort'ig'i
pafmortigis	paf'mort'ig'is
pafmortigos	paf'mort'ig'os
pafmortigita	paf'mort'ig'it'a
pafrapideco	paf'rapid'ec'o
pafrapidecon	paf'rapid'ec'o'n
paftubo	paf'tub'o
pafvundita	paf'vund'it'a
pafvunditaj	paf'vund'it'a'j
pafvunditan	paf'vund'it'a'n
paga	pag'a
pagas	pag'as
page	pag'e
pagi	pag'i
pagis	pag'is
pago	pag'o
pagoj	pag'o'j
pagojn	pag'o'j'n
pagon	pag'o'n
pagos	pag'os
pagu	pag'u
pagus	pag'us
pagado	pag'ad'o
paganta	pag'ant'a
pagantaj	pag'ant'a'j
pagantajn	pag'ant'a'j'n
pagante	pag'ant'e
pagata	pag'at'a
pagataj	pag'at'a'j
pagatan	pag'at'a'n
pagato	pag'at'o
pagebla	pag'ebl'a
pageblaj	pag'ebl'a'j
pageblan	pag'ebl'a'n
pagebleco	pag'ebl'ec'o
pagenda	pag'end'a
pagendaj	pag'end'a'j
pagendan	pag'end'a'n
pagendas	pag'end'as
pagendaĵo	pag'end'aĵ'o
pagendaĵoj	pag'end'aĵ'o'j
pagendaĵojn	pag'end'aĵ'o'j'n
pagendaĵon	pag'end'aĵ'o'n
pagigas	pag'ig'as
pagigi	pag'ig'i
pagigis	pag'ig'is
pagigita	pag'ig'it'a
pagigitaj	pag'ig'it'a'j
pagilo	pag'il'o
paginta	pag'int'a
paginte	pag'int'e
pagita	pag'it'a
pagitaj	pag'it'a'j
pagitajn	pag'it'a'j'n
pagitan	pag'it'a'n
pagite	pag'it'e
pagmaniero	pag'manier'o
pagmanieroj	pag'manier'o'j
pagokarto	pag'o'kart'o
pagokartoj	pag'o'kart'o'j
pagota	pag'ot'a
pagotaj	pag'ot'a'j
pagvojoj	pag'voj'o'j
pagho	paĝ'o
paĝo	paĝ'o
paĝoj	paĝ'o'j
paĝojn	paĝ'o'j'n
paĝon	paĝ'o'n
paĝaro	paĝ'ar'o
paĝaroj	paĝ'ar'o'j
paĝarojn	paĝ'ar'o'j'n
paĝaron	paĝ'ar'o'n
paĝrulado	paĝ'rul'ad'o
pagajo	pagaj'o
pagana	pagan'a
paganaj	pagan'a'j
paganajn	pagan'a'j'n
paganan	pagan'a'n
pagano	pagan'o
paganoj	pagan'o'j
paganojn	pagan'o'j'n
paganismo	pagan'ism'o
paganismon	pagan'ism'o'n
pagodo	pagod'o
pagodoj	pagod'o'j
pagodon	pagod'o'n
pajaco	pajac'o
pajacoj	pajac'o'j
pajla	pajl'a
pajlaj	pajl'a'j
pajlajn	pajl'a'j'n
pajlan	pajl'a'n
pajlo	pajl'o
pajloj	pajl'o'j
pajlon	pajl'o'n
pajlero	pajl'er'o
pajleron	pajl'er'o'n
pajlulo	pajl'ul'o
pakas	pak'as
paki	pak'i
pakis	pak'is
pako	pak'o
pakoj	pak'o'j
pakojn	pak'o'j'n
pakon	pak'o'n
paku	pak'u
pakado	pak'ad'o
pakadoj	pak'ad'o'j
pakadon	pak'ad'o'n
pakaĵo	pak'aĵ'o
pakaĵoj	pak'aĵ'o'j
pakaĵojn	pak'aĵ'o'j'n
pakaĵon	pak'aĵ'o'n
pakaĵaro	pak'aĵ'ar'o
pakaĵaron	pak'aĵ'ar'o'n
pakaĵeto	pak'aĵ'et'o
pakaĵetoj	pak'aĵ'et'o'j
pakaĵetojn	pak'aĵ'et'o'j'n
pakaĵeton	pak'aĵ'et'o'n
pakante	pak'ant'e
paketo	pak'et'o
paketoj	pak'et'o'j
paketojn	pak'et'o'j'n
paketon	pak'et'o'n
pakita	pak'it'a
pakitaj	pak'it'a'j
pakitan	pak'it'a'n
pakumo	pak'um'o
pakumoj	pak'um'o'j
pakumon	pak'um'o'n
pakistana	pakistan'a
pakistanaj	pakistan'a'j
pakistanajn	pakistan'a'j'n
pakistanan	pakistan'a'n
pakistano	pakistan'o
pakistanon	pakistan'o'n
pakistanano	pakistan'an'o
pakistananoj	pakistan'an'o'j
pakto	pakt'o
paktoj	pakt'o'j
pakton	pakt'o'n
paktinta	pakt'int'a
paktintaj	pakt'int'a'j
paktintoj	pakt'int'o'j
pala	pal'a
palaj	pal'a'j
palajn	pal'a'j'n
palan	pal'a'n
palas	pal'as
pale	pal'e
palo	pal'o
palos	pal'os
palblua	pal'blu'a
paleco	pal'ec'o
palecon	pal'ec'o'n
palflava	pal'flav'a
palflavaj	pal'flav'a'j
palgriza	pal'griz'a
palgrizaj	pal'griz'a'j
paligas	pal'ig'as
paligis	pal'ig'is
paliĝas	pal'iĝ'as
paliĝis	pal'iĝ'is
paliĝinta	pal'iĝ'int'a
paliĝinte	pal'iĝ'int'e
palruĝa	pal'ruĝ'a
palruĝan	pal'ruĝ'a'n
palaca	palac'a
palacaj	palac'a'j
palacan	palac'a'n
palace	palac'e
palaco	palac'o
palacoj	palac'o'j
palacojn	palac'o'j'n
palacon	palac'o'n
palaceto	palac'et'o
palackomplekso	palac'kompleks'o
paladio	paladi'o
palankeno	palanken'o
palankenon	palanken'o'n
palasa	palas'a
palaso	palas'o
palata	palat'a
palataj	palat'a'j
palatan	palat'a'n
palato	palat'o
palaton	palat'o'n
palatigita	palat'ig'it'a
palatigitaj	palat'ig'it'a'j
palataligo	palatal'ig'o
palataligon	palatal'ig'o'n
palatina	palatin'a
palatino	palatin'o
palatinata	palatinat'a
palatinato	palatinat'o
palaŭo	palaŭ'o
palavano	palavan'o
paleo	pale'o
paledoj	paled'o'j
paleoceno	paleocen'o
paleolitika	paleolitik'a
paleolitikaj	paleolitik'a'j
paleolitiko	paleolitik'o
paleontologo	paleontolog'o
paleontologoj	paleontolog'o'j
paleontologiaj	paleontolog'i'a'j
paleontologio	paleontolog'i'o
paleozoiko	paleozoik'o
palestina	palestin'a
palestinaj	palestin'a'j
palestinajn	palestin'a'j'n
palestinan	palestin'a'n
palestine	palestin'e
palestino	palestin'o
palestinon	palestin'o'n
palestinano	palestin'an'o
palestinanoj	palestin'an'o'j
palestinanojn	palestin'an'o'j'n
paletro	paletr'o
paletron	paletr'o'n
palia	pali'a
paliativa	paliativ'a
palindromo	palindrom'o
paliso	palis'o
palisoj	palis'o'j
palisojn	palis'o'j'n
palison	palis'o'n
palisaro	palis'ar'o
palisaron	palis'ar'o'n
paliseto	palis'et'o
palisandro	palisandr'o
paliumo	palium'o
palma	palm'a
palmaj	palm'a'j
palmo	palm'o
palmoj	palm'o'j
palmojn	palm'o'j'n
palmon	palm'o'n
palmarbo	palm'arb'o
palmarboj	palm'arb'o'j
palmfolioj	palm'foli'o'j
palmoleo	palm'ole'o
palmira	palmir'a
palmiro	palmir'o
palpa	palp'a
palpaj	palp'a'j
palpajn	palp'a'j'n
palpan	palp'a'n
palpas	palp'as
palpe	palp'e
palpi	palp'i
palpis	palp'is
palpu	palp'u
palpadis	palp'ad'is
palpado	palp'ad'o
palpante	palp'ant'e
palpebla	palp'ebl'a
palpeble	palp'ebl'e
palpserĉis	palp'serĉ'is
palpebro	palpebr'o
palpebroj	palpebr'o'j
palpebrojn	palpebr'o'j'n
palpebron	palpebr'o'n
palpebruma	palpebr'um'a
palpebrumas	palpebr'um'as
palpebrumi	palpebr'um'i
palpebrumis	palpebr'um'is
palpebrumo	palpebr'um'o
palpebrumado	palpebr'um'ad'o
palpebrumante	palpebr'um'ant'e
palto	palt'o
paltoj	palt'o'j
paltojn	palt'o'j'n
palton	palt'o'n
pamfleto	pamflet'o
pamfletoj	pamflet'o'j
pamfletojn	pamflet'o'j'n
pampa	pamp'a
pampo	pamp'o
pana	pan'a
pano	pan'o
panoj	pan'o'j
panojn	pan'o'j'n
panon	pan'o'n
panbakisto	pan'bak'ist'o
panbulon	pan'bul'o'n
panejo	pan'ej'o
paneroj	pan'er'o'j
panerojn	pan'er'o'j'n
paneron	pan'er'o'n
panisto	pan'ist'o
panpeco	pan'pec'o
panpecon	pan'pec'o'n
pantranĉaĵoj	pan'tranĉ'aĵ'o'j
pantranĉaĵon	pan'tranĉ'aĵ'o'n
panvendejo	pan'vend'ej'o
panaceo	panace'o
panaceon	panace'o'n
panama	panam'a
panamo	panam'o
pando	pand'o
pandoj	pand'o'j
pandojn	pand'o'j'n
pandon	pand'o'n
pandemio	pandemi'o
pandiono	pandion'o
pandionon	pandion'o'n
pandora	pandor'a
pandoro	pandor'o
panduo	pandu'o
panea	pane'a
paneas	pane'as
panei	pane'i
paneis	pane'is
paneo	pane'o
paneoj	pane'o'j
panegiro	panegir'o
panegiron	panegir'o'n
panelo	panel'o
paneloj	panel'o'j
panelojn	panel'o'j'n
panelon	panel'o'n
panika	panik'a
panikaj	panik'a'j
panikas	panik'as
panike	panik'e
paniki	panik'i
panikis	panik'is
paniko	panik'o
panikon	panik'o'n
panikiĝas	panik'iĝ'as
panikiĝi	panik'iĝ'i
panikiĝis	panik'iĝ'is
panjo	panj'o
panjoj	panj'o'j
panjon	panj'o'n
pankreata	pankreat'a
pankreataj	pankreat'a'j
pankreatan	pankreat'a'n
pankreato	pankreat'o
panonio	panoni'o
panorama	panoram'a
panoraman	panoram'a'n
panoramo	panoram'o
panoramoj	panoram'o'j
panoramojn	panoram'o'j'n
panoramon	panoram'o'n
panoramejo	panoram'ej'o
panslavismo	panslavism'o
pantalono	pantalon'o
pantalonoj	pantalon'o'j
pantalonojn	pantalon'o'j'n
pantalonon	pantalon'o'n
pantaloneto	pantalon'et'o
pantaloneton	pantalon'et'o'n
pantalonfendon	pantalon'fend'o'n
panteismo	panteism'o
panteono	panteon'o
panteonon	panteon'o'n
pantero	panter'o
panteroj	panter'o'j
panteron	panter'o'n
pantoflo	pantofl'o
pantofloj	pantofl'o'j
pantoflojn	pantofl'o'j'n
pantomimo	pantomim'o
papa	pap'a
papaj	pap'a'j
papajn	pap'a'j'n
papan	pap'a'n
papo	pap'o
papoj	pap'o'j
papojn	pap'o'j'n
papon	pap'o'n
papado	pap'ad'o
papeco	pap'ec'o
papofico	pap'ofic'o
papoficon	pap'ofic'o'n
papage	papag'e
papago	papag'o
papagoj	papag'o'j
papagon	papag'o'n
papageto	papag'et'o
papagetoj	papag'et'o'j
papajo	papaj'o
papava	papav'a
papavo	papav'o
papavoj	papav'o'j
papera	paper'a
paperaj	paper'a'j
paperajn	paper'a'j'n
paperan	paper'a'n
papere	paper'e
papero	paper'o
paperoj	paper'o'j
paperojn	paper'o'j'n
paperon	paper'o'n
paperaĵoj	paper'aĵ'o'j
paperaĵojn	paper'aĵ'o'j'n
paperaro	paper'ar'o
paperaroj	paper'ar'o'j
paperarojn	paper'ar'o'j'n
paperaron	paper'ar'o'n
paperbendo	paper'bend'o
papereto	paper'et'o
paperetoj	paper'et'o'j
papereton	paper'et'o'n
paperfabriko	paper'fabrik'o
paperfolio	paper'foli'o
paperfolioj	paper'foli'o'j
paperfoliojn	paper'foli'o'j'n
paperfolion	paper'foli'o'n
paperlaboro	paper'labor'o
papermono	paper'mon'o
paperpeco	paper'pec'o
paperpecon	paper'pec'o'n
paperpoŝte	paper'poŝt'e
paperpoŝto	paper'poŝt'o
paperproduktado	paper'produkt'ad'o
papertondado	paper'tond'ad'o
papertondaĵoj	paper'tond'aĵ'o'j
papertondaĵojn	paper'tond'aĵ'o'j'n
paperujo	paper'uj'o
paperujon	paper'uj'o'n
papiamento	papiament'o
papilia	papili'a
papilio	papili'o
papilioj	papili'o'j
papiliojn	papili'o'j'n
papilion	papili'o'n
papirusaj	papirus'a'j
papiruso	papirus'o
papirusoj	papirus'o'j
papiruson	papirus'o'n
papriko	paprik'o
paprikon	paprik'o'n
papua	papu'a
papuaj	papu'a'j
papuo	papu'o
papuonovgvineo	papu'o'nov'gvine'o
para	par'a
paraj	par'a'j
paran	par'a'n
pare	par'e
paro	par'o
paroj	par'o'j
parojn	par'o'j'n
paron	par'o'n
pareto	par'et'o
paretoj	par'et'o'j
parhufuloj	par'huf'ul'o'j
parigo	par'ig'o
parigado	par'ig'ad'o
parigita	par'ig'it'a
parigitaj	par'ig'it'a'j
parigitajn	par'ig'it'a'j'n
pariĝa	par'iĝ'a
pariĝas	par'iĝ'as
pariĝi	par'iĝ'i
pariĝis	par'iĝ'is
pariĝo	par'iĝ'o
pariĝada	par'iĝ'ad'a
pariĝadaj	par'iĝ'ad'a'j
pariĝado	par'iĝ'ad'o
pariĝintaj	par'iĝ'int'a'j
parulo	par'ul'o
parulino	par'ul'in'o
paramagneta	para'magnet'a
paramagnetaj	para'magnet'a'j
paramilitaj	para'milit'a'j
parapsikologio	para'psik'olog'i'o
parabola	parabol'a
parabolaj	parabol'a'j
parabolan	parabol'a'n
parabolo	parabol'o
paraboloj	parabol'o'j
parabolojn	parabol'o'j'n
parabolon	parabol'o'n
parabolantenoj	parabol'anten'o'j
paraboloido	parabol'oid'o
parada	parad'a
paradaj	parad'a'j
paradas	parad'as
parade	parad'e
paradi	parad'i
paradis	parad'is
parado	parad'o
paradoj	parad'o'j
paradojn	parad'o'j'n
paradon	parad'o'n
paradigma	paradigm'a
paradigmo	paradigm'o
paradigmoj	paradigm'o'j
paradigmojn	paradigm'o'j'n
paradigmon	paradigm'o'n
paradigmata	paradigm'at'a
paradiza	paradiz'a
paradizan	paradiz'a'n
paradizo	paradiz'o
paradizoj	paradiz'o'j
paradizon	paradiz'o'n
paradoksa	paradoks'a
paradoksaj	paradoks'a'j
paradoksan	paradoks'a'n
paradokse	paradoks'e
paradokso	paradoks'o
paradoksoj	paradoks'o'j
paradoksojn	paradoks'o'j'n
paradokson	paradoks'o'n
parafino	parafin'o
parafrazi	parafraz'i
parafrazo	parafraz'o
parafrazoj	parafraz'o'j
parafrazon	parafraz'o'n
paragrafo	paragraf'o
paragrafoj	paragraf'o'j
paragrafojn	paragraf'o'j'n
paragrafon	paragraf'o'n
paragvaja	paragvaj'a
paragvajo	paragvaj'o
paralakso	paralaks'o
paralela	paralel'a
paralelaj	paralel'a'j
paralelajn	paralel'a'j'n
paralelan	paralel'a'n
paralelas	paralel'as
paralele	paralel'e
paralelo	paralel'o
paraleloj	paralel'o'j
paralelojn	paralel'o'j'n
paralelon	paralel'o'n
paraleleco	paralel'ec'o
paralelecon	paralel'ec'o'n
paraleligo	paralel'ig'o
paraleligoj	paralel'ig'o'j
paraleligon	paralel'ig'o'n
paralelismo	paralel'ism'o
paralelogramo	paralelogram'o
paralimpika	paralimpik'a
paralimpikoj	paralimpik'o'j
paralimpikojn	paralimpik'o'j'n
paralizas	paraliz'as
paralizi	paraliz'i
paralizis	paraliz'is
paralizo	paraliz'o
paralizoj	paraliz'o'j
paralizon	paraliz'o'n
paraliziĝis	paraliz'iĝ'is
paralizita	paraliz'it'a
paralizitaj	paraliz'it'a'j
paralogismo	paralogism'o
parametro	parametr'o
parametroj	parametr'o'j
parametrojn	parametr'o'j'n
parametron	parametr'o'n
paranao	parana'o
paranoja	paranoj'a
paranojo	paranoj'o
parapeto	parapet'o
paraŝuto	paraŝut'o
paraŝutoj	paraŝut'o'j
paraŝutojn	paraŝut'o'j'n
paraŝuton	paraŝut'o'n
paraŝutado	paraŝut'ad'o
paraŝutistoj	paraŝut'ist'o'j
paraŝutsoldatoj	paraŝut'soldat'o'j
parazita	parazit'a
parazitaj	parazit'a'j
parazitajn	parazit'a'j'n
parazitas	parazit'as
parazito	parazit'o
parazitoj	parazit'o'j
parazitojn	parazit'o'j'n
paraziton	parazit'o'n
parazitado	parazit'ad'o
parazitismo	parazit'ism'o
parcelo	parcel'o
parceloj	parcel'o'j
parcelojn	parcel'o'j'n
parcelon	parcel'o'n
pardonas	pardon'as
pardoni	pardon'i
pardonis	pardon'is
pardono	pardon'o
pardonon	pardon'o'n
pardonos	pardon'os
pardonu	pardon'u
pardonus	pardon'us
pardonado	pardon'ad'o
pardonante	pardon'ant'e
pardonata	pardon'at'a
pardonebla	pardon'ebl'a
pardonema	pardon'em'a
pardonita	pardon'it'a
pardonitaj	pardon'it'a'j
pardonpeta	pardon'pet'a
pardonpetan	pardon'pet'a'n
pardonpetas	pardon'pet'as
pardonpete	pardon'pet'e
pardonpeti	pardon'pet'i
pardonpetis	pardon'pet'is
pardonpeto	pardon'pet'o
pardonpetoj	pardon'pet'o'j
pardonpetojn	pardon'pet'o'j'n
pardonpeton	pardon'pet'o'n
pardonpetos	pardon'pet'os
pardonpetu	pardon'pet'u
pardonpetismo	pardon'pet'ism'o
parenca	parenc'a
parencaj	parenc'a'j
parencajn	parenc'a'j'n
parencan	parenc'a'n
parencas	parenc'as
parence	parenc'e
parenco	parenc'o
parencoj	parenc'o'j
parencojn	parenc'o'j'n
parencon	parenc'o'n
parencaro	parenc'ar'o
parencaron	parenc'ar'o'n
parenceco	parenc'ec'o
parencecon	parenc'ec'o'n
parenciĝis	parenc'iĝ'is
parencino	parenc'in'o
parenteze	parentez'e
parentezo	parentez'o
parentezoj	parentez'o'j
parfuma	parfum'a
parfumo	parfum'o
parfumoj	parfum'o'j
parfumojn	parfum'o'j'n
parfumon	parfum'o'n
parfumfabrikado	parfum'fabrik'ad'o
parfumita	parfum'it'a
parfumitaj	parfum'it'a'j
pargeto	parget'o
pario	pari'o
parietala	parietal'a
pariso	paris'o
parison	paris'o'n
pariza	pariz'a
parizaj	pariz'a'j
parizan	pariz'a'n
parizo	pariz'o
parizon	pariz'o'n
parizano	pariz'an'o
parizanoj	pariz'an'o'j
parka	park'a
parkaj	park'a'j
parkas	park'as
parki	park'i
parkis	park'is
parko	park'o
parkoj	park'o'j
parkojn	park'o'j'n
parkon	park'o'n
parkado	park'ad'o
parkejo	park'ej'o
parkejoj	park'ej'o'j
parkejon	park'ej'o'n
parketo	park'et'o
parkita	park'it'a
parkitaj	park'it'a'j
parkstrato	park'strat'o
parkumas	park'um'as
parkumi	park'um'i
parkumis	park'um'is
parkumado	park'um'ad'o
parkumadon	park'um'ad'o'n
parkumejo	park'um'ej'o
parkumejoj	park'um'ej'o'j
parkumita	park'um'it'a
parkere	parker'e
parkeri	parker'i
parkeris	parker'is
parkerado	parker'ad'o
parkerigas	parker'ig'as
parkerigi	parker'ig'i
parkerigis	parker'ig'is
parkerigo	parker'ig'o
parkerigu	parker'ig'u
parkerigado	parker'ig'ad'o
parkerigita	parker'ig'it'a
parkerigitaj	parker'ig'it'a'j
parkinsona	parkinson'a
parkinsonmalsano	parkinson'mal'san'o
parlamenta	parlament'a
parlamentaj	parlament'a'j
parlamentajn	parlament'a'j'n
parlamentan	parlament'a'n
parlamento	parlament'o
parlamentoj	parlament'o'j
parlamentojn	parlament'o'j'n
parlamenton	parlament'o'n
parlamentano	parlament'an'o
parlamentanoj	parlament'an'o'j
parlamentanojn	parlament'an'o'j'n
parlamentejo	parlament'ej'o
parlamentestro	parlament'estr'o
parlamentismo	parlament'ism'o
parlamentario	parlamentari'o
parnasa	parnas'a
parnaso	parnas'o
parodia	parodi'a
parodiaj	parodi'a'j
parodian	parodi'a'n
parodias	parodi'as
parodii	parodi'i
parodiis	parodi'is
parodio	parodi'o
parodioj	parodi'o'j
parodion	parodi'o'n
parodiita	parodi'it'a
paroĥa	paroĥ'a
paroĥaj	paroĥ'a'j
paroĥan	paroĥ'a'n
paroĥo	paroĥ'o
paroĥoj	paroĥ'o'j
paroĥojn	paroĥ'o'j'n
paroĥon	paroĥ'o'n
paroĥanoj	paroĥ'an'o'j
paroĥejo	paroĥ'ej'o
paroĥejoj	paroĥ'ej'o'j
paroĥestro	paroĥ'estr'o
paroĥestroj	paroĥ'estr'o'j
paroĥestron	paroĥ'estr'o'n
paroĥestrejo	paroĥ'estr'ej'o
paroka	parok'a
parokaj	parok'a'j
paroko	parok'o
parokoj	parok'o'j
parokanaro	parok'an'ar'o
parokanaroj	parok'an'ar'o'j
parokanarojn	parok'an'ar'o'j'n
parokanaron	parok'an'ar'o'n
parokestro	parok'estr'o
parokestroj	parok'estr'o'j
paroksismo	paroksism'o
parola	parol'a
parolaj	parol'a'j
parolajn	parol'a'j'n
parolan	parol'a'n
parolas	parol'as
parole	parol'e
paroli	parol'i
parolis	parol'is
parolo	parol'o
paroloj	parol'o'j
parolojn	parol'o'j'n
parolon	parol'o'n
parolos	parol'os
parolu	parol'u
parolus	parol'us
paroladaj	parol'ad'a'j
paroladas	parol'ad'as
paroladi	parol'ad'i
paroladis	parol'ad'is
parolado	parol'ad'o
paroladoj	parol'ad'o'j
paroladojn	parol'ad'o'j'n
paroladon	parol'ad'o'n
paroladeraroj	parol'ad'erar'o'j
paroladpercepto	parol'ad'percept'o
paroladproduktado	parol'ad'produkt'ad'o
parolagoj	parol'ag'o'j
parolanta	parol'ant'a
parolantaj	parol'ant'a'j
parolantajn	parol'ant'a'j'n
parolantan	parol'ant'a'n
parolantas	parol'ant'as
parolante	parol'ant'e
parolanto	parol'ant'o
parolantoj	parol'ant'o'j
parolantojn	parol'ant'o'j'n
parolanton	parol'ant'o'n
parolantaro	parol'ant'ar'o
parolata	parol'at'a
parolataj	parol'at'a'j
parolatajn	parol'at'a'j'n
parolatan	parol'at'a'n
parolatas	parol'at'as
parolate	parol'at'e
parolebla	parol'ebl'a
parolema	parol'em'a
parolemaj	parol'em'a'j
paroleman	parol'em'a'n
paroleraro	parol'erar'o
paroleraroj	parol'erar'o'j
paroletas	parol'et'as
parolfiguroj	parol'figur'o'j
paroliga	parol'ig'a
paroligaj	parol'ig'a'j
paroligas	parol'ig'as
paroligi	parol'ig'i
paroliĝas	parol'iĝ'as
parolilo	parol'il'o
parolilon	parol'il'o'n
parolinta	parol'int'a
parolinte	parol'int'e
parolinto	parol'int'o
parolisto	parol'ist'o
parolistoj	parol'ist'o'j
parolita	parol'it'a
parolitaj	parol'it'a'j
parolitajn	parol'it'a'j'n
parolitan	parol'it'a'n
parolite	parol'it'e
parolkapablo	parol'kapabl'o
parolkapablon	parol'kapabl'o'n
parolkomunumo	parol'komun'um'o
parollibereco	parol'liber'ec'o
parollingva	parol'lingv'a
parollingvaj	parol'lingv'a'j
parolmaniero	parol'manier'o
parolmanieroj	parol'manier'o'j
parolmanieron	parol'manier'o'n
parolonta	parol'ont'a
parolorganoj	parol'organ'o'j
parolrajton	parol'rajt'o'n
parolrekono	parol're'kon'o
parolsintezo	parol'sintez'o
parolsonoj	parol'son'o'j
paroltemo	parol'tem'o
paroltemon	parol'tem'o'n
parolturno	parol'turn'o
parolturnoj	parol'turn'o'j
parolturnojn	parol'turn'o'j'n
parolunuo	parol'unu'o
parsekoj	parsek'o'j
parsioj	parsi'o'j
parta	part'a
partaj	part'a'j
partajn	part'a'j'n
partan	part'a'n
parte	part'e
parto	part'o
partoj	part'o'j
partojn	part'o'j'n
parton	part'o'n
partatempa	part'a'temp'a
partatempaj	part'a'temp'a'j
partatempan	part'a'temp'a'n
partatempe	part'a'temp'e
parteto	part'et'o
partetoj	part'et'o'j
parteton	part'et'o'n
partigas	part'ig'as
partigi	part'ig'i
partigo	part'ig'o
partigon	part'ig'o'n
partigita	part'ig'it'a
partopagoj	part'o'pag'o'j
partoprena	part'o'pren'a
partoprenaj	part'o'pren'a'j
partoprenan	part'o'pren'a'n
partoprenas	part'o'pren'as
partopreni	part'o'pren'i
partoprenis	part'o'pren'is
partopreno	part'o'pren'o
partoprenoj	part'o'pren'o'j
partoprenon	part'o'pren'o'n
partoprenos	part'o'pren'os
partoprenu	part'o'pren'u
partoprenus	part'o'pren'us
partoprenadis	part'o'pren'ad'is
partoprenado	part'o'pren'ad'o
partoprenadon	part'o'pren'ad'o'n
partoprenanta	part'o'pren'ant'a
partoprenantaj	part'o'pren'ant'a'j
partoprenantajn	part'o'pren'ant'a'j'n
partoprenante	part'o'pren'ant'e
partoprenanto	part'o'pren'ant'o
partoprenantoj	part'o'pren'ant'o'j
partoprenantojn	part'o'pren'ant'o'j'n
partoprenanton	part'o'pren'ant'o'n
partoprenantaro	part'o'pren'ant'ar'o
partoprenigas	part'o'pren'ig'as
partoprenigi	part'o'pren'ig'i
partoprenigis	part'o'pren'ig'is
partoprenigo	part'o'pren'ig'o
partoprenigita	part'o'pren'ig'it'a
partopreninta	part'o'pren'int'a
partoprenintaj	part'o'pren'int'a'j
partopreninte	part'o'pren'int'e
partopreninto	part'o'pren'int'o
partoprenintoj	part'o'pren'int'o'j
partoprenintojn	part'o'pren'int'o'j'n
partoprenita	part'o'pren'it'a
partoprenitaj	part'o'pren'it'a'j
partoprenontoj	part'o'pren'ont'o'j
partoprenontojn	part'o'pren'ont'o'j'n
parttempan	part'temp'a'n
parttempe	part'temp'e
partumas	part'um'as
partumi	part'um'i
partumis	part'um'is
partumado	part'um'ad'o
partumanta	part'um'ant'a
partumante	part'um'ant'e
partumita	part'um'it'a
partumitaj	part'um'it'a'j
partenogenezo	partenogenez'o
partenono	partenon'o
partero	parter'o
partia	parti'a
partiaj	parti'a'j
partiajn	parti'a'j'n
partian	parti'a'n
partio	parti'o
partioj	parti'o'j
partiojn	parti'o'j'n
partion	parti'o'n
partiano	parti'an'o
partianoj	parti'an'o'j
partianojn	parti'an'o'j'n
partianeco	parti'an'ec'o
partieca	parti'ec'a
partieco	parti'ec'o
partiestro	parti'estr'o
partiestroj	parti'estr'o'j
partigvidado	parti'gvid'ad'o
partikunveno	parti'kun'ven'o
participa	particip'a
participaj	particip'a'j
participo	particip'o
participoj	particip'o'j
participojn	particip'o'j'n
participon	particip'o'n
partikla	partikl'a
partiklaj	partikl'a'j
partiklan	partikl'a'n
partiklo	partikl'o
partikloj	partikl'o'j
partiklojn	partikl'o'j'n
partiklon	partikl'o'n
partikletoj	partikl'et'o'j
partiklograndeco	partikl'o'grand'ec'o
partikulo	partikul'o
partikuloj	partikul'o'j
partikulara	partikul'ar'a
partikularaj	partikul'ar'a'j
partikularan	partikul'ar'a'n
partikulare	partikul'ar'e
partituro	partitur'o
partituroj	partitur'o'j
partituron	partitur'o'n
partizana	partizan'a
partizanaj	partizan'a'j
partizano	partizan'o
partizanoj	partizan'o'j
partnera	partner'a
partneraj	partner'a'j
partnerajn	partner'a'j'n
partnere	partner'e
partnero	partner'o
partneroj	partner'o'j
partnerojn	partner'o'j'n
partneron	partner'o'n
partnereco	partner'ec'o
partnerecoj	partner'ec'o'j
partnerecojn	partner'ec'o'j'n
partnerecon	partner'ec'o'n
partnerino	partner'in'o
paruo	paru'o
paruoj	paru'o'j
parulio	paruli'o
parulioj	paruli'o'j
pasas	pas'as
pase	pas'e
pasi	pas'i
pasis	pas'is
paso	pas'o
pasoj	pas'o'j
pason	pas'o'n
pasos	pas'os
pasu	pas'u
pasus	pas'us
pasadis	pas'ad'is
pasado	pas'ad'o
pasadoj	pas'ad'o'j
pasadon	pas'ad'o'n
pasaĵo	pas'aĵ'o
pasaĵoj	pas'aĵ'o'j
pasaĵojn	pas'aĵ'o'j'n
pasanta	pas'ant'a
pasantaj	pas'ant'a'j
pasantajn	pas'ant'a'j'n
pasantan	pas'ant'a'n
pasante	pas'ant'e
pasanto	pas'ant'o
pasantoj	pas'ant'o'j
pasantojn	pas'ant'o'j'n
pasatoj	pas'at'o'j
pasejo	pas'ej'o
pasejoj	pas'ej'o'j
pasejojn	pas'ej'o'j'n
pasejon	pas'ej'o'n
pasema	pas'em'a
pasemaj	pas'em'a'j
pasemajn	pas'em'a'j'n
paseman	pas'em'a'n
pasigas	pas'ig'as
pasigi	pas'ig'i
pasigis	pas'ig'is
pasigo	pas'ig'o
pasigos	pas'ig'os
pasigu	pas'ig'u
pasigus	pas'ig'us
pasigadis	pas'ig'ad'is
pasigado	pas'ig'ad'o
pasigante	pas'ig'ant'e
pasiginta	pas'ig'int'a
pasiginte	pas'ig'int'e
pasigita	pas'ig'it'a
pasigitaj	pas'ig'it'a'j
pasigitajn	pas'ig'it'a'j'n
pasigitan	pas'ig'it'a'n
pasinta	pas'int'a
pasintaj	pas'int'a'j
pasintajn	pas'int'a'j'n
pasintan	pas'int'a'n
pasinte	pas'int'e
pasinto	pas'int'o
pasinton	pas'int'o'n
pasintajare	pas'int'a'jar'e
pasintaĵoj	pas'int'aĵ'o'j
pasintaĵon	pas'int'aĵ'o'n
pasintece	pas'int'ec'e
pasinteco	pas'int'ec'o
pasintecon	pas'int'ec'o'n
pasintfoje	pas'int'foj'e
pasintjara	pas'int'jar'a
pasintjaraj	pas'int'jar'a'j
pasintjaran	pas'int'jar'a'n
pasintjare	pas'int'jar'e
pasintmonate	pas'int'monat'e
pasintnokte	pas'int'nokt'e
pasintsemajne	pas'int'semajn'e
pasintsomere	pas'int'somer'e
pasintvespere	pas'int'vesper'e
pasita	pas'it'a
pasitaj	pas'it'a'j
pasite	pas'it'e
paspago	pas'pag'o
paspagoj	pas'pag'o'j
paspagojn	pas'pag'o'j'n
paspagon	pas'pag'o'n
paspermeson	pas'permes'o'n
pasponteto	pas'pont'et'o
pasvorto	pas'vort'o
pasvortoj	pas'vort'o'j
pasvortojn	pas'vort'o'j'n
pasvorton	pas'vort'o'n
paŝa	paŝ'a
pasha	paŝ'a
paŝas	paŝ'as
paŝi	paŝ'i
paŝis	paŝ'is
pasho	paŝ'o
paŝo	paŝ'o
paŝoj	paŝ'o'j
paŝojn	paŝ'o'j'n
paŝon	paŝ'o'n
paŝos	paŝ'os
paŝu	paŝ'u
paŝadas	paŝ'ad'as
paŝadi	paŝ'ad'i
paŝadis	paŝ'ad'is
paŝado	paŝ'ad'o
paŝadon	paŝ'ad'o'n
paŝanta	paŝ'ant'a
paŝantaj	paŝ'ant'a'j
paŝante	paŝ'ant'e
paŝegoj	paŝ'eg'o'j
paŝegojn	paŝ'eg'o'j'n
paŝinte	paŝ'int'e
paŝoŝtono	paŝ'o'ŝton'o
paŝao	paŝa'o
pasaĝera	pasaĝer'a
pasaĝeraj	pasaĝer'a'j
pasaĝeran	pasaĝer'a'n
pasaĝero	pasaĝer'o
pasaĝeroj	pasaĝer'o'j
pasaĝerojn	pasaĝer'o'j'n
pasaĝeron	pasaĝer'o'n
pasaĝersekcio	pasaĝer'sekci'o
pasaĝertransporto	pasaĝer'trans'port'o
pasamento	pasament'o
pasamentoj	pasament'o'j
paseo	pase'o
paseon	pase'o'n
pasero	paser'o
paseroj	paser'o'j
paseron	paser'o'n
paseroformaj	paser'o'form'a'j
pasia	pasi'a
pasiaj	pasi'a'j
pasiajn	pasi'a'j'n
pasian	pasi'a'n
pasie	pasi'e
pasio	pasi'o
pasioj	pasi'o'j
pasiojn	pasi'o'j'n
pasion	pasi'o'n
pasiiga	pasi'ig'a
pasiiĝis	pasi'iĝ'is
pasiono	pasion'o
pasionon	pasion'o'n
pasiva	pasiv'a
pasivaj	pasiv'a'j
pasivajn	pasiv'a'j'n
pasivan	pasiv'a'n
pasive	pasiv'e
pasivo	pasiv'o
pasivon	pasiv'o'n
pasivaĵo	pasiv'aĵ'o
pasiveco	pasiv'ec'o
pasivigas	pasiv'ig'as
pasivigo	pasiv'ig'o
paska	pask'a
paskaj	pask'a'j
paskajn	pask'a'j'n
paskan	pask'a'n
paske	pask'e
pasko	pask'o
paskon	pask'o'n
paskinsulo	pask'insul'o
paskala	paskal'a
paskalo	paskal'o
pasporta	pasport'a
pasportan	pasport'a'n
pasporto	pasport'o
pasportoj	pasport'o'j
pasportojn	pasport'o'j'n
pasporton	pasport'o'n
pasto	past'o
pastoj	past'o'j
paston	past'o'n
pastaĵo	past'aĵ'o
pastaĵoj	past'aĵ'o'j
pastaĵojn	past'aĵ'o'j'n
pastaĵon	past'aĵ'o'n
pastogloboj	past'o'glob'o'j
paŝta	paŝt'a
paŝtaj	paŝt'a'j
paŝtas	paŝt'as
paŝti	paŝt'i
paŝtis	paŝt'is
paŝto	paŝt'o
paŝtu	paŝt'u
paŝtado	paŝt'ad'o
paŝtadon	paŝt'ad'o'n
paŝtanta	paŝt'ant'a
paŝtantaj	paŝt'ant'a'j
paŝtante	paŝt'ant'e
paŝtejo	paŝt'ej'o
paŝtejoj	paŝt'ej'o'j
paŝtejojn	paŝt'ej'o'j'n
paŝtejon	paŝt'ej'o'n
paŝtiĝas	paŝt'iĝ'as
paŝtiĝi	paŝt'iĝ'i
paŝtiĝis	paŝt'iĝ'is
paŝtiĝantaj	paŝt'iĝ'ant'a'j
paŝtista	paŝt'ist'a
paŝtistaj	paŝt'ist'a'j
paŝtistan	paŝt'ist'a'n
paŝtisto	paŝt'ist'o
paŝtistoj	paŝt'ist'o'j
paŝtistojn	paŝt'ist'o'j'n
paŝtiston	paŝt'ist'o'n
paŝtistino	paŝt'ist'in'o
pasteĉo	pasteĉ'o
pasteĉojn	pasteĉ'o'j'n
pasteĉon	pasteĉ'o'n
paŝtelo	paŝtel'o
paŝteloj	paŝtel'o'j
pasteŭro	pasteŭr'o
pasteŭrizado	pasteŭr'iz'ad'o
pastiĉo	pastiĉ'o
pastoro	pastor'o
pastoroj	pastor'o'j
pastoreca	pastor'ec'a
pastorecaj	pastor'ec'a'j
pastorala	pastoral'a
pastra	pastr'a
pastraj	pastr'a'j
pastrajn	pastr'a'j'n
pastran	pastr'a'n
pastro	pastr'o
pastroj	pastr'o'j
pastrojn	pastr'o'j'n
pastron	pastr'o'n
pastraro	pastr'ar'o
pastraroj	pastr'ar'o'j
pastraron	pastr'ar'o'n
pastreco	pastr'ec'o
pastrejo	pastr'ej'o
pastriĝo	pastr'iĝ'o
pastrino	pastr'in'o
pastrinoj	pastr'in'o'j
pastrinon	pastr'in'o'n
pastrodomo	pastr'o'dom'o
pata	pat'a
pato	pat'o
patoj	pat'o'j
paton	pat'o'n
patkuko	pat'kuk'o
patkukoj	pat'kuk'o'j
patkukojn	pat'kuk'o'j'n
patkukon	pat'kuk'o'n
patagonia	patagoni'a
patagonio	patagoni'o
patenta	patent'a
patentaj	patent'a'j
patento	patent'o
patentoj	patent'o'j
patentojn	patent'o'j'n
patenton	patent'o'n
patentita	patent'it'a
patentitaj	patent'it'a'j
patentjuro	patent'jur'o
patentoficejo	patent'ofic'ej'o
patentpeto	patent'pet'o
patino	patin'o
patogena	patogen'a
patogenaj	patogen'a'j
patogeno	patogen'o
patogenoj	patogen'o'j
patogenojn	patogen'o'j'n
patogenezo	patogenez'o
patologia	patolog'i'a
patologiaj	patolog'i'a'j
patologian	patolog'i'a'n
patologie	patolog'i'e
patologio	patolog'i'o
patologioj	patolog'i'o'j
patologion	patolog'i'o'n
patologiisto	patolog'i'ist'o
patologiistoj	patolog'i'ist'o'j
patosa	patos'a
patose	patos'e
patoso	patos'o
patoson	patos'o'n
patra	patr'a
patraj	patr'a'j
patran	patr'a'n
patre	patr'e
patro	patr'o
patroj	patr'o'j
patrojn	patr'o'j'n
patron	patr'o'n
patraflanka	patr'a'flank'a
patreca	patr'ec'a
patreco	patr'ec'o
patrecon	patr'ec'o'n
patreto	patr'et'o
patria	patr'i'a
patrio	patr'i'o
patrion	patr'i'o'n
patrina	patr'in'a
patrinaj	patr'in'a'j
patrinajn	patr'in'a'j'n
patrinan	patr'in'a'n
patrino	patr'in'o
patrinoj	patr'in'o'j
patrinojn	patr'in'o'j'n
patrinon	patr'in'o'n
patrindiino	patr'in'di'in'o
patrineca	patr'in'ec'a
patrineco	patr'in'ec'o
patrinecon	patr'in'ec'o'n
patrineto	patr'in'et'o
patrinflanka	patr'in'flank'a
patrinflankaj	patr'in'flank'a'j
patrinlakto	patr'in'lakt'o
patrinlinia	patr'in'lini'a
patrinmontaro	patr'in'mont'ar'o
patroflanka	patr'o'flank'a
patrolanda	patr'o'land'a
patrolando	patr'o'land'o
patrolandon	patr'o'land'o'n
patrolinia	patr'o'lini'a
patroliniaj	patr'o'lini'a'j
patronomo	patr'o'nom'o
patronomon	patr'onom'o'n
patruja	patr'uj'a
patrujo	patr'uj'o
patrujoj	patr'uj'o'j
patrujon	patr'uj'o'n
patrujdefenda	patr'uj'defend'a
patriarĥa	patriarĥ'a
patriarka	patriark'a
patriarkaj	patriark'a'j
patriarkan	patriark'a'n
patriarko	patriark'o
patriarkoj	patriark'o'j
patriarkon	patriark'o'n
patriarkeca	patriark'ec'a
patriarkeco	patriark'ec'o
patriarkecon	patriark'ec'o'n
patriarkejo	patriark'ej'o
patricia	patrici'a
patriciaj	patrici'a'j
patricio	patrici'o
patricioj	patrici'o'j
patriko	patrik'o
patriota	patriot'a
patriotaj	patriot'a'j
patriotajn	patriot'a'j'n
patriotan	patriot'a'n
patrioto	patriot'o
patriotoj	patriot'o'j
patriotisma	patriot'ism'a
patriotismaj	patriot'ism'a'j
patriotismo	patriot'ism'o
patriotismon	patriot'ism'o'n
patrola	patrol'a
patrolaj	patrol'a'j
patrolas	patrol'as
patroli	patrol'i
patrolis	patrol'is
patrolo	patrol'o
patroloj	patrol'o'j
patrolojn	patrol'o'j'n
patrolon	patrol'o'n
patrolado	patrol'ad'o
patroladon	patrol'ad'o'n
patrona	patron'a
patronan	patron'a'n
patronis	patron'is
patrono	patron'o
patronoj	patron'o'j
patronojn	patron'o'j'n
patronon	patron'o'n
patronado	patron'ad'o
patronata	patron'at'a
patroneco	patron'ec'o
patronecon	patron'ec'o'n
patronino	patron'in'o
patronsanktulo	patron'sankt'ul'o
paŭla	paŭl'a
paŭlaj	paŭl'a'j
paŭlo	paŭl'o
paŭlon	paŭl'o'n
paŭsas	paŭs'as
paŭsi	paŭs'i
paŭsaĵo	paŭs'aĵ'o
paŭsaĵoj	paŭs'aĵ'o'j
paŭta	paŭt'a
paŭtas	paŭt'as
paŭtis	paŭt'is
paŭzas	paŭz'as
paŭzi	paŭz'i
paŭzis	paŭz'is
paŭzo	paŭz'o
paŭzoj	paŭz'o'j
paŭzojn	paŭz'o'j'n
paŭzon	paŭz'o'n
paŭzu	paŭz'u
paŭzante	paŭz'ant'e
paŭzeto	paŭz'et'o
paŭzetoj	paŭz'et'o'j
paŭzeton	paŭz'et'o'n
paŭzostreko	paŭz'o'strek'o
paŭzostrekoj	paŭz'o'strek'o'j
paŭzanio	paŭzani'o
pavas	pav'as
pavo	pav'o
pavoj	pav'o'j
pavojn	pav'o'j'n
pavon	pav'o'n
pavio	pavi'o
paviano	pavian'o
pavianoj	pavian'o'j
pavilono	pavilon'o
pavilonoj	pavilon'o'j
pavilonojn	pavilon'o'j'n
pavilonon	pavilon'o'n
pavimi	pavim'i
pavimis	pavim'is
pavimo	pavim'o
pavimoj	pavim'o'j
pavimon	pavim'o'n
pavimante	pavim'ant'e
pavimeroj	pavim'er'o'j
pavimita	pavim'it'a
pavimitaj	pavim'it'a'j
pavimitan	pavim'it'a'n
peano	pean'o
peco	pec'o
pecoj	pec'o'j
pecojn	pec'o'j'n
pecon	pec'o'n
pecegoj	pec'eg'o'j
peceto	pec'et'o
pecetoj	pec'et'o'j
pecetojn	pec'et'o'j'n
peceton	pec'et'o'n
pecetigita	pec'et'ig'it'a
pecetofteco	pec'et'oft'ec'o
pecmonero	pec'mon'er'o
peĉo	peĉ'o
pedagogo	pedagog'o
pedagogoj	pedagog'o'j
pedagogia	pedagog'i'a
pedagogiaj	pedagog'i'a'j
pedagogiajn	pedagog'i'a'j'n
pedagogian	pedagog'i'a'n
pedagogie	pedagog'i'e
pedagogio	pedagog'i'o
pedagogion	pedagog'i'o'n
pedalo	pedal'o
pedaloj	pedal'o'j
pedalojn	pedal'o'j'n
pedalon	pedal'o'n
pedalaro	pedal'ar'o
pedanta	pedant'a
pedante	pedant'e
pedanto	pedant'o
pedanteco	pedant'ec'o
pedelo	pedel'o
pedeloj	pedel'o'j
pederastio	pederast'i'o
pediko	pedik'o
pedikoj	pedik'o'j
pedikojn	pedik'o'j'n
pedofilo	pedofil'o
pedofilia	pedofil'i'a
pedofilio	pedofil'i'o
pego	peg'o
pegoj	peg'o'j
pegedoj	peg'ed'o'j
pegazo	pegaz'o
pejzaĝa	pejzaĝ'a
pejzaĝaj	pejzaĝ'a'j
pejzaĝe	pejzaĝ'e
pejzaĝo	pejzaĝ'o
pejzaĝoj	pejzaĝ'o'j
pejzaĝojn	pejzaĝ'o'j'n
pejzaĝon	pejzaĝ'o'n
pejzaĝarkitekturo	pejzaĝ'arkitektur'o
pejzaĝekologio	pejzaĝ'ekolog'i'o
pejzaĝigado	pejzaĝ'ig'ad'o
pejzaĝistoj	pejzaĝ'ist'o'j
peka	pek'a
pekaj	pek'a'j
pekan	pek'a'n
pekas	pek'as
peke	pek'e
peki	pek'i
pekis	pek'is
peko	pek'o
pekoj	pek'o'j
pekojn	pek'o'j'n
pekon	pek'o'n
peku	pek'u
pekado	pek'ad'o
pekanto	pek'ant'o
pekantoj	pek'ant'o'j
pekeco	pek'ec'o
pekema	pek'em'a
pekemaj	pek'em'a'j
pekfalo	pek'fal'o
pekinto	pek'int'o
pekintoj	pek'int'o'j
pekintojn	pek'int'o'j'n
pekinton	pek'int'o'n
pekkonfeso	pek'konfes'o
pekliberigo	pek'liber'ig'o
pektino	pek'tin'o
pekulo	pek'ul'o
pekuloj	pek'ul'o'j
pekulojn	pek'ul'o'j'n
pekulon	pek'ul'o'n
pekina	pekin'a
pekinaj	pekin'a'j
pekinajn	pekin'a'j'n
pekinan	pekin'a'n
pekino	pekin'o
pekinon	pekin'o'n
pekinanoj	pekin'an'o'j
pekinopera	pekin'oper'a
peklas	pekl'as
peklita	pekl'it'a
peklitaj	pekl'it'a'j
pekteno	pekten'o
pektenoj	pekten'o'j
pelas	pel'as
peli	pel'i
pelis	pel'is
pelo	pel'o
pelos	pel'os
pelu	pel'u
pelus	pel'us
pelado	pel'ad'o
pelanta	pel'ant'a
pelante	pel'ant'e
pelata	pel'at'a
pelataj	pel'at'a'j
pelate	pel'at'e
pelilo	pel'il'o
peliloj	pel'il'o'j
pelita	pel'it'a
pelitaj	pel'it'a'j
pelado	pelad'o
pelaga	pelag'a
pelagaj	pelag'a'j
pelagio	pelagi'o
peleo	pele'o
pelerino	pelerin'o
pelikano	pelikan'o
pelikanoj	pelikan'o'j
pelmelo	pelmel'o
pelta	pelt'a
pelto	pelt'o
peltoj	pelt'o'j
peltojn	pelt'o'j'n
pelton	pelt'o'n
peltindustrio	pelt'industri'o
peltisto	pelt'ist'o
pelva	pelv'a
pelvaj	pelv'a'j
pelvo	pelv'o
pelvon	pelv'o'n
pelveto	pelv'et'o
pena	pen'a
penan	pen'a'n
penas	pen'as
pene	pen'e
peni	pen'i
peno	pen'o
penoj	pen'o'j
penojn	pen'o'j'n
penon	pen'o'n
penos	pen'os
penu	pen'u
penus	pen'us
penadas	pen'ad'as
penadi	pen'ad'i
penadis	pen'ad'is
penado	pen'ad'o
penadoj	pen'ad'o'j
penadojn	pen'ad'o'j'n
penadon	pen'ad'o'n
penanta	pen'ant'a
penantaj	pen'ant'a'j
penante	pen'ant'e
penatoj	pen'at'o'j
penega	pen'eg'a
penegas	pen'eg'as
penege	pen'eg'e
penegis	pen'eg'is
peniga	pen'ig'a
penigaj	pen'ig'a'j
penigan	pen'ig'a'n
penige	pen'ig'e
penita	pen'it'a
penco	penc'o
pencoj	penc'o'j
pencojn	penc'o'j'n
pencon	penc'o'n
penda	pend'a
pendas	pend'as
pendi	pend'i
pendis	pend'is
pendos	pend'os
pendado	pend'ad'o
pendaĵo	pend'aĵ'o
pendaĵoj	pend'aĵ'o'j
pendaĵojn	pend'aĵ'o'j'n
pendanta	pend'ant'a
pendantaj	pend'ant'a'j
pendantajn	pend'ant'a'j'n
pendantan	pend'ant'a'n
pendante	pend'ant'e
pendigas	pend'ig'as
pendigi	pend'ig'i
pendigis	pend'ig'is
pendigo	pend'ig'o
pendigos	pend'ig'os
pendigu	pend'ig'u
pendigante	pend'ig'ant'e
pendigilo	pend'ig'il'o
pendiginte	pend'ig'int'e
pendigita	pend'ig'it'a
pendigitaj	pend'ig'it'a'j
pendigitan	pend'ig'it'a'n
pendiĝas	pend'iĝ'as
pendiĝis	pend'iĝ'is
pendita	pend'it'a
pendumi	pend'um'i
pendumis	pend'um'is
pendumo	pend'um'o
pendumos	pend'um'os
pendumilo	pend'um'il'o
pendumita	pend'um'it'a
pendolo	pendol'o
pendolon	pendol'o'n
peneo	pene'o
penelope	penelop'e
penelopo	penelop'o
penetra	penetr'a
penetraj	penetr'a'j
penetran	penetr'a'n
penetras	penetr'as
penetre	penetr'e
penetri	penetr'i
penetris	penetr'is
penetro	penetr'o
penetron	penetr'o'n
penetros	penetr'os
penetru	penetr'u
penetrus	penetr'us
penetradis	penetr'ad'is
penetrado	penetr'ad'o
penetradon	penetr'ad'o'n
penetranta	penetr'ant'a
penetrantaj	penetr'ant'a'j
penetrante	penetr'ant'e
penetrebla	penetr'ebl'a
penetreblaj	penetr'ebl'a'j
penetrema	penetr'em'a
penetremaj	penetr'em'a'j
penetrinta	penetr'int'a
penetrita	penetr'it'a
penetritaj	penetr'it'a'j
penicilino	penicil'in'o
peniko	penik'o
penikoj	penik'o'j
penikon	penik'o'n
penisa	penis'a
peniso	penis'o
penisoj	penis'o'j
penison	penis'o'n
pensa	pens'a
pensaj	pens'a'j
pensan	pens'a'n
pensas	pens'as
pense	pens'e
pensi	pens'i
pensis	pens'is
penso	pens'o
pensoj	pens'o'j
pensojn	pens'o'j'n
penson	pens'o'n
pensos	pens'os
pensu	pens'u
pensus	pens'us
pensadas	pens'ad'as
pensadi	pens'ad'i
pensadis	pens'ad'is
pensado	pens'ad'o
pensadoj	pens'ad'o'j
pensadojn	pens'ad'o'j'n
pensadon	pens'ad'o'n
pensaĵo	pens'aĵ'o
pensanta	pens'ant'a
pensantaj	pens'ant'a'j
pensantan	pens'ant'a'n
pensante	pens'ant'e
pensanto	pens'ant'o
pensantoj	pens'ant'o'j
pensaro	pens'ar'o
pensata	pens'at'a
pensebla	pens'ebl'a
penseblaj	pens'ebl'a'j
penseblas	pens'ebl'as
penseble	pens'ebl'e
pensema	pens'em'a
pensemaj	pens'em'a'j
penseme	pens'em'e
pensfabriko	pens'fabrik'o
pensfabrikoj	pens'fabrik'o'j
pensfabrikojn	pens'fabrik'o'j'n
pensfadenon	pens'faden'o'n
pensfluo	pens'flu'o
pensiga	pens'ig'a
pensigaj	pens'ig'a'j
pensigajn	pens'ig'a'j'n
pensigas	pens'ig'as
pensige	pens'ig'e
pensigi	pens'ig'i
pensigis	pens'ig'is
pensinta	pens'int'a
pensinte	pens'int'e
pensintus	pens'int'us
pensisto	pens'ist'o
pensistoj	pens'ist'o'j
pensita	pens'it'a
pensitaj	pens'it'a'j
penskapablo	pens'kapabl'o
penslibereco	pens'liber'ec'o
pensmaniero	pens'manier'o
pensmanieroj	pens'manier'o'j
pensmanierojn	pens'manier'o'j'n
pensmanieron	pens'manier'o'n
pensomaniero	pens'o'manier'o
pensoskoloj	pens'o'skol'o'j
penspolico	pens'polic'o
pensulo	pens'ul'o
pensuloj	pens'ul'o'j
pensulojn	pens'ul'o'j'n
pensia	pensi'a
pensiaj	pensi'a'j
pensio	pensi'o
pensioj	pensi'o'j
pensiojn	pensi'o'j'n
pension	pensi'o'n
pensiiĝis	pensi'iĝ'is
pensiiĝo	pensi'iĝ'o
pensiiĝos	pensi'iĝ'os
pensiita	pensi'it'a
pensiulo	pensi'ul'o
pensiuloj	pensi'ul'o'j
pensiulino	pensi'ul'in'o
pensilvania	pensilvani'a
pensilvanio	pensilvani'o
pensiono	pension'o
pensionoj	pension'o'j
pensionon	pension'o'n
penta	pent'a
pentas	pent'as
pente	pent'e
penti	pent'i
pentis	pent'is
pento	pent'o
penton	pent'o'n
pentos	pent'os
pentu	pent'u
pentus	pent'us
pentado	pent'ad'o
pentanta	pent'ant'a
pentanto	pent'ant'o
pentinta	pent'int'a
pentofari	pent'o'far'i
pentofaro	pent'o'far'o
pentofaron	pent'o'far'o'n
pentofaradon	pent'o'far'ad'o'n
pentofarado	pent'o'farad'o
pentagono	pentagon'o
pentagramo	pentagram'o
pentametro	pentametr'o
pentekosta	pentekost'a
pentekosto	pentekost'o
pentekoston	pentekost'o'n
pentra	pentr'a
pentras	pentr'as
pentri	pentr'i
pentris	pentr'is
pentros	pentr'os
pentru	pentr'u
pentrus	pentr'us
pentradis	pentr'ad'is
pentrado	pentr'ad'o
pentradon	pentr'ad'o'n
pentrajho	pentr'aĵ'o
pentraĵo	pentr'aĵ'o
pentraĵoj	pentr'aĵ'o'j
pentraĵojn	pentr'aĵ'o'j'n
pentraĵon	pentr'aĵ'o'n
pentranta	pentr'ant'a
pentrante	pentr'ant'e
pentrarto	pentr'art'o
pentrartoj	pentr'art'o'j
pentrarton	pentr'art'o'n
pentrata	pentr'at'a
pentrinda	pentr'ind'a
pentrindaj	pentr'ind'a'j
pentrista	pentr'ist'a
pentristo	pentr'ist'o
pentristoj	pentr'ist'o'j
pentristojn	pentr'ist'o'j'n
pentriston	pentr'ist'o'n
pentristino	pentr'ist'in'o
pentrita	pentr'it'a
pentritaj	pentr'it'a'j
pentritajn	pentr'it'a'j'n
pentritan	pentr'it'a'n
pentrite	pentr'it'e
pentroarto	pentr'o'art'o
pentroarton	pentr'o'art'o'n
peono	peon'o
peonoj	peon'o'j
peonojn	peon'o'j'n
peonon	peon'o'n
peonia	peoni'a
peonio	peoni'o
peonioj	peoni'o'j
pepas	pep'as
pepi	pep'i
pepis	pep'is
pepo	pep'o
pepado	pep'ad'o
pepadon	pep'ad'o'n
peplomo	peplom'o
per	per
pera	per'a
peras	per'as
pere	per'e
peri	per'i
peris	per'is
pero	per'o
peru	per'u
perado	per'ad'o
peradon	per'ad'o'n
peraĵo	per'aĵ'o
peranta	per'ant'a
perantaj	per'ant'a'j
perante	per'ant'e
peranto	per'ant'o
perantoj	per'ant'o'j
perantojn	per'ant'o'j'n
peranton	per'ant'o'n
perantino	per'ant'in'o
perborato	per'bor'at'o
perbusa	per'bus'a
perbuse	per'bus'e
perbuŝa	per'buŝ'a
perbuŝe	per'buŝ'e
peresperanta	per'esperant'a
perfingre	per'fingr'e
perforta	per'fort'a
perfortaj	per'fort'a'j
perfortajn	per'fort'a'j'n
perfortan	per'fort'a'n
perfortas	per'fort'as
perforte	per'fort'e
perforti	per'fort'i
perfortis	per'fort'is
perforto	per'fort'o
perfortoj	per'fort'o'j
perfortojn	per'fort'o'j'n
perforton	per'fort'o'n
perfortado	per'fort'ad'o
perfortagoj	per'fort'ag'o'j
perfortaĵoj	per'fort'aĵ'o'j
perfortema	per'fort'em'a
perfortemaj	per'fort'em'a'j
perfortita	per'fort'it'a
perfortkrimoj	per'fort'krim'o'j
perfortuloj	per'fort'ul'o'j
perilo	per'il'o
perilon	per'il'o'n
peristo	per'ist'o
peristoj	per'ist'o'j
perita	per'it'a
peritaj	per'it'a'j
perkape	per'kap'e
perkarbaj	per'karb'a'j
perklorata	per'klor'at'a
perklorato	per'klor'at'o
perkomputila	per'komput'il'a
perkomputile	per'komput'il'e
perkoresponde	per'korespond'e
perlaboras	per'labor'as
perlabori	per'labor'i
perlaboris	per'labor'is
perlaboros	per'labor'os
perleĝe	per'leĝ'e
perletere	per'leter'e
permana	per'man'a
permanaj	per'man'a'j
permanan	per'man'a'n
permane	per'man'e
permanganato	per'mangan'at'o
peroksido	per'oksid'o
peroksidoj	per'oksid'o'j
peroksidon	per'oksid'o'n
perokule	per'okul'e
perpiede	per'pied'e
perpoŝte	per'poŝt'e
perpreĝe	per'preĝ'e
perreta	per'ret'a
perrete	per'ret'e
perŝipe	per'ŝip'e
persulfato	per'sulf'at'o
pertelefone	per'telefon'e
pertrajne	per'trajn'e
perverba	per'verb'a
perverban	per'verb'a'n
pervoĉe	per'voĉ'e
pervorte	per'vort'e
perĉo	perĉ'o
percepta	percept'a
perceptaj	percept'a'j
perceptajn	percept'a'j'n
perceptan	percept'a'n
perceptas	percept'as
percepte	percept'e
percepti	percept'i
perceptis	percept'is
percepto	percept'o
perceptoj	percept'o'j
perceptojn	percept'o'j'n
percepton	percept'o'n
perceptos	percept'os
perceptu	percept'u
perceptus	percept'us
perceptado	percept'ad'o
perceptante	percept'ant'e
perceptata	percept'at'a
perceptataj	percept'at'a'j
perceptebla	percept'ebl'a
percepteblaj	percept'ebl'a'j
percepteblajn	percept'ebl'a'j'n
percepteblan	percept'ebl'a'n
percepteblas	percept'ebl'as
percepteble	percept'ebl'e
perceptita	percept'it'a
perceptitaj	percept'it'a'j
perceptitajn	percept'it'a'j'n
perceptitan	percept'it'a'n
perceptite	percept'it'e
perda	perd'a
perdas	perd'as
perdi	perd'i
perdis	perd'is
perdo	perd'o
perdoj	perd'o'j
perdojn	perd'o'j'n
perdon	perd'o'n
perdos	perd'os
perdu	perd'u
perdus	perd'us
perdadas	perd'ad'as
perdadis	perd'ad'is
perdado	perd'ad'o
perdanta	perd'ant'a
perdantaj	perd'ant'a'j
perdante	perd'ant'e
perdanto	perd'ant'o
perdigas	perd'ig'as
perdigi	perd'ig'i
perdigis	perd'ig'is
perdiĝas	perd'iĝ'as
perdiĝi	perd'iĝ'i
perdiĝis	perd'iĝ'is
perdiĝo	perd'iĝ'o
perdiĝon	perd'iĝ'o'n
perdiĝos	perd'iĝ'os
perdiĝu	perd'iĝ'u
perdiĝus	perd'iĝ'us
perdiĝinta	perd'iĝ'int'a
perdiĝintaj	perd'iĝ'int'a'j
perdinta	perd'int'a
perdintaj	perd'int'a'j
perdinte	perd'int'e
perdinto	perd'int'o
perdita	perd'it'a
perditaj	perd'it'a'j
perditajn	perd'it'a'j'n
perditan	perd'it'a'n
perdite	perd'it'e
perdvarmo	perd'varm'o
perdvarmon	perd'varm'o'n
perdriko	perdrik'o
perdrikoj	perdrik'o'j
pereas	pere'as
perei	pere'i
pereis	pere'is
pereo	pere'o
pereon	pere'o'n
pereos	pere'os
pereu	pere'u
pereus	pere'us
pereadis	pere'ad'is
pereanta	pere'ant'a
pereiga	pere'ig'a
pereigan	pere'ig'a'n
pereigas	pere'ig'as
pereigi	pere'ig'i
pereigis	pere'ig'is
pereigos	pere'ig'os
pereigus	pere'ig'us
pereigita	pere'ig'it'a
pereinta	pere'int'a
pereintaj	pere'int'a'j
pereintoj	pere'int'o'j
pereonta	pere'ont'a
perestrojko	perestrojk'o
perfekta	perfekt'a
perfektaj	perfekt'a'j
perfektajn	perfekt'a'j'n
perfektan	perfekt'a'n
perfektas	perfekt'as
perfekte	perfekt'e
perfekto	perfekt'o
perfekteco	perfekt'ec'o
perfektecoj	perfekt'ec'o'j
perfektecon	perfekt'ec'o'n
perfektiga	perfekt'ig'a
perfektigan	perfekt'ig'a'n
perfektigas	perfekt'ig'as
perfektigi	perfekt'ig'i
perfektigis	perfekt'ig'is
perfektigo	perfekt'ig'o
perfektigon	perfekt'ig'o'n
perfektigos	perfekt'ig'os
perfektigu	perfekt'ig'u
perfektigado	perfekt'ig'ad'o
perfektigita	perfekt'ig'it'a
perfektigitaj	perfekt'ig'it'a'j
perfektiĝas	perfekt'iĝ'as
perfektiĝi	perfekt'iĝ'i
perfektiĝis	perfekt'iĝ'is
perfektiĝo	perfekt'iĝ'o
perfektiĝon	perfekt'iĝ'o'n
perfektismo	perfekt'ism'o
perfektulo	perfekt'ul'o
perfektive	perfektiv'e
perfida	perfid'a
perfidaj	perfid'a'j
perfidan	perfid'a'n
perfidas	perfid'as
perfide	perfid'e
perfidi	perfid'i
perfidis	perfid'is
perfido	perfid'o
perfidon	perfid'o'n
perfidos	perfid'os
perfidu	perfid'u
perfidus	perfid'us
perfidado	perfid'ad'o
perfidita	perfid'it'a
perfiditaj	perfid'it'a'j
perfidulo	perfid'ul'o
perfiduloj	perfid'ul'o'j
perfidulojn	perfid'ul'o'j'n
perfidulon	perfid'ul'o'n
pergamo	pergam'o
pergameno	pergamen'o
pergamenon	pergamen'o'n
pergolo	pergol'o
pergoloj	pergol'o'j
peridermo	periderm'o
periferia	periferi'a
periferiaj	periferi'a'j
periferiajn	periferi'a'j'n
periferian	periferi'a'n
periferie	periferi'e
periferio	periferi'o
periferioj	periferi'o'j
periferion	periferi'o'n
perigordo	perigord'o
perihelio	periheli'o
perimetro	perimetr'o
perimetron	perimetr'o'n
perioda	period'a
periodaj	period'a'j
periodajn	period'a'j'n
periodan	period'a'n
periode	period'e
periodo	period'o
periodoj	period'o'j
periodojn	period'o'j'n
periodon	period'o'n
periodaĵo	period'aĵ'o
periodaĵoj	period'aĵ'o'j
periodaĵojn	period'aĵ'o'j'n
periodaĵon	period'aĵ'o'n
periodeco	period'ec'o
periodecon	period'ec'o'n
periodigo	period'ig'o
periskopo	periskop'o
peristilo	peristil'o
peritoneo	peritone'o
perko	perk'o
perkoformaj	perk'o'form'a'j
perkutado	perkut'ad'o
perkutadon	perkut'ad'o'n
perkutinstrumentoj	perkut'instrument'o'j
perla	perl'a
perlaj	perl'a'j
perlan	perl'a'n
perlis	perl'is
perlo	perl'o
perloj	perl'o'j
perlojn	perl'o'j'n
perlon	perl'o'n
perlamoto	perlamot'o
permanenta	permanent'a
permanentaj	permanent'a'j
permanentajn	permanent'a'j'n
permanentan	permanent'a'n
permanente	permanent'e
permeablo	permeabl'o
permeablon	permeabl'o'n
permesas	permes'as
permesi	permes'i
permesis	permes'is
permeso	permes'o
permesoj	permes'o'j
permesojn	permes'o'j'n
permeson	permes'o'n
permesos	permes'os
permesu	permes'u
permesus	permes'us
permesadis	permes'ad'is
permesado	permes'ad'o
permesanta	permes'ant'a
permesantaj	permes'ant'a'j
permesantajn	permes'ant'a'j'n
permesantan	permes'ant'a'n
permesante	permes'ant'e
permesata	permes'at'a
permesataj	permes'at'a'j
permesatas	permes'at'as
permesate	permes'at'e
permesebla	permes'ebl'a
permeseblaj	permes'ebl'a'j
permeseblas	permes'ebl'as
permeseble	permes'ebl'e
permesilo	permes'il'o
permesiloj	permes'il'o'j
permesilojn	permes'il'o'j'n
permesilon	permes'il'o'n
permesinta	permes'int'a
permesinte	permes'int'e
permesintus	permes'int'us
permesita	permes'it'a
permesitaj	permes'it'a'j
permesitajn	permes'it'a'j'n
permesitan	permes'it'a'n
permesite	permes'it'e
permio	permi'o
permutaĵo	permut'aĵ'o
permutaĵoj	permut'aĵ'o'j
perono	peron'o
peronoj	peron'o'j
peronon	peron'o'n
perpendikla	perpendikl'a
perpendikle	perpendikl'e
perpendikulara	perpendikular'a
perpendikularaj	perpendikular'a'j
perpendikularan	perpendikular'a'n
perpendikulare	perpendikular'e
perpleksa	perpleks'a
perpleksaj	perpleks'a'j
perplekse	perpleks'e
perpleksis	perpleks'is
perplekso	perpleks'o
perplekson	perpleks'o'n
perpleksigis	perpleks'ig'is
perpleksita	perpleks'it'a
persa	pers'a
persaj	pers'a'j
persajn	pers'a'j'n
persan	pers'a'n
perse	pers'e
perso	pers'o
persoj	pers'o'j
person	pers'o'n
persaraba	pers'arab'a
persia	pers'i'a
persian	pers'i'a'n
persio	pers'i'o
perslingva	pers'lingv'a
persujo	pers'uj'o
perseo	perse'o
perseon	perse'o'n
persefono	persefon'o
persekutas	persekut'as
persekute	persekut'e
persekuti	persekut'i
persekutis	persekut'is
persekuto	persekut'o
persekutoj	persekut'o'j
persekutojn	persekut'o'j'n
persekuton	persekut'o'n
persekutos	persekut'os
persekutu	persekut'u
persekutus	persekut'us
persekutadas	persekut'ad'as
persekutadis	persekut'ad'is
persekutado	persekut'ad'o
persekutadoj	persekut'ad'o'j
persekutadon	persekut'ad'o'n
persekutanta	persekut'ant'a
persekutantaj	persekut'ant'a'j
persekutante	persekut'ant'e
persekutantoj	persekut'ant'o'j
persekutantojn	persekut'ant'o'j'n
persekutata	persekut'at'a
persekutataj	persekut'at'a'j
persekutatoj	persekut'at'o'j
persekutita	persekut'it'a
persekutitaj	persekut'it'a'j
persepolo	persepol'o
persika	persik'a
persikaj	persik'a'j
persiko	persik'o
persikoj	persik'o'j
persikojn	persik'o'j'n
persikon	persik'o'n
persikarbo	persik'arb'o
persikarbeto	persik'arb'et'o
persikflora	persik'flor'a
persimono	persimon'o
persimonoj	persimon'o'j
persista	persist'a
persistaj	persist'a'j
persistajn	persist'a'j'n
persistan	persist'a'n
persistas	persist'as
persiste	persist'e
persisti	persist'i
persistis	persist'is
persisto	persist'o
persiston	persist'o'n
persistos	persist'os
persistu	persist'u
persistado	persist'ad'o
persistante	persist'ant'e
persisteco	persist'ec'o
persistema	persist'em'a
persistemaj	persist'em'a'j
persisteme	persist'em'e
persistemo	persist'em'o
persistemoj	persist'em'o'j
persistemon	persist'em'o'n
persona	person'a
personaj	person'a'j
personajn	person'a'j'n
personan	person'a'n
persone	person'e
persono	person'o
personoj	person'o'j
personojn	person'o'j'n
personon	person'o'n
personaĵo	person'aĵ'o
personaĵoj	person'aĵ'o'j
personara	person'ar'a
personaro	person'ar'o
personaron	person'ar'o'n
personaŭtoj	person'aŭt'o'j
personeca	person'ec'a
personecaj	person'ec'a'j
personeco	person'ec'o
personecoj	person'ec'o'j
personecojn	person'ec'o'j'n
personecon	person'ec'o'n
personecmalsano	person'ec'mal'san'o
personigas	person'ig'as
personigi	person'ig'i
personigis	person'ig'is
personigo	person'ig'o
personigoj	person'ig'o'j
personigebla	person'ig'ebl'a
personigita	person'ig'it'a
personigitaj	person'ig'it'a'j
personigitajn	person'ig'it'a'j'n
personigitan	person'ig'it'a'n
personkulto	person'kult'o
personnomoj	person'nom'o'j
persontrajnoj	person'trajn'o'j
personulo	person'ul'o
personuloj	person'ul'o'j
perspektiva	perspektiv'a
perspektivaj	perspektiv'a'j
perspektivo	perspektiv'o
perspektivoj	perspektiv'o'j
perspektivojn	perspektiv'o'j'n
perspektivon	perspektiv'o'n
persvadas	persvad'as
persvadi	persvad'i
persvadis	persvad'is
persvado	persvad'o
persvadoj	persvad'o'j
persvados	persvad'os
persvadu	persvad'u
persvadado	persvad'ad'o
persvadante	persvad'ant'e
persvadita	persvad'it'a
persvaditaj	persvad'it'a'j
perturba	perturb'a
perturbas	perturb'as
perturbi	perturb'i
perturbis	perturb'is
perturbo	perturb'o
perturboj	perturb'o'j
perturbojn	perturb'o'j'n
perturbon	perturb'o'n
perturbita	perturb'it'a
perturbitaj	perturb'it'a'j
perua	peru'a
peruaj	peru'a'j
peruan	peru'a'n
peruo	peru'o
peruon	peru'o'n
peruanoj	peru'an'o'j
peruko	peruk'o
perukoj	peruk'o'j
perukon	peruk'o'n
perversa	pervers'a
perversaj	pervers'a'j
perversajn	pervers'a'j'n
perversan	pervers'a'n
perverse	pervers'e
perverso	pervers'o
pesas	pes'as
pesi	pes'i
pesis	pes'is
peso	pes'o
pesoj	pes'o'j
pesu	pes'u
pesado	pes'ad'o
pesante	pes'ant'e
pesilo	pes'il'o
pesilon	pes'il'o'n
pesita	pes'it'a
pesaĥo	pesaĥ'o
pesimisma	pesimism'a
pesimismaj	pesimism'a'j
pesimisman	pesimism'a'n
pesimisme	pesimism'e
pesimismo	pesimism'o
pesimismon	pesimism'o'n
pesimisto	pesimist'o
pesimistoj	pesimist'o'j
pesta	pest'a
pesto	pest'o
peston	pest'o'n
pesticido	pesticid'o
peta	pet'a
petas	pet'as
pete	pet'e
peti	pet'i
petis	pet'is
peto	pet'o
petoj	pet'o'j
petojn	pet'o'j'n
peton	pet'o'n
petos	pet'os
petu	pet'u
petus	pet'us
petadis	pet'ad'is
petado	pet'ad'o
petanta	pet'ant'a
petantaj	pet'ant'a'j
petantajn	pet'ant'a'j'n
petantan	pet'ant'a'n
petante	pet'ant'e
petanto	pet'ant'o
petantoj	pet'ant'o'j
petata	pet'at'a
petataj	pet'at'a'j
petega	pet'eg'a
petegas	pet'eg'as
petege	pet'eg'e
petegi	pet'eg'i
petegis	pet'eg'is
petego	pet'eg'o
petegoj	pet'eg'o'j
petegon	pet'eg'o'n
petegos	pet'eg'os
petegu	pet'eg'u
petegado	pet'eg'ad'o
petegante	pet'eg'ant'e
petinta	pet'int'a
petinte	pet'int'e
petintus	pet'int'us
petita	pet'it'a
petitaj	pet'it'a'j
petitajn	pet'it'a'j'n
petitan	pet'it'a'n
petite	pet'it'e
petskribo	pet'skrib'o
petskriboj	pet'skrib'o'j
petskribojn	pet'skrib'o'j'n
petskribon	pet'skrib'o'n
petveturi	pet'vetur'i
petveturado	pet'vetur'ad'o
petalo	petal'o
petaloj	petal'o'j
petalojn	petal'o'j'n
petardo	petard'o
petardoj	petard'o'j
petardojn	petard'o'j'n
peterburga	peterburg'a
peterburgaj	peterburg'a'j
peterburgo	peterburg'o
peterburgon	peterburg'o'n
peticio	petici'o
peticioj	petici'o'j
peticiojn	petici'o'j'n
peticion	petici'o'n
peticiado	petici'ad'o
petiolo	petiol'o
petioloj	petiol'o'j
petola	petol'a
petolaj	petol'a'j
petolan	petol'a'n
petolas	petol'as
petole	petol'e
petoli	petol'i
petolis	petol'is
petolo	petol'o
petolon	petol'o'n
petoladis	petol'ad'is
petolado	petol'ad'o
petolaĵo	petol'aĵ'o
petolaĵoj	petol'aĵ'o'j
petolema	petol'em'a
petolemaj	petol'em'a'j
petolemo	petol'em'o
petolulo	petol'ul'o
petra	petr'a
petri	petr'i
petro	petr'o
petroj	petr'o'j
petron	petr'o'n
petrus	petr'us
petrarko	petrark'o
petrelo	petrel'o
petreloj	petrel'o'j
petrogrado	petrograd'o
petrola	petrol'a
petrolaj	petrol'a'j
petrolo	petrol'o
petroloj	petrol'o'j
petrolojn	petrol'o'j'n
petrolon	petrol'o'n
petrolindustrio	petrol'industri'o
petrolkampo	petrol'kamp'o
petrolkemia	petrol'kemi'a
petrolkemiaj	petrol'kemi'a'j
petrolkemiaĵoj	petrol'kemi'aĵ'o'j
petrolproduktado	petrol'produkt'ad'o
petrolŝipo	petrol'ŝip'o
petronio	petroni'o
petroselo	petrosel'o
petroselon	petrosel'o'n
peza	pez'a
pezaj	pez'a'j
pezajn	pez'a'j'n
pezan	pez'a'n
pezas	pez'as
peze	pez'e
pezi	pez'i
pezis	pez'is
pezo	pez'o
pezoj	pez'o'j
pezojn	pez'o'j'n
pezon	pez'o'n
pezos	pez'os
pezbalancita	pez'balanc'it'a
pezbalancitaj	pez'balanc'it'a'j
pezeco	pez'ec'o
pezecon	pez'ec'o'n
pezega	pez'eg'a
pezegaj	pez'eg'a'j
pezigas	pez'ig'as
pezigis	pez'ig'is
peziloj	pez'il'o'j
pezimpostaj	pez'impost'a'j
pezmetalo	pez'metal'o
pezmetaloj	pez'metal'o'j
pezmetalojn	pez'metal'o'j'n
pezocentro	pez'o'centr'o
pezoforto	pez'o'fort'o
pia	pi'a
piaj	pi'a'j
piajn	pi'a'j'n
pian	pi'a'n
pie	pi'e
pio	pi'o
piece	pi'ec'e
pieco	pi'ec'o
piecon	pi'ec'o'n
piulo	pi'ul'o
piuloj	pi'ul'o'j
piulino	pi'ul'in'o
piana	pian'a
pianan	pian'a'n
pianas	pian'as
piane	pian'e
piani	pian'i
piano	pian'o
pianoj	pian'o'j
pianon	pian'o'n
pianado	pian'ad'o
pianego	pian'eg'o
pianeto	pian'et'o
pianisto	pian'ist'o
pianistoj	pian'ist'o'j
pianiston	pian'ist'o'n
pianistino	pian'ist'in'o
pianludas	pian'lud'as
pianludi	pian'lud'i
pianludis	pian'lud'is
pianludo	pian'lud'o
pianludon	pian'lud'o'n
pianludado	pian'lud'ad'o
pianludadon	pian'lud'ad'o'n
pianomuziko	pian'o'muzik'o
pica	pic'a
pico	pic'o
picoj	pic'o'j
picojn	pic'o'j'n
picon	pic'o'n
picejo	pic'ej'o
picejon	pic'ej'o'n
piĉo	piĉ'o
piĉon	piĉ'o'n
picea	pice'a
piceo	pice'o
piceoj	pice'o'j
pieda	pied'a
piedaj	pied'a'j
piede	pied'e
piedo	pied'o
piedoj	pied'o'j
piedojn	pied'o'j'n
piedon	pied'o'n
piedartiko	pied'artik'o
piedbatas	pied'bat'as
piedbate	pied'bat'e
piedbati	pied'bat'i
piedbatis	pied'bat'is
piedbato	pied'bat'o
piedbatoj	pied'bat'o'j
piedbatojn	pied'bat'o'j'n
piedbaton	pied'bat'o'n
piedbatado	pied'bat'ad'o
piedbatante	pied'bat'ant'e
piedbatita	pied'bat'it'a
piedetoj	pied'et'o'j
piedetojn	pied'et'o'j'n
piedfingro	pied'fingr'o
piedfingroj	pied'fingr'o'j
piedfingrojn	pied'fingr'o'j'n
piedfingron	pied'fingr'o'n
piedfrapis	pied'frap'is
piedingo	pied'ing'o
piedingoj	pied'ing'o'j
piedira	pied'ir'a
piediraj	pied'ir'a'j
piediras	pied'ir'as
piedire	pied'ir'e
piediri	pied'ir'i
piediris	pied'ir'is
piediro	pied'ir'o
piediroj	pied'ir'o'j
piediron	pied'ir'o'n
piediros	pied'ir'os
piediru	pied'ir'u
piedirus	pied'ir'us
piedirado	pied'ir'ad'o
piediradon	pied'ir'ad'o'n
piediranta	pied'ir'ant'a
piedirantaj	pied'ir'ant'a'j
piedirante	pied'ir'ant'e
piediranto	pied'ir'ant'o
piedirantoj	pied'ir'ant'o'j
piedirantojn	pied'ir'ant'o'j'n
piediranton	pied'ir'ant'o'n
piedirejo	pied'ir'ej'o
piednoto	pied'not'o
piednotoj	pied'not'o'j
piednotojn	pied'not'o'j'n
piedpilka	pied'pilk'a
piedpilkaj	pied'pilk'a'j
piedpilkan	pied'pilk'a'n
piedpilkas	pied'pilk'as
piedpilki	pied'pilk'i
piedpilko	pied'pilk'o
piedpilkon	pied'pilk'o'n
piedpilkado	pied'pilk'ad'o
piedpilkadon	pied'pilk'ad'o'n
piedpilkisto	pied'pilk'ist'o
piedpilkludo	pied'pilk'lud'o
piedpinte	pied'pint'e
piedpintoj	pied'pint'o'j
piedpremas	pied'prem'as
piedpremis	pied'prem'is
piedsigno	pied'sign'o
piedsignoj	pied'sign'o'j
piedsignojn	pied'sign'o'j'n
piedsignon	pied'sign'o'n
piedsoldatoj	pied'soldat'o'j
piedspuron	pied'spur'o'n
piedtenejon	pied'ten'ej'o'n
piedvesto	pied'vest'o
piedveston	pied'vest'o'n
piedvojo	pied'voj'o
piedvojoj	pied'voj'o'j
piedvojaĝo	pied'vojaĝ'o
piedestalo	piedestal'o
piedestalon	piedestal'o'n
piemonta	piemont'a
piemonto	piemont'o
piero	pier'o
pieroto	pierot'o
pieroton	pierot'o'n
pietismo	pietism'o
pietisto	pietist'o
piezoelektra	piez'o'elektr'a
piezoelektraj	piez'o'elektr'a'j
pigo	pig'o
pigoj	pig'o'j
piĝina	piĝin'a
piĝino	piĝin'o
piĝinoj	piĝin'o'j
pigmaliono	pigmalion'o
pigmeo	pigme'o
pigmeoj	pigme'o'j
pigmento	pigment'o
pigmentoj	pigment'o'j
pigmentojn	pigment'o'j'n
pigmenton	pigment'o'n
pigmentaĵo	pigment'aĵ'o
pigra	pigr'a
pigraj	pigr'a'j
pigras	pigr'as
pigre	pigr'e
pigris	pigr'is
pigro	pigr'o
pigreco	pigr'ec'o
pigrulo	pigr'ul'o
piĵamo	piĵam'o
piĵamon	piĵam'o'n
pika	pik'a
pikaj	pik'a'j
pikan	pik'a'n
pikas	pik'as
pike	pik'e
piki	pik'i
pikis	pik'is
piko	pik'o
pikoj	pik'o'j
pikojn	pik'o'j'n
pikon	pik'o'n
piku	pik'u
pikus	pik'us
pikado	pik'ad'o
pikanta	pik'ant'a
pikantaj	pik'ant'a'j
pikantan	pik'ant'a'n
pikante	pik'ant'e
pikdoloro	pik'dolor'o
pikdrato	pik'drat'o
pikilo	pik'il'o
pikiloj	pik'il'o'j
pikilojn	pik'il'o'j'n
pikilon	pik'il'o'n
pikita	pik'it'a
pikaso	pikas'o
pikniki	piknik'i
piknikis	piknik'is
pikniko	piknik'o
piknikon	piknik'o'n
piknikos	piknik'os
pikrata	pikr'at'a
pikselo	piksel'o
pikseloj	piksel'o'j
pikselojn	piksel'o'j'n
pikselon	piksel'o'n
piktogramoj	piktogram'o'j
piktura	piktur'a
pikturo	piktur'o
pilo	pil'o
piloj	pil'o'j
pilojn	pil'o'j'n
pilon	pil'o'n
pilvivo	pil'viv'o
pilado	pilad'o
pilafo	pilaf'o
pilastro	pilastr'o
pilastroj	pilastr'o'j
pilastrojn	pilastr'o'j'n
pilato	pilat'o
pilgrima	pilgrim'a
pilgrimaj	pilgrim'a'j
pilgriman	pilgrim'a'n
pilgrimas	pilgrim'as
pilgrimi	pilgrim'i
pilgrimis	pilgrim'is
pilgrimo	pilgrim'o
pilgrimoj	pilgrim'o'j
pilgrimojn	pilgrim'o'j'n
pilgrimon	pilgrim'o'n
pilgrimado	pilgrim'ad'o
pilgrimadoj	pilgrim'ad'o'j
pilgrimadojn	pilgrim'ad'o'j'n
pilgrimadon	pilgrim'ad'o'n
pilgrimanto	pilgrim'ant'o
pilgrimantoj	pilgrim'ant'o'j
pilgrimantojn	pilgrim'ant'o'j'n
pilgrimejo	pilgrim'ej'o
pilgrimejoj	pilgrim'ej'o'j
pilgrimloko	pilgrim'lok'o
pilgrimlokoj	pilgrim'lok'o'j
pilgrimulo	pilgrim'ul'o
pilgrimuloj	pilgrim'ul'o'j
piliero	pilier'o
pilieroj	pilier'o'j
pilierojn	pilier'o'j'n
pilko	pilk'o
pilkoj	pilk'o'j
pilkojn	pilk'o'j'n
pilkon	pilk'o'n
pilketo	pilk'et'o
pilketoj	pilk'et'o'j
pilkludo	pilk'lud'o
pilolo	pilol'o
piloloj	pilol'o'j
pilolojn	pilol'o'j'n
pilolon	pilol'o'n
pilono	pilon'o
pilonoj	pilon'o'j
pilorio	pilori'o
pilota	pilot'a
pilotas	pilot'as
piloti	pilot'i
pilotis	pilot'is
piloto	pilot'o
pilotoj	pilot'o'j
pilotojn	pilot'o'j'n
piloton	pilot'o'n
pilotado	pilot'ad'o
pilotata	pilot'at'a
pilotataj	pilot'at'a'j
pilotatan	pilot'at'a'n
pilotejo	pilot'ej'o
piloteraro	pilot'erar'o
pimpa	pimp'a
pimpaj	pimp'a'j
pina	pin'a
pinaj	pin'a'j
pine	pin'e
pino	pin'o
pinoj	pin'o'j
pinon	pin'o'n
pinaro	pin'ar'o
pinaroj	pin'ar'o'j
pinarboj	pin'arb'o'j
pinarbaro	pin'arb'ar'o
pinarbaroj	pin'arb'ar'o'j
pinsemoj	pin'sem'o'j
pinakoteko	pinakotek'o
pinataj	pinat'a'j
pinĉas	pinĉ'as
pinĉi	pinĉ'i
pinĉis	pinĉ'is
pinĉo	pinĉ'o
pinĉado	pinĉ'ad'o
pinĉilo	pinĉ'il'o
pinĉiloj	pinĉ'il'o'j
pinĉilojn	pinĉ'il'o'j'n
pinĉita	pinĉ'it'a
pindaro	pindar'o
pineala	pineal'a
pinglo	pingl'o
pingloj	pingl'o'j
pinglojn	pingl'o'j'n
pinglon	pingl'o'n
pinglaro	pingl'ar'o
pingloarboj	pingl'o'arb'o'j
pinglokapo	pingl'o'kap'o
pingvenaj	pingven'a'j
pingveno	pingven'o
pingvenoj	pingven'o'j
pingvenojn	pingven'o'j'n
pingvenon	pingven'o'n
pinjino	pinjin'o
pinjono	pinjon'o
pinjonoj	pinjon'o'j
pinokjo	pinokj'o
pinta	pint'a
pintaj	pint'a'j
pintajn	pint'a'j'n
pintan	pint'a'n
pintas	pint'as
pinte	pint'e
pinti	pint'i
pintis	pint'is
pinto	pint'o
pintoj	pint'o'j
pintojn	pint'o'j'n
pinton	pint'o'n
pintado	pint'ad'o
pintakra	pint'akr'a
pintarkaj	pint'ark'a'j
pintarko	pint'ark'o
pinteca	pint'ec'a
pinthoroj	pint'hor'o'j
pintigita	pint'ig'it'a
pintigitaj	pint'ig'it'a'j
pintita	pint'it'a
pintitaj	pint'it'a'j
pintitan	pint'it'a'n
pintkonferenco	pint'konferenc'o
pintkunveno	pint'kun'ven'o
pintkunvenoj	pint'kun'ven'o'j
pintkunvenon	pint'kun'ven'o'n
pintnivela	pint'nivel'a
pintnivelaj	pint'nivel'a'j
pintokunveno	pint'o'kun'ven'o
pintokunvenon	pint'o'kun'ven'o'n
pintpostulo	pint'postul'o
pintpunkto	pint'punkt'o
pinttempo	pint'temp'o
pintuloj	pint'ul'o'j
pioĉo	pioĉ'o
pioĉoj	pioĉ'o'j
pioĉon	pioĉ'o'n
pionira	pionir'a
pioniraj	pionir'a'j
pionirajn	pionir'a'j'n
pioniran	pionir'a'n
pionire	pionir'e
pioniris	pionir'is
pioniro	pionir'o
pioniroj	pionir'o'j
pionirojn	pionir'o'j'n
pioniron	pionir'o'n
pipo	pip'o
pipoj	pip'o'j
pipojn	pip'o'j'n
pipon	pip'o'n
pipio	pipi'o
pipilo	pipil'o
pipiloj	pipil'o'j
pipino	pipin'o
pipra	pipr'a
pipro	pipr'o
piproj	pipr'o'j
pipron	pipr'o'n
piran	pir'a'n
piro	pir'o
piroj	pir'o'j
pirojn	pir'o'j'n
piron	pir'o'n
pirarbo	pir'arb'o
pirujoj	pir'uj'o'j
piramida	piramid'a
piramidaj	piramid'a'j
piramido	piramid'o
piramidoj	piramid'o'j
piramidojn	piramid'o'j'n
piramidon	piramid'o'n
piramideca	piramid'ec'a
piramidecaj	piramid'ec'a'j
piramidforma	piramid'form'a
piranjoj	piranj'o'j
pirata	pirat'a
pirataj	pirat'a'j
piratan	pirat'a'n
pirate	pirat'e
pirato	pirat'o
piratoj	pirat'o'j
piratojn	pirat'o'j'n
piratado	pirat'ad'o
piratadon	pirat'ad'o'n
pireo	pire'o
pirenea	pirene'a
pireneoj	pirene'o'j
pirho	pirh'o
piridilo	pirid'il'o
piridino	pirid'in'o
pirito	pirit'o
piritoo	pirito'o
pirofosfato	piro'fosf'at'o
pirosulfato	piro'sulf'at'o
pirogojn	pirog'o'j'n
pirolo	pirol'o
pirotekniko	piroteknik'o
piroteknikaĵo	piroteknik'aĵ'o
piroteknikaĵoj	piroteknik'aĵ'o'j
piroteknikisto	piroteknik'ist'o
pisa	pis'a
pisan	pis'a'n
pisas	pis'as
pisi	pis'i
pisis	pis'is
piso	pis'o
pistis	pist'is
pistado	pist'ad'o
pistilo	pist'il'o
pistiloj	pist'il'o'j
pistita	pist'it'a
pistitaj	pist'it'a'j
pistujo	pist'uj'o
pistujoj	pist'uj'o'j
piŝta	piŝt'a
piŝtaj	piŝt'a'j
piŝto	piŝt'o
piŝtoj	piŝt'o'j
piŝtojn	piŝt'o'j'n
piŝton	piŝt'o'n
piŝtmotoroj	piŝt'motor'o'j
pistilo	pistil'o
pistiloj	pistil'o'j
pistolo	pistol'o
pistoloj	pistol'o'j
pistolojn	pistol'o'j'n
pistolon	pistol'o'n
pitagora	pitagor'a
pitagoraj	pitagor'a'j
pitagoro	pitagor'o
pitagoranoj	pitagor'an'o'j
pitiaj	piti'a'j
pitono	piton'o
pitonoj	piton'o'j
pitoreska	pitoresk'a
pitoreskaj	pitoresk'a'j
pitoreskajn	pitoresk'a'j'n
pitoreskan	pitoresk'a'n
pitoreske	pitoresk'e
pitoreskejo	pitoresk'ej'o
pitoreskejoj	pitoresk'ej'o'j
pivota	pivot'a
pivotaj	pivot'a'j
pivotajn	pivot'a'j'n
pivotan	pivot'a'n
pivoto	pivot'o
pivotoj	pivot'o'j
pivotfortokonvertilo	pivot'fort'o'konvert'il'o
piza	piz'a
pizo	piz'o
pizoj	piz'o'j
pizojn	piz'o'j'n
pizon	piz'o'n
place	plac'e
placo	plac'o
placoj	plac'o'j
placojn	plac'o'j'n
placon	plac'o'n
placeto	plac'et'o
placetoj	plac'et'o'j
placeton	plac'et'o'n
plaĉa	plaĉ'a
plaĉaj	plaĉ'a'j
plaĉajn	plaĉ'a'j'n
plaĉan	plaĉ'a'n
plaĉas	plaĉ'as
plaĉe	plaĉ'e
plaĉi	plaĉ'i
plaĉis	plaĉ'is
placho	plaĉ'o
plaĉo	plaĉ'o
plaĉon	plaĉ'o'n
plaĉos	plaĉ'os
plaĉu	plaĉ'u
plaĉus	plaĉ'us
plaĉaspekta	plaĉ'aspekt'a
plaĉegas	plaĉ'eg'as
plaĉita	plaĉ'it'a
placenta	placent'a
placento	placent'o
plado	plad'o
pladoj	plad'o'j
pladojn	plad'o'j'n
pladon	plad'o'n
pladeton	plad'et'o'n
plafona	plafon'a
plafono	plafon'o
plafonoj	plafon'o'j
plafonojn	plafon'o'j'n
plafonon	plafon'o'n
plagas	plag'as
plagi	plag'i
plagis	plag'is
plago	plag'o
plagoj	plag'o'j
plagojn	plag'o'j'n
plagon	plag'o'n
plagu	plag'u
plagita	plag'it'a
plagitaj	plag'it'a'j
plagitajn	plag'it'a'j'n
plagitoj	plag'it'o'j
plagitojn	plag'it'o'j'n
plaĝa	plaĝ'a
plaĝaj	plaĝ'a'j
plaĝo	plaĝ'o
plaĝoj	plaĝ'o'j
plaĝojn	plaĝ'o'j'n
plaĝon	plaĝ'o'n
plagiati	plagiat'i
plagiato	plagiat'o
plako	plak'o
plakoj	plak'o'j
plana	plan'a
planaj	plan'a'j
planas	plan'as
plane	plan'e
plani	plan'i
planis	plan'is
plano	plan'o
planoj	plan'o'j
planojn	plan'o'j'n
planon	plan'o'n
planos	plan'os
planu	plan'u
planus	plan'us
planado	plan'ad'o
planadon	plan'ad'o'n
plananta	plan'ant'a
planantaj	plan'ant'a'j
planantan	plan'ant'a'n
planante	plan'ant'e
planata	plan'at'a
planataj	plan'at'a'j
planate	plan'at'e
planekonomio	plan'ekonomi'o
planisto	plan'ist'o
planistoj	plan'ist'o'j
planita	plan'it'a
planitaj	plan'it'a'j
planitajn	plan'it'a'j'n
planitan	plan'it'a'n
planite	plan'it'e
planlingva	plan'lingv'a
planlingvaj	plan'lingv'a'j
planlingvo	plan'lingv'o
planlingvoj	plan'lingv'o'j
planlingvojn	plan'lingv'o'j'n
planlingvon	plan'lingv'o'n
plansetlejoj	plan'setl'ej'o'j
plando	pland'o
plandoj	pland'o'j
plandojn	pland'o'j'n
plandon	pland'o'n
plandumo	pland'um'o
plandumoj	pland'um'o'j
plandumojn	pland'um'o'j'n
planeda	planed'a
planedaj	planed'a'j
planedajn	planed'a'j'n
planedan	planed'a'n
planedo	planed'o
planedoj	planed'o'j
planedojn	planed'o'j'n
planedon	planed'o'n
planedoscienco	planed'o'scienc'o
planedsistemoj	planed'sistem'o'j
planetario	planetari'o
planka	plank'a
planken	plank'e'n
planko	plank'o
plankoj	plank'o'j
plankojn	plank'o'j'n
plankon	plank'o'n
plankoviŝtuko	plank'o'viŝ'tuk'o
planktono	plankton'o
planktonon	plankton'o'n
planta	plant'a
plantaj	plant'a'j
plantajn	plant'a'j'n
plantan	plant'a'n
plantas	plant'as
planti	plant'i
plantis	plant'is
planto	plant'o
plantoj	plant'o'j
plantojn	plant'o'j'n
planton	plant'o'n
plantos	plant'os
plantu	plant'u
plantado	plant'ad'o
plantadoj	plant'ad'o'j
plantadon	plant'ad'o'n
plantaĵo	plant'aĵ'o
plantaĵoj	plant'aĵ'o'j
plantaĵojn	plant'aĵ'o'j'n
plantante	plant'ant'e
plantaro	plant'ar'o
plantaron	plant'ar'o'n
plantata	plant'at'a
plantĉeloj	plant'ĉel'o'j
plantdomoj	plant'dom'o'j
plantejo	plant'ej'o
plantejoj	plant'ej'o'j
plantejojn	plant'ej'o'j'n
plantejposedantoj	plant'ej'posed'ant'o'j
plantfamilio	plant'famili'o
plantfamilioj	plant'famili'o'j
plantfibroj	plant'fibr'o'j
plantgenro	plant'genr'o
plantidoj	plant'id'o'j
plantidojn	plant'id'o'j'n
plantinga	plant'ing'a
plantistoj	plant'ist'o'j
plantita	plant'it'a
plantitaj	plant'it'a'j
plantmalsanoj	plant'mal'san'o'j
plantmaterialo	plant'material'o
plantokomunumoj	plant'o'komun'um'o'j
plantomanĝanto	plant'o'manĝ'ant'o
plantomanĝantoj	plant'o'manĝ'ant'o'j
plantospecio	plant'o'speci'o
plantospecioj	plant'o'speci'o'j
plantoleo	plant'ole'o
plantoleoj	plant'ole'o'j
plantparto	plant'part'o
plantpartoj	plant'part'o'j
plantspecio	plant'speci'o
plantspecioj	plant'speci'o'j
plantvivo	plant'viv'o
plasma	plasm'a
plasmaj	plasm'a'j
plasman	plasm'a'n
plasmo	plasm'o
plasmoj	plasm'o'j
plasmon	plasm'o'n
plasmomembrano	plasm'o'membran'o
plasmido	plasmid'o
plasmidoj	plasmid'o'j
plasmodio	plasmodi'o
plasta	plast'a
plastaj	plast'a'j
plastajn	plast'a'j'n
plastan	plast'a'n
plaste	plast'e
plasto	plast'o
plastoj	plast'o'j
plastojn	plast'o'j'n
plaston	plast'o'n
plastaĵoj	plast'aĵ'o'j
plastaĵojn	plast'aĵ'o'j'n
plastiganto	plast'ig'ant'o
plastika	plastik'a
plastikaj	plastik'a'j
plastikan	plastik'a'n
plastike	plastik'e
plastiko	plastik'o
plastikaĵoj	plastik'aĵ'o'j
plastikeco	plastik'ec'o
plastikecon	plastik'ec'o'n
plastron	plastr'o'n
plata	plat'a
plataj	plat'a'j
platajn	plat'a'j'n
platan	plat'a'n
plate	plat'e
plato	plat'o
platoj	plat'o'j
platojn	plat'o'j'n
platon	plat'o'n
plataĵo	plat'aĵ'o
plataĵoj	plat'aĵ'o'j
plataĵon	plat'aĵ'o'n
platbati	plat'bat'i
platbatis	plat'bat'is
platbeka	plat'bek'a
plateco	plat'ec'o
platetoj	plat'et'o'j
platgermana	plat'german'a
platigas	plat'ig'as
platigi	plat'ig'i
platigis	plat'ig'is
platigita	plat'ig'it'a
platigitaj	plat'ig'it'a'j
platiĝas	plat'iĝ'as
platiĝis	plat'iĝ'is
platkapulo	plat'kap'ul'o
platkapuloj	plat'kap'ul'o'j
platkapulojn	plat'kap'ul'o'j'n
platotektoniko	plat'o'tekton'ik'o
platplafona	plat'plafon'a
platpremita	plat'prem'it'a
platpremitaj	plat'prem'it'a'j
plataleo	platale'o
platano	platan'o
platanoj	platan'o'j
platena	platen'a
platenaj	platen'a'j
plateno	platen'o
platforma	platform'a
platformaj	platform'a'j
platformo	platform'o
platformoj	platform'o'j
platformojn	platform'o'j'n
platformon	platform'o'n
platino	platin'o
platona	platon'a
platonaj	platon'a'j
platonan	platon'a'n
platono	platon'o
platonon	platon'o'n
platonismo	platon'ism'o
plaŭdas	plaŭd'as
plaŭdi	plaŭd'i
plaŭdis	plaŭd'is
plaŭdo	plaŭd'o
plaŭdon	plaŭd'o'n
plaŭdado	plaŭd'ad'o
plaŭto	plaŭt'o
pleba	pleb'a
plebaj	pleb'a'j
pleban	pleb'a'n
plebo	pleb'o
pleboj	pleb'o'j
plebanoj	pleb'an'o'j
plebejoj	pleb'ej'o'j
plebiscito	plebiscit'o
plebisciton	plebiscit'o'n
pledas	pled'as
pledi	pled'i
pledis	pled'is
pledo	pled'o
pledoj	pled'o'j
pledojn	pled'o'j'n
pledon	pled'o'n
pledado	pled'ad'o
pledante	pled'ant'e
pledanto	pled'ant'o
pledantoj	pled'ant'o'j
pleistoceno	pleistocen'o
plej	plej
pleja	plej'a
plejaj	plej'a'j
plejan	plej'a'n
pleje	plej'e
plejo	plej'o
plejaĝa	plej'aĝ'a
plejaĝulo	plej'aĝ'ul'o
plejaĝuloj	plej'aĝ'ul'o'j
plejalta	plej'alt'a
plejaltulo	plej'alt'ul'o
plejamata	plej'am'at'a
plejantaŭa	plej'antaŭ'a
plejbona	plej'bon'a
plejbone	plej'bon'e
plejbono	plej'bon'o
plejbonon	plej'bon'o'n
plejboneco	plej'bon'ec'o
plejbonecon	plej'bon'ec'o'n
plejebla	plej'ebl'a
plejeblan	plej'ebl'a'n
plejeble	plej'ebl'e
plejeblon	plej'ebl'o'n
plejfoje	plej'foj'e
plejgranda	plej'grand'a
plejmultaj	plej'mult'a'j
plejmulte	plej'mult'e
plejmulto	plej'mult'o
plejmulton	plej'mult'o'n
plejofte	plej'oft'e
plejparta	plej'part'a
plejpartaj	plej'part'a'j
plejparte	plej'part'e
plejparto	plej'part'o
plejpartoj	plej'part'o'j
plejparton	plej'part'o'n
plejpotenca	plej'potenc'a
plejpotenculo	plej'potenc'ul'o
plejsankta	plej'sankt'a
plejsupera	plej'super'a
plejsupra	plej'supr'a
plejverŝajne	plej'ver'ŝajn'e
plejadoj	plejad'o'j
plejstocena	plejstocen'a
plejstoceno	plejstocen'o
plektas	plekt'as
plekti	plekt'i
plektis	plekt'is
plektado	plekt'ad'o
plektaĵo	plekt'aĵ'o
plektaĵoj	plekt'aĵ'o'j
plektaĵojn	plekt'aĵ'o'j'n
plektaĵon	plekt'aĵ'o'n
plektita	plekt'it'a
plektitaj	plekt'it'a'j
plektitan	plekt'it'a'n
plektro	plektr'o
plena	plen'a
plenaj	plen'a'j
plenajn	plen'a'j'n
plenan	plen'a'n
plenas	plen'as
plene	plen'e
plenis	plen'is
pleno	plen'o
plenon	plen'o'n
plenaĝa	plen'aĝ'a
plenaĝaj	plen'aĝ'a'j
plenaĝan	plen'aĝ'a'n
plenaĝeco	plen'aĝ'ec'o
plenaĝecon	plen'aĝ'ec'o'n
plenaĝulo	plen'aĝ'ul'o
plenaghuloj	plen'aĝ'ul'o'j
plenaĝuloj	plen'aĝ'ul'o'j
plenblovebla	plen'blov'ebl'a
plenbloveblaj	plen'blov'ebl'a'j
plenblovita	plen'blov'it'a
plenblovitaj	plen'blov'it'a'j
pleneco	plen'ec'o
plenecon	plen'ec'o'n
plenega	plen'eg'a
plenforte	plen'fort'e
plengorĝe	plen'gorĝ'e
plenigas	plen'ig'as
plenigi	plen'ig'i
plenigis	plen'ig'is
plenigo	plen'ig'o
plenigos	plen'ig'os
plenigu	plen'ig'u
plenigus	plen'ig'us
plenigadis	plen'ig'ad'is
plenigado	plen'ig'ad'o
plenigaĵo	plen'ig'aĵ'o
plenigaĵoj	plen'ig'aĵ'o'j
plenigaĵon	plen'ig'aĵ'o'n
pleniganta	plen'ig'ant'a
plenigantaj	plen'ig'ant'a'j
plenigante	plen'ig'ant'e
plenigata	plen'ig'at'a
pleniginta	plen'ig'int'a
pleniginte	plen'ig'int'e
plenigita	plen'ig'it'a
plenigitaj	plen'ig'it'a'j
plenigitajn	plen'ig'it'a'j'n
plenigitan	plen'ig'it'a'n
plenigite	plen'ig'it'e
pleniĝas	plen'iĝ'as
pleniĝis	plen'iĝ'is
pleniĝos	plen'iĝ'os
plenkonscie	plen'konsci'e
plenkore	plen'kor'e
plenkreska	plen'kresk'a
plenkreskaj	plen'kresk'a'j
plenkreskajn	plen'kresk'a'j'n
plenkreskan	plen'kresk'a'n
plenkreskas	plen'kresk'as
plenkreskis	plen'kresk'is
plenkresko	plen'kresk'o
plenkreskos	plen'kresk'os
plenkreskiĝis	plen'kresk'iĝ'is
plenkreskinta	plen'kresk'int'a
plenkreskinte	plen'kresk'int'e
plenkreskula	plen'kresk'ul'a
plenkreskulaj	plen'kresk'ul'a'j
plenkreskulan	plen'kresk'ul'a'n
plenkreskulo	plen'kresk'ul'o
plenkreskuloj	plen'kresk'ul'o'j
plenkreskulojn	plen'kresk'ul'o'j'n
plenkreskulon	plen'kresk'ul'o'n
plenkunsido	plen'kun'sid'o
plenkunsidoj	plen'kun'sid'o'j
plenlonga	plen'long'a
plenlongaj	plen'long'a'j
plenlongan	plen'long'a'n
plenluna	plen'lun'a
plenluno	plen'lun'o
plenmano	plen'man'o
plenmanon	plen'man'o'n
plenmezura	plen'mezur'a
plenmezuraj	plen'mezur'a'j
plenmezure	plen'mezur'e
plennome	plen'nom'e
plenplena	plen'plen'a
plenplenaj	plen'plen'a'j
plenplenan	plen'plen'a'n
plenplenas	plen'plen'as
plenplene	plen'plen'e
plenplenis	plen'plen'is
plenplenigis	plen'plen'ig'is
plenpulme	plen'pulm'e
plenrajta	plen'rajt'a
plenrajtaj	plen'rajt'a'j
plenrajte	plen'rajt'e
plenrapide	plen'rapid'e
plenskala	plen'skal'a
plenskalaj	plen'skal'a'j
plenskalan	plen'skal'a'n
plenŝtopis	plen'ŝtop'is
plenŝtopita	plen'ŝtop'it'a
plenŝtopitaj	plen'ŝtop'it'a'j
plentaŭga	plen'taŭg'a
plentaŭgaj	plen'taŭg'a'j
plentaŭgan	plen'taŭg'a'n
plentempa	plen'temp'a
plentempaj	plen'temp'a'j
plentempajn	plen'temp'a'j'n
plentempan	plen'temp'a'n
plentempe	plen'temp'e
plentona	plen'ton'a
plenuma	plen'um'a
plenumaj	plen'um'a'j
plenumajn	plen'um'a'j'n
plenuman	plen'um'a'n
plenumas	plen'um'as
plenumi	plen'um'i
plenumis	plen'um'is
plenumo	plen'um'o
plenumoj	plen'um'o'j
plenumojn	plen'um'o'j'n
plenumon	plen'um'o'n
plenumos	plen'um'os
plenumu	plen'um'u
plenumus	plen'um'us
plenumadi	plen'um'ad'i
plenumadis	plen'um'ad'is
plenumado	plen'um'ad'o
plenumadon	plen'um'ad'o'n
plenumanta	plen'um'ant'a
plenumantaj	plen'um'ant'a'j
plenumante	plen'um'ant'e
plenumanto	plen'um'ant'o
plenumantoj	plen'um'ant'o'j
plenumata	plen'um'at'a
plenumataj	plen'um'at'a'j
plenumebla	plen'um'ebl'a
plenumeblaj	plen'um'ebl'a'j
plenumeblan	plen'um'ebl'a'n
plenumenda	plen'um'end'a
plenumendaj	plen'um'end'a'j
plenumendan	plen'um'end'a'n
plenumigi	plen'um'ig'i
plenumiĝas	plen'um'iĝ'as
plenumiĝi	plen'um'iĝ'i
plenumiĝis	plen'um'iĝ'is
plenumiĝo	plen'um'iĝ'o
plenumiĝon	plen'um'iĝ'o'n
plenumiĝos	plen'um'iĝ'os
plenumiĝu	plen'um'iĝ'u
plenuminta	plen'um'int'a
plenuminte	plen'um'int'e
plenumita	plen'um'it'a
plenumitaj	plen'um'it'a'j
plenumitan	plen'um'it'a'n
plenumkomitato	plen'um'komitat'o
plenumkomitaton	plen'um'komitat'o'n
plenumota	plen'um'ot'a
plenvalora	plen'valor'a
plenvoĉe	plen'voĉ'e
plenda	plend'a
plendan	plend'a'n
plendas	plend'as
plende	plend'e
plendi	plend'i
plendis	plend'is
plendo	plend'o
plendoj	plend'o'j
plendojn	plend'o'j'n
plendon	plend'o'n
plendos	plend'os
plendu	plend'u
plendus	plend'us
plendadas	plend'ad'as
plendado	plend'ad'o
plendadon	plend'ad'o'n
plendanta	plend'ant'a
plendante	plend'ant'e
plendanto	plend'ant'o
plendantoj	plend'ant'o'j
plendema	plend'em'a
pleonasma	pleonasm'a
pleonasmo	pleonasm'o
pleto	plet'o
pletoj	plet'o'j
pletojn	plet'o'j'n
pleton	plet'o'n
pleŭra	pleŭr'a
pleŭro	pleŭr'o
plezura	plezur'a
plezuraj	plezur'a'j
plezuran	plezur'a'n
plezuras	plezur'as
plezure	plezur'e
plezuro	plezur'o
plezuroj	plezur'o'j
plezurojn	plezur'o'j'n
plezuron	plezur'o'n
plezurege	plezur'eg'e
plezurego	plezur'eg'o
plezurĝardeno	plezur'ĝarden'o
plezuriga	plezur'ig'a
plezurigaj	plezur'ig'a'j
plezurigan	plezur'ig'a'n
plezurigas	plezur'ig'as
plezurige	plezur'ig'e
plezurigi	plezur'ig'i
plezurigis	plezur'ig'is
plezurigos	plezur'ig'os
plezurkrozado	plezur'kroz'ad'o
pli	pli
plia	pli'a
pliaj	pli'a'j
pliajn	pli'a'j'n
plian	pli'a'n
plie	pli'e
pliafoje	pli'a'foj'e
pliaĝa	pli'aĝ'a
pliaĝaj	pli'aĝ'a'j
pliaĝan	pli'aĝ'a'n
pliaghulo	pli'aĝ'ul'o
pliaĝulo	pli'aĝ'ul'o
pliaĝuloj	pli'aĝ'ul'o'j
pliaĝulojn	pli'aĝ'ul'o'j'n
pliakrigis	pli'akr'ig'is
pliakriĝis	pli'akr'iĝ'is
plialtigas	pli'alt'ig'as
plialtigi	pli'alt'ig'i
plialtigis	pli'alt'ig'is
plialtigo	pli'alt'ig'o
plialtigon	pli'alt'ig'o'n
plialtigos	pli'alt'ig'os
plialtigu	pli'alt'ig'u
plialtigante	pli'alt'ig'ant'e
plialtigita	pli'alt'ig'it'a
plialtiĝas	pli'alt'iĝ'as
plialtiĝis	pli'alt'iĝ'is
plialtiĝo	pli'alt'iĝ'o
plialtiĝon	pli'alt'iĝ'o'n
plialtiĝos	pli'alt'iĝ'os
pliampleksigi	pli'ampleks'ig'i
pliampleksigis	pli'ampleks'ig'is
pliampleksigo	pli'ampleks'ig'o
plibeligas	pli'bel'ig'as
plibeligi	pli'bel'ig'i
plibeligis	pli'bel'ig'is
plibeligo	pli'bel'ig'o
plibeligoj	pli'bel'ig'o'j
plibeligita	pli'bel'ig'it'a
plibeligitaj	pli'bel'ig'it'a'j
plibona	pli'bon'a
plibonan	pli'bon'a'n
plibonas	pli'bon'as
plibone	pli'bon'e
plibono	pli'bon'o
plibonigaj	pli'bon'ig'a'j
plibonigas	pli'bon'ig'as
plibonigi	pli'bon'ig'i
plibonigis	pli'bon'ig'is
plibonigo	pli'bon'ig'o
plibonigoj	pli'bon'ig'o'j
plibonigojn	pli'bon'ig'o'j'n
plibonigon	pli'bon'ig'o'n
plibonigos	pli'bon'ig'os
plibonigu	pli'bon'ig'u
plibonigus	pli'bon'ig'us
plibonigado	pli'bon'ig'ad'o
plibonigadon	pli'bon'ig'ad'o'n
pliboniganta	pli'bon'ig'ant'a
plibonigante	pli'bon'ig'ant'e
plibonigata	pli'bon'ig'at'a
plibonigebla	pli'bon'ig'ebl'a
plibonigenda	pli'bon'ig'end'a
plibonigita	pli'bon'ig'it'a
plibonigitaj	pli'bon'ig'it'a'j
plibonigitajn	pli'bon'ig'it'a'j'n
plibonigitan	pli'bon'ig'it'a'n
pliboniĝas	pli'bon'iĝ'as
pliboniĝi	pli'bon'iĝ'i
pliboniĝis	pli'bon'iĝ'is
pliboniĝo	pli'bon'iĝ'o
pliboniĝoj	pli'bon'iĝ'o'j
pliboniĝon	pli'bon'iĝ'o'n
pliboniĝos	pli'bon'iĝ'os
pliboniĝu	pli'bon'iĝ'u
pliboniĝus	pli'bon'iĝ'us
pliefikigi	pli'efik'ig'i
plievoluinta	pli'evolu'int'a
plievoluintaj	pli'evolu'int'a'j
plifaciligas	pli'facil'ig'as
plifaciligi	pli'facil'ig'i
plifaciligis	pli'facil'ig'is
plifaciligo	pli'facil'ig'o
plifaciligos	pli'facil'ig'os
plifaciligus	pli'facil'ig'us
plifirmigas	pli'firm'ig'as
plifirmigi	pli'firm'ig'i
plifirmigis	pli'firm'ig'is
plifirmigo	pli'firm'ig'o
plifirmigado	pli'firm'ig'ad'o
plifirmigante	pli'firm'ig'ant'e
plifirmigita	pli'firm'ig'it'a
plifirmigitaj	pli'firm'ig'it'a'j
plifortigas	pli'fort'ig'as
plifortigi	pli'fort'ig'i
plifortigis	pli'fort'ig'is
plifortigo	pli'fort'ig'o
plifortigon	pli'fort'ig'o'n
plifortigos	pli'fort'ig'os
plifortigu	pli'fort'ig'u
plifortigus	pli'fort'ig'us
plifortigado	pli'fort'ig'ad'o
plifortigante	pli'fort'ig'ant'e
plifortigita	pli'fort'ig'it'a
plifortigitaj	pli'fort'ig'it'a'j
plifortigitajn	pli'fort'ig'it'a'j'n
plifortigitan	pli'fort'ig'it'a'n
plifortiĝas	pli'fort'iĝ'as
plifortiĝi	pli'fort'iĝ'i
plifortiĝis	pli'fort'iĝ'is
plifortiĝo	pli'fort'iĝ'o
plifortikigas	pli'fortik'ig'as
plifortikigi	pli'fortik'ig'i
plifortikigis	pli'fortik'ig'is
plifortikigo	pli'fortik'ig'o
plifortikigoj	pli'fortik'ig'o'j
plifortikigojn	pli'fortik'ig'o'j'n
plifortikigon	pli'fortik'ig'o'n
plifortikigado	pli'fortik'ig'ad'o
plifortikigante	pli'fortik'ig'ant'e
plifortikigita	pli'fortik'ig'it'a
plifortikigitaj	pli'fortik'ig'it'a'j
plifrue	pli'fru'e
pligranda	pli'grand'a
pligrandan	pli'grand'a'n
pligrandigas	pli'grand'ig'as
pligrandigi	pli'grand'ig'i
pligrandigis	pli'grand'ig'is
pligrandigo	pli'grand'ig'o
pligrandigon	pli'grand'ig'o'n
pligrandigos	pli'grand'ig'os
pligrandigu	pli'grand'ig'u
pligrandigado	pli'grand'ig'ad'o
pligrandigante	pli'grand'ig'ant'e
pligrandigita	pli'grand'ig'it'a
pligrandigitaj	pli'grand'ig'it'a'j
pligrandigitan	pli'grand'ig'it'a'n
pligrandiĝas	pli'grand'iĝ'as
pligrandiĝi	pli'grand'iĝ'i
pligrandiĝis	pli'grand'iĝ'is
pligrandiĝo	pli'grand'iĝ'o
pligrandiĝon	pli'grand'iĝ'o'n
pligrandiĝos	pli'grand'iĝ'os
pligrandiĝanta	pli'grand'iĝ'ant'a
pligrandiĝinta	pli'grand'iĝ'int'a
pligravigas	pli'grav'ig'as
pligravigi	pli'grav'ig'i
pligravigis	pli'grav'ig'is
pligraviĝas	pli'grav'iĝ'as
pligraviĝis	pli'grav'iĝ'is
pliĝuste	pli'ĝust'e
pliiga	pli'ig'a
pliigaj	pli'ig'a'j
pliigan	pli'ig'a'n
pliigas	pli'ig'as
pliige	pli'ig'e
pliigi	pli'ig'i
pliigis	pli'ig'is
pliigo	pli'ig'o
pliigoj	pli'ig'o'j
pliigojn	pli'ig'o'j'n
pliigon	pli'ig'o'n
pliigos	pli'ig'os
pliigu	pli'ig'u
pliigus	pli'ig'us
pliigado	pli'ig'ad'o
pliiganta	pli'ig'ant'a
pliigantaj	pli'ig'ant'a'j
pliigantan	pli'ig'ant'a'n
pliigante	pli'ig'ant'e
pliigita	pli'ig'it'a
pliigitaj	pli'ig'it'a'j
pliigitajn	pli'ig'it'a'j'n
pliigitan	pli'ig'it'a'n
pliiĝa	pli'iĝ'a
pliiĝaj	pli'iĝ'a'j
pliiĝas	pli'iĝ'as
pliiĝi	pli'iĝ'i
pliiĝis	pli'iĝ'is
pliiĝo	pli'iĝ'o
pliiĝoj	pli'iĝ'o'j
pliiĝojn	pli'iĝ'o'j'n
pliiĝon	pli'iĝ'o'n
pliiĝos	pli'iĝ'os
pliiĝus	pli'iĝ'us
pliiĝado	pli'iĝ'ad'o
pliiĝanta	pli'iĝ'ant'a
pliiĝantaj	pli'iĝ'ant'a'j
pliiĝantan	pli'iĝ'ant'a'n
pliiĝante	pli'iĝ'ant'e
pliiĝinta	pli'iĝ'int'a
pliintensiĝo	pli'intens'iĝ'o
plijuna	pli'jun'a
plijuniĝis	pli'jun'iĝ'is
pliklarigi	pli'klar'ig'i
pliklarigis	pli'klar'ig'is
plikuraĝigu	pli'kuraĝ'ig'u
plilarĝigas	pli'larĝ'ig'as
plilarĝigi	pli'larĝ'ig'i
plilarĝigis	pli'larĝ'ig'is
plilarĝigo	pli'larĝ'ig'o
plilarĝigon	pli'larĝ'ig'o'n
plilarĝigado	pli'larĝ'ig'ad'o
plilarĝigita	pli'larĝ'ig'it'a
plilarĝigitaj	pli'larĝ'ig'it'a'j
plilarĝiĝas	pli'larĝ'iĝ'as
plilarĝiĝis	pli'larĝ'iĝ'is
plilaŭtigis	pli'laŭt'ig'is
plilaŭtiĝis	pli'laŭt'iĝ'is
plilongigas	pli'long'ig'as
plilongigi	pli'long'ig'i
plilongigis	pli'long'ig'is
plilongigo	pli'long'ig'o
plilongigoj	pli'long'ig'o'j
plilongigon	pli'long'ig'o'n
plilongigado	pli'long'ig'ad'o
plilongigante	pli'long'ig'ant'e
plilongigita	pli'long'ig'it'a
plilongigitaj	pli'long'ig'it'a'j
plilongigitajn	pli'long'ig'it'a'j'n
plilongigitan	pli'long'ig'it'a'n
plilongiĝas	pli'long'iĝ'as
plilongiĝis	pli'long'iĝ'is
plimalpli	pli'mal'pli
plimalbonigas	pli'mal'bon'ig'as
plimalbonigi	pli'mal'bon'ig'i
plimalbonigis	pli'mal'bon'ig'is
plimalbonigado	pli'mal'bon'ig'ad'o
plimalbonigita	pli'mal'bon'ig'it'a
plimalbonigitaj	pli'mal'bon'ig'it'a'j
plimalboniĝas	pli'mal'bon'iĝ'as
plimalboniĝi	pli'mal'bon'iĝ'i
plimalboniĝis	pli'mal'bon'iĝ'is
plimalboniĝo	pli'mal'bon'iĝ'o
plimalboniĝon	pli'mal'bon'iĝ'o'n
plimulta	pli'mult'a
plimultaj	pli'mult'a'j
plimultajn	pli'mult'a'j'n
plimultan	pli'mult'a'n
plimultas	pli'mult'as
plimulte	pli'mult'e
plimultis	pli'mult'is
plimulto	pli'mult'o
plimultoj	pli'mult'o'j
plimultojn	pli'mult'o'j'n
plimulton	pli'mult'o'n
plimultigas	pli'mult'ig'as
plimultigi	pli'mult'ig'i
plimultigis	pli'mult'ig'is
plimultigo	pli'mult'ig'o
plimultiĝas	pli'mult'iĝ'as
plimultiĝis	pli'mult'iĝ'is
plimultiĝo	pli'mult'iĝ'o
plimultita	pli'mult'it'a
plimultitaj	pli'mult'it'a'j
plinombriĝis	pli'nombr'iĝ'is
pliofte	pli'oft'e
plioftiĝas	pli'oft'iĝ'as
pliparte	pli'part'e
pliparto	pli'part'o
pliparton	pli'part'o'n
pliperfektigi	pli'perfekt'ig'i
plipezigis	pli'pez'ig'is
plipezigos	pli'pez'ig'os
plipeziĝis	pli'pez'iĝ'is
plipeziĝo	pli'pez'iĝ'o
pliposte	pli'post'e
pliprecize	pli'preciz'e
pliprecizigi	pli'preciz'ig'i
pliproduktado	pli'produkt'ad'o
pliprofundigas	pli'profund'ig'as
pliprofundigi	pli'profund'ig'i
pliprofundigis	pli'profund'ig'is
pliprofundigo	pli'profund'ig'o
pliprofundigon	pli'profund'ig'o'n
pliproksimigas	pli'proksim'ig'as
pliproksimigi	pli'proksim'ig'i
pliproksimiĝi	pli'proksim'iĝ'i
pliproksimiĝis	pli'proksim'iĝ'is
pliproksimiĝo	pli'proksim'iĝ'o
plirapide	pli'rapid'e
plirapidigas	pli'rapid'ig'as
plirapidigi	pli'rapid'ig'i
plirapidigis	pli'rapid'ig'is
plirapidigo	pli'rapid'ig'o
plirapidigos	pli'rapid'ig'os
plirapidiĝis	pli'rapid'iĝ'is
pliriĉigas	pli'riĉ'ig'as
pliriĉigi	pli'riĉ'ig'i
pliriĉigis	pli'riĉ'ig'is
pliriĉigo	pli'riĉ'ig'o
pliriĉigon	pli'riĉ'ig'o'n
pliriĉigita	pli'riĉ'ig'it'a
pliriĉiĝas	pli'riĉ'iĝ'as
pliriĉiĝis	pli'riĉ'iĝ'is
pliriĉiĝo	pli'riĉ'iĝ'o
pliseverigas	pli'sever'ig'as
pliseverigi	pli'sever'ig'i
pliseverigis	pli'sever'ig'is
pliseverigita	pli'sever'ig'it'a
pliseverigitaj	pli'sever'ig'it'a'j
plisimpligi	pli'simpl'ig'i
plivalorigo	pli'valor'ig'o
plivarmiĝas	pli'varm'iĝ'as
plivarmiĝo	pli'varm'iĝ'o
plivastigas	pli'vast'ig'as
plivastigi	pli'vast'ig'i
plivastigis	pli'vast'ig'is
plivastigo	pli'vast'ig'o
plivastigon	pli'vast'ig'o'n
plivastigos	pli'vast'ig'os
plivastigata	pli'vast'ig'at'a
plivastigita	pli'vast'ig'it'a
plivastiĝas	pli'vast'iĝ'as
plivastiĝis	pli'vast'iĝ'is
plivastiĝo	pli'vast'iĝ'o
plivigligi	pli'vigl'ig'i
plivigligis	pli'vigl'ig'is
plivole	pli'vol'e
plinio	plini'o
plioceno	pliocen'o
plonĝas	plonĝ'as
plonĝi	plonĝ'i
plonĝis	plonĝ'is
plonĝo	plonĝ'o
plonĝoj	plonĝ'o'j
plonĝado	plonĝ'ad'o
plonĝadon	plonĝ'ad'o'n
plonĝante	plonĝ'ant'e
plonĝanto	plonĝ'ant'o
plonĝantomalsano	plonĝ'ant'o'mal'san'o
plonĝisto	plonĝ'ist'o
plonĝistoj	plonĝ'ist'o'j
plora	plor'a
ploras	plor'as
plore	plor'e
plori	plor'i
ploris	plor'is
ploro	plor'o
ploroj	plor'o'j
plorojn	plor'o'j'n
ploron	plor'o'n
ploros	plor'os
ploru	plor'u
plorus	plor'us
ploradas	plor'ad'as
ploradis	plor'ad'is
plorado	plor'ad'o
ploradon	plor'ad'o'n
ploranta	plor'ant'a
plorantaj	plor'ant'a'j
plorantan	plor'ant'a'n
plorante	plor'ant'e
ploregas	plor'eg'as
ploregi	plor'eg'i
ploregis	plor'eg'is
plorego	plor'eg'o
ploregante	plor'eg'ant'e
plorema	plor'em'a
ploremon	plor'em'o'n
ploretis	plor'et'is
plorigas	plor'ig'as
plorigi	plor'ig'i
plorigis	plor'ig'is
plorinda	plor'ind'a
plorkriis	plor'kri'is
plorsingultis	plor'singult'is
plotino	plotin'o
plu	plu
plua	plu'a
pluaj	plu'a'j
pluajn	plu'a'j'n
pluan	plu'a'n
pluas	plu'as
plue	plu'e
pluen	plu'e'n
pluis	plu'is
pluapaŝa	plu'a'paŝ'a
pluapaŝan	plu'a'paŝ'a'n
pluapaŝe	plu'a'paŝ'e
pludaŭras	plu'daŭr'as
pludaŭri	plu'daŭr'i
pludaŭris	plu'daŭr'is
pludiris	plu'dir'is
pludonas	plu'don'as
pludoni	plu'don'i
pludonis	plu'don'is
pludonita	plu'don'it'a
pludonitaj	plu'don'it'a'j
pluekzistas	plu'ekzist'as
pluekzisti	plu'ekzist'i
pluekzisto	plu'ekzist'o
pluekziston	plu'ekzist'o'n
pluekzistanta	plu'ekzist'ant'a
pluekzistantaj	plu'ekzist'ant'a'j
pluestas	plu'est'as
pluestis	plu'est'is
pluevoluis	plu'evolu'is
pluevoluo	plu'evolu'o
pluevoluigi	plu'evolu'ig'i
pluevoluigis	plu'evolu'ig'is
pluevoluigo	plu'evolu'ig'o
pluevoluigon	plu'evolu'ig'o'n
pluhavas	plu'hav'as
pluhavi	plu'hav'i
pluigas	plu'ig'as
pluigi	plu'ig'i
pluigis	plu'ig'is
pluiras	plu'ir'as
pluiri	plu'ir'i
pluiris	plu'ir'is
pluiros	plu'ir'os
pluiru	plu'ir'u
pluirante	plu'ir'ant'e
plulaboris	plu'labor'is
plulerni	plu'lern'i
plulernis	plu'lern'is
plumarŝis	plu'marŝ'is
plurestas	plu'rest'as
plusendas	plu'send'as
plusendi	plu'send'i
plusendis	plu'send'is
plusendo	plu'send'o
plusendoj	plu'send'o'j
plusendos	plu'send'os
plusendado	plu'send'ad'o
plusendanta	plu'send'ant'a
plusendante	plu'send'ant'e
plusendita	plu'send'it'a
plusenditaj	plu'send'it'a'j
plutenas	plu'ten'as
pluteni	plu'ten'i
plutenis	plu'ten'is
pluveturis	plu'vetur'is
pluviva	plu'viv'a
pluvivaj	plu'viv'a'j
pluvivajn	plu'viv'a'j'n
pluvivan	plu'viv'a'n
pluvivas	plu'viv'as
pluvivi	plu'viv'i
pluvivis	plu'viv'is
pluvivo	plu'viv'o
pluvivon	plu'viv'o'n
pluvivos	plu'viv'os
pluvivu	plu'viv'u
pluvivus	plu'viv'us
pluvivado	plu'viv'ad'o
pluvivanta	plu'viv'ant'a
pluvivantaj	plu'viv'ant'a'j
pluvivanto	plu'viv'ant'o
pluvivantoj	plu'viv'ant'o'j
pluvivantojn	plu'viv'ant'o'j'n
pluvivinta	plu'viv'int'a
plugas	plug'as
plugi	plug'i
plugis	plug'is
plugadis	plug'ad'is
plugado	plug'ad'o
plugadon	plug'ad'o'n
pluganta	plug'ant'a
plugilo	plug'il'o
plugiloj	plug'il'o'j
plugilojn	plug'il'o'j'n
plugilon	plug'il'o'n
plugita	plug'it'a
plugitaj	plug'it'a'j
plugtero	plug'ter'o
plukas	pluk'as
pluki	pluk'i
plukis	pluk'is
pluku	pluk'u
plukado	pluk'ad'o
plukante	pluk'ant'e
plukinstrumentoj	pluk'instrument'o'j
plukita	pluk'it'a
plukitaj	pluk'it'a'j
pluma	plum'a
plumaj	plum'a'j
plume	plum'e
plumo	plum'o
plumoj	plum'o'j
plumojn	plum'o'j'n
plumon	plum'o'n
plumaro	plum'ar'o
plumaroj	plum'ar'o'j
plumarojn	plum'ar'o'j'n
plumaron	plum'ar'o'n
plumecaj	plum'ec'a'j
plumita	plum'it'a
plumnomo	plum'nom'o
plumoŝanĝado	plum'o'ŝanĝ'ad'o
plumŝanĝo	plum'ŝanĝ'o
plumba	plumb'a
plumbaj	plumb'a'j
plumban	plumb'a'n
plumbe	plumb'e
plumbo	plumb'o
plumboj	plumb'o'j
plumbojn	plumb'o'j'n
plumbon	plumb'o'n
plumbisto	plumb'ist'o
plumbomalkovro	plumb'o'mal'kovr'o
plumpa	plump'a
plumpan	plump'a'n
plumpinto	plump'int'o
plumpintoj	plump'int'o'j
plura	plur'a
pluraj	plur'a'j
plurajn	plur'a'j'n
pluran	plur'a'n
plurcent	plur'cent
plurmil	plur'mil
plurangula	plur'angul'a
plurangulo	plur'angul'o
pluranguloj	plur'angul'o'j
plurdimensia	plur'dimensi'a
plurdimensiaj	plur'dimensi'a'j
plureco	plur'ec'o
plurecon	plur'ec'o'n
pluredro	plur'edr'o
pluredroj	plur'edr'o'j
pluredron	plur'edr'o'n
plurelekta	plur'elekt'a
pluretaĝa	plur'etaĝ'a
pluretna	plur'etn'a
plurfaceta	plur'fac'et'a
plurflanka	plur'flank'a
plurflankaj	plur'flank'a'j
plurflankajn	plur'flank'a'j'n
plurflankan	plur'flank'a'n
plurflanke	plur'flank'e
plurfoja	plur'foj'a
plurfoje	plur'foj'e
plurisma	plur'ism'a
plurismo	plur'ism'o
plurismon	plur'ism'o'n
plurjara	plur'jar'a
plurjaraj	plur'jar'a'j
plurjaran	plur'jar'a'n
plurjare	plur'jar'e
plurjarcenta	plur'jar'cent'a
plurkolora	plur'kolor'a
plurkoloraj	plur'kolor'a'j
plurkultura	plur'kultur'a
plurkvadratoj	plur'kvadrat'o'j
plurlatera	plur'later'a
plurlateraj	plur'later'a'j
plurlatero	plur'later'o
plurlateroj	plur'later'o'j
plurlingva	plur'lingv'a
plurlingvaj	plur'lingv'a'j
plurlingvajn	plur'lingv'a'j'n
plurlingvan	plur'lingv'a'n
plurlingve	plur'lingv'e
plurlingveco	plur'lingv'ec'o
plurlingvecon	plur'lingv'ec'o'n
plurlingvismo	plur'lingv'ism'o
plurloke	plur'lok'e
plurludanta	plur'lud'ant'a
plurludantaj	plur'lud'ant'a'j
plurmaniere	plur'manier'e
plurmedia	plur'medi'a
plurmediaj	plur'medi'a'j
plurmedio	plur'medi'o
plurmonata	plur'monat'a
plurnacia	plur'naci'a
plurnaciaj	plur'naci'a'j
plurnivela	plur'nivel'a
plurnivelaj	plur'nivel'a'j
plurnoma	plur'nom'a
plurobla	plur'obl'a
pluroble	plur'obl'e
plurope	plur'op'e
pluropo	plur'op'o
pluropon	plur'op'o'n
plurpartia	plur'parti'a
plurpartian	plur'parti'a'n
plursenca	plur'senc'a
plursignifa	plur'signif'a
plursilabaj	plur'silab'a'j
plurspecaj	plur'spec'a'j
plurstadia	plur'stadi'a
plurtaga	plur'tag'a
plurtavola	plur'tavol'a
plurtavolaj	plur'tavol'a'j
plurtavolan	plur'tavol'a'n
plurvoĉa	plur'voĉ'a
plurala	plural'a
pluralaj	plural'a'j
pluralajn	plural'a'j'n
pluralan	plural'a'n
plurale	plural'e
pluralo	plural'o
pluraloj	plural'o'j
pluralojn	plural'o'j'n
pluralon	plural'o'n
pluraleco	plural'ec'o
plus	plus
plusa	plus'a
plusaj	plus'a'j
pluse	plus'e
pluso	plus'o
plusoj	plus'o'j
plusojn	plus'o'j'n
pluson	plus'o'n
plussigno	plus'sign'o
plusvaloro	plus'valor'o
plusvaloron	plus'valor'o'n
pluŝa	pluŝ'a
pluŝan	pluŝ'a'n
pluŝo	pluŝ'o
pluskvamperfekto	pluskvamperfekt'o
pluto	plut'o
plutarko	plutark'o
plutokrato	plutokrat'o
plutokratio	plutokrat'i'o
plutono	pluton'o
plutonon	pluton'o'n
plutonio	plutoni'o
plutonion	plutoni'o'n
pluva	pluv'a
pluvaj	pluv'a'j
pluvan	pluv'a'n
pluvas	pluv'as
pluve	pluv'e
pluvi	pluv'i
pluvis	pluv'is
pluvo	pluv'o
pluvoj	pluv'o'j
pluvojn	pluv'o'j'n
pluvon	pluv'o'n
pluvos	pluv'os
pluvus	pluv'us
pluvadas	pluv'ad'as
pluvadis	pluv'ad'is
pluvado	pluv'ad'o
pluvakvo	pluv'akv'o
pluvakvon	pluv'akv'o'n
pluvarbara	pluv'arb'ar'a
pluvarbaro	pluv'arb'ar'o
pluvarbaroj	pluv'arb'ar'o'j
pluvarbarojn	pluv'arb'ar'o'j'n
pluvegas	pluv'eg'as
pluvegis	pluv'eg'is
pluvego	pluv'eg'o
pluvegoj	pluv'eg'o'j
pluvegojn	pluv'eg'o'j'n
pluvegon	pluv'eg'o'n
pluvema	pluv'em'a
pluveroj	pluv'er'o'j
pluveta	pluv'et'a
pluvetas	pluv'et'as
pluvetis	pluv'et'is
pluveto	pluv'et'o
pluvgutoj	pluv'gut'o'j
pluvmantelo	pluv'mantel'o
pluvmantelon	pluv'mantel'o'n
pluvmarĉo	pluv'marĉ'o
pluvmarĉoj	pluv'marĉ'o'j
pluvmezurilo	pluv'mezur'il'o
pluvneĝo	pluv'neĝ'o
pluvokvanto	pluv'o'kvant'o
pluvokvanton	pluv'o'kvant'o'n
pluvoplena	pluv'o'plen'a
pluvoplenaj	pluv'o'plen'a'j
pluvombrelo	pluv'ombrel'o
pluvombreloj	pluv'ombrel'o'j
pluvombrelojn	pluv'ombrel'o'j'n
pluvombrelon	pluv'ombrel'o'n
pluvperiodoj	pluv'period'o'j
pluvsezono	pluv'sezon'o
pluvsezonoj	pluv'sezon'o'j
pluvsezonon	pluv'sezon'o'n
pneŭo	pneŭ'o
pneŭoj	pneŭ'o'j
pneŭojn	pneŭ'o'j'n
pneŭon	pneŭ'o'n
pneŭmatika	pneŭmatik'a
pneŭmatikaj	pneŭmatik'a'j
pneŭmatikan	pneŭmatik'a'n
pneŭmatiko	pneŭmatik'o
pneŭmatikoj	pneŭmatik'o'j
pneŭmatikojn	pneŭmatik'o'j'n
pneŭmonito	pneŭmon'it'o
pneŭmonio	pneŭmoni'o
po	po
poa	po'a
poe	po'e
poacoj	po'ac'o'j
podetala	po'detal'a
podetalaj	po'detal'a'j
podetalan	po'detal'a'n
podetalbutikoj	po'detal'butik'o'j
podetalisto	po'detal'ist'o
podetalistoj	po'detal'ist'o'j
podetalistojn	po'detal'ist'o'j'n
pogranda	po'grand'a
pograndaj	po'grand'a'j
pograndan	po'grand'a'n
pogrande	po'grand'e
poioma	po'iom'a
poiome	po'iom'e
poiomete	po'iom'et'e
pokapa	po'kap'a
pokapaj	po'kap'a'j
pokapan	po'kap'a'n
pokape	po'kap'e
popersona	po'person'a
poŝtupa	po'ŝtup'a
potage	po'tag'e
poba	pob'a
pobe	pob'e
pobo	pob'o
pocion	poci'o'n
podagro	podagr'o
podia	podi'a
podio	podi'o
podion	podi'o'n
podkasta	podkast'a
podkasto	podkast'o
podkastoj	podkast'o'j
podkastojn	podkast'o'j'n
podkaston	podkast'o'n
poema	poem'a
poemaj	poem'a'j
poemo	poem'o
poemoj	poem'o'j
poemojn	poem'o'j'n
poemon	poem'o'n
poemaro	poem'ar'o
poemaroj	poem'ar'o'j
poemarojn	poem'ar'o'j'n
poemaron	poem'ar'o'n
poemeto	poem'et'o
poemetoj	poem'et'o'j
poemetojn	poem'et'o'j'n
poemeton	poem'et'o'n
poemkolekto	poem'kolekt'o
poemlibro	poem'libr'o
poento	poent'o
poentoj	poent'o'j
poentojn	poent'o'j'n
poenton	poent'o'n
poentado	poent'ad'o
poentaro	poent'ar'o
poentarojn	poent'ar'o'j'n
poentaron	poent'ar'o'n
poeta	poet'a
poetaj	poet'a'j
poetan	poet'a'n
poeto	poet'o
poetoj	poet'o'j
poetojn	poet'o'j'n
poeton	poet'o'n
poetika	poet'ik'a
poetiko	poet'ik'o
poetikon	poet'ik'o'n
poetino	poet'in'o
poetinoj	poet'in'o'j
poezia	poezi'a
poeziaj	poezi'a'j
poeziajn	poezi'a'j'n
poezian	poezi'a'n
poezie	poezi'e
poezio	poezi'o
poezioj	poezi'o'j
poezion	poezi'o'n
poeziaĵo	poezi'aĵ'o
poeziaĵoj	poezi'aĵ'o'j
poeziaĵojn	poezi'aĵ'o'j'n
poeziaĵon	poezi'aĵ'o'n
poezieco	poezi'ec'o
pogromo	pogrom'o
pogromoj	pogrom'o'j
pojno	pojn'o
pojnoj	pojn'o'j
pojnojn	pojn'o'j'n
pojnon	pojn'o'n
pokalo	pokal'o
pokaloj	pokal'o'j
pokalojn	pokal'o'j'n
pokalon	pokal'o'n
pokemono	pokemon'o
pokero	poker'o
pokeron	poker'o'n
pola	pol'a
polaj	pol'a'j
polajn	pol'a'j'n
polan	pol'a'n
pole	pol'e
poli	pol'i
polo	pol'o
poloj	pol'o'j
polojn	pol'o'j'n
polon	pol'o'n
poleco	pol'ec'o
polio	pol'i'o
polino	pol'in'o
pollanda	pol'land'a
pollandaj	pol'land'a'j
pollando	pol'land'o
pollandon	pol'land'o'n
pollandanoj	pol'land'an'o'j
pollandolitovio	pol'land'o'litov'i'o
pollingva	pol'lingv'a
pollingvaj	pol'lingv'a'j
polujo	pol'uj'o
polara	polar'a
polaraj	polar'a'j
polarigis	polar'ig'is
polariganto	polar'ig'ant'o
polarigita	polar'ig'it'a
polarigitaj	polar'ig'it'a'j
polarigitan	polar'ig'it'a'n
polarizo	polariz'o
poldero	polder'o
polderoj	polder'o'j
polekso	poleks'o
polekson	poleks'o'n
polemika	polemik'a
polemikaj	polemik'a'j
polemikajn	polemik'a'j'n
polemikan	polemik'a'n
polemikas	polemik'as
polemike	polemik'e
polemiki	polemik'i
polemikis	polemik'is
polemiko	polemik'o
polemikoj	polemik'o'j
polemikojn	polemik'o'j'n
polemikon	polemik'o'n
polemikisto	polemik'ist'o
poleno	polen'o
polenoj	polen'o'j
polenon	polen'o'n
polenado	polen'ad'o
polenadon	polen'ad'o'n
polenigado	polen'ig'ad'o
polenigistoj	polen'ig'ist'o'j
poliestero	poli'ester'o
poliestro	poli'ester'o
polietileno	poli'et'il'en'o
polikarbonato	poli'karbon'at'o
polikristala	poli'kristal'a
polikristalaj	poli'kristal'a'j
polikromo	poli'krom'o
polikromon	poli'krom'o'n
polikvarfluoretileno	poli'kvar'fluor'et'il'en'o
polimera	poli'mer'a
polimeraj	poli'mer'a'j
polimero	poli'mer'o
polimeroj	poli'mer'o'j
polimerojn	poli'mer'o'j'n
polimeron	poli'mer'o'n
polimerigo	poli'mer'ig'o
polimerizaj	poli'mer'iz'a'j
polipropileno	poli'prop'il'en'o
polisakaridoj	poli'sakar'id'o'j
polisinteza	poli'sintez'a
polistireno	poli'stiren'o
poliuretano	poli'uretan'o
polica	polic'a
policaj	polic'a'j
policajn	polic'a'j'n
polican	polic'a'n
police	polic'e
polico	polic'o
policoj	polic'o'j
policojn	polic'o'j'n
policon	polic'o'n
policagentejoj	polic'agent'ej'o'j
policano	polic'an'o
policanoj	polic'an'o'j
policanojn	polic'an'o'j'n
policanon	polic'an'o'n
policanaro	polic'an'ar'o
policdistrikto	polic'distrikt'o
policejo	polic'ej'o
policejoj	polic'ej'o'j
policejojn	polic'ej'o'j'n
policejon	polic'ej'o'n
policestro	polic'estr'o
policisto	polic'ist'o
policistoj	polic'ist'o'j
policistojn	polic'ist'o'j'n
policiston	polic'ist'o'n
policistaro	polic'ist'ar'o
polickrimenketo	polic'krim'enket'o
polictrupo	polic'trup'o
polictrupoj	polic'trup'o'j
polictrupon	polic'trup'o'n
polidekto	polidekt'o
polidoro	polidor'o
polifonia	polifoni'a
polifonio	polifoni'o
polifonion	polifoni'o'n
poligamiaj	poligami'a'j
poligamio	poligami'o
poligamion	poligami'o'n
poliginio	poligini'o
poliglota	poliglot'a
poligloto	poliglot'o
poliglotoj	poliglot'o'j
poligona	poligon'a
poligono	poligon'o
polikarpo	polikarp'o
polikliniko	poliklinik'o
polimerazo	polimer'az'o
polimestoro	polimestor'o
polimorfa	polimorf'a
polimorfismo	polimorf'ism'o
poliniko	polinik'o
polinoma	polinom'a
polinomo	polinom'o
polinomoj	polinom'o'j
poliomjelito	polio'mjel'it'o
polipo	polip'o
polipoj	polip'o'j
poliso	polis'o
politburoo	politburo'o
politeisma	politeism'a
politeismaj	politeism'a'j
politeismo	politeism'o
politeismon	politeism'o'n
politeknika	politeknik'a
politekniko	politeknik'o
politeknikejo	politeknik'ej'o
politeknikejoj	politeknik'ej'o'j
politika	politik'a
politikaj	politik'a'j
politikajn	politik'a'j'n
politikan	politik'a'n
politike	politik'e
politiko	politik'o
politikoj	politik'o'j
politikojn	politik'o'j'n
politikon	politik'o'n
politikado	politik'ad'o
politikestroj	politik'estr'o'j
politikigo	politik'ig'o
politikista	politik'ist'a
politikistaj	politik'ist'a'j
politikisto	politik'ist'o
politikistoj	politik'ist'o'j
politikistojn	politik'ist'o'j'n
politikiston	politik'ist'o'n
politikistino	politik'ist'in'o
politikofaristoj	politik'o'far'ist'o'j
politikokreado	politik'o'kre'ad'o
politikuloj	politik'ul'o'j
politruko	politruk'o
polje	polj'e
poljo	polj'o
polmo	polm'o
polmoj	polm'o'j
polmon	polm'o'n
poloo	polo'o
polonia	poloni'a
polonio	poloni'o
polpo	polp'o
polpoj	polp'o'j
poltrona	poltron'a
poltrono	poltron'o
polua	polu'a
poluas	polu'as
polui	polu'i
poluis	polu'is
poluo	polu'o
poluon	polu'o'n
poluado	polu'ad'o
poluadon	polu'ad'o'n
poluaĵo	polu'aĵ'o
poluaĵoj	polu'aĵ'o'j
poluaĵojn	polu'aĵ'o'j'n
poluantaj	polu'ant'a'j
poluanto	polu'ant'o
poluantoj	polu'ant'o'j
poluita	polu'it'a
poluitaj	polu'it'a'j
poluitajn	polu'it'a'j'n
poluitan	polu'it'a'n
polucia	poluci'a
polucio	poluci'o
polucion	poluci'o'n
polukso	poluks'o
poluras	polur'as
poluri	polur'i
poluris	polur'is
poluro	polur'o
polurado	polur'ad'o
polurante	polur'ant'e
polurita	polur'it'a
poluritaj	polur'it'a'j
poluritajn	polur'it'a'j'n
poluritan	polur'it'a'n
polusa	polus'a
polusaj	polus'a'j
polusajn	polus'a'j'n
polusan	polus'a'n
poluso	polus'o
polusoj	polus'o'j
polusojn	polus'o'j'n
poluson	polus'o'n
poluseco	polus'ec'o
polusecon	polus'ec'o'n
polusiĝo	polus'iĝ'o
polusiĝoj	polus'iĝ'o'j
polusiĝon	polus'iĝ'o'n
polusregionoj	polus'region'o'j
polva	polv'a
polvaj	polv'a'j
polvan	polv'a'n
polvo	polv'o
polvoj	polv'o'j
polvon	polv'o'n
polvero	polv'er'o
polveroj	polv'er'o'j
polverojn	polv'er'o'j'n
polveron	polv'er'o'n
polvokovrita	polv'o'kovr'it'a
polvokovritaj	polv'o'kovr'it'a'j
polvonubo	polv'o'nub'o
polvoŝtormoj	polv'o'ŝtorm'o'j
polvosuĉilo	polv'o'suĉ'il'o
polvosuĉiloj	polv'o'suĉ'il'o'j
polvosuĉilon	polv'o'suĉ'il'o'n
poma	pom'a
poman	pom'a'n
pomo	pom'o
pomoj	pom'o'j
pomojn	pom'o'j'n
pomon	pom'o'n
pomarbo	pom'arb'o
pomarboj	pom'arb'o'j
pomarbojn	pom'arb'o'j'n
pomarbon	pom'arb'o'n
pomego	pom'eg'o
pomkukon	pom'kuk'o'n
pomsuko	pom'suk'o
pomtorton	pom'tort'o'n
pomujo	pom'uj'o
pomujoj	pom'uj'o'j
pomelo	pomel'o
pomerio	pomeri'o
pompa	pomp'a
pompaj	pomp'a'j
pompajn	pomp'a'j'n
pompan	pomp'a'n
pompas	pomp'as
pompe	pomp'e
pompis	pomp'is
pompo	pomp'o
pompon	pomp'o'n
pompeco	pomp'ec'o
pompeo	pompe'o
pompejo	pompej'o
pompejon	pompej'o'n
ponardi	ponard'i
ponardis	ponard'is
ponardo	ponard'o
ponardoj	ponard'o'j
ponardojn	ponard'o'j'n
ponardon	ponard'o'n
ponardita	ponard'it'a
poneo	pone'o
poneon	pone'o'n
ponta	pont'a
pontaj	pont'a'j
ponte	pont'e
ponto	pont'o
pontoj	pont'o'j
pontojn	pont'o'j'n
ponton	pont'o'n
ponteto	pont'et'o
pontetoj	pont'et'o'j
ponteton	pont'et'o'n
pontlingvo	pont'lingv'o
pontolingvo	pont'o'lingv'o
pontolingvon	pont'o'lingv'o'n
pontifika	pontifik'a
pontifikaj	pontifik'a'j
pontifiko	pontifik'o
pope	pop'e
popo	pop'o
popoj	pop'o'j
popare	pop'ar'e
poparte	pop'art'e
popeca	pop'ec'a
popece	pop'ec'e
popkulturo	pop'kultur'o
popmuzika	pop'muzik'a
popmuziko	pop'muzik'o
popmuzikon	pop'muzik'o'n
poplo	popl'o
poploj	popl'o'j
poplon	popl'o'n
popola	popol'a
popolaj	popol'a'j
popolajn	popol'a'j'n
popolan	popol'a'n
popolas	popol'as
popole	popol'e
popolo	popol'o
popoloj	popol'o'j
popolojn	popol'o'j'n
popolon	popol'o'n
popolaĉo	popol'aĉ'o
popolamaso	popol'amas'o
popolamasoj	popol'amas'o'j
popolamasojn	popol'amas'o'j'n
popolamason	popol'amas'o'n
popolana	popol'an'a
popolano	popol'an'o
popolanoj	popol'an'o'j
popolanojn	popol'an'o'j'n
popolaro	popol'ar'o
popolarmeo	popol'arme'o
popolarto	popol'art'o
popoldanco	popol'danc'o
popoldancoj	popol'danc'o'j
popoldemokratia	popol'demokrat'i'a
popoldiro	popol'dir'o
popoleto	popol'et'o
popolfabeloj	popol'fabel'o'j
popolgrupoj	popol'grup'o'j
popolita	popol'it'a
popolitaj	popol'it'a'j
popolkanta	popol'kant'a
popolkanto	popol'kant'o
popolkantoj	popol'kant'o'j
popolkantojn	popol'kant'o'j'n
popolkanton	popol'kant'o'n
popolkredo	popol'kred'o
popolkunveno	popol'kun'ven'o
popollingvo	popol'lingv'o
popollingvon	popol'lingv'o'n
popolmalamiko	popol'mal'amik'o
popolmigradoj	popol'migr'ad'o'j
popolmuzika	popol'muzik'a
popolmuzikaj	popol'muzik'a'j
popolmuziko	popol'muzik'o
popolmuzikon	popol'muzik'o'n
popolnomo	popol'nom'o
popolnomoj	popol'nom'o'j
popolnombro	popol'nombr'o
popolnombrado	popol'nombr'ad'o
popolnombradoj	popol'nombr'ad'o'j
popolpartio	popol'parti'o
popolrakontoj	popol'rakont'o'j
popolrespubliko	popol'respublik'o
popolriĉa	popol'riĉ'a
popolriĉaj	popol'riĉ'a'j
popolsano	popol'san'o
popolsanon	popol'san'o'n
popolscio	popol'sci'o
popoltradicio	popol'tradici'o
populacia	populaci'a
populacio	populaci'o
populacioj	populaci'o'j
populaciojn	populaci'o'j'n
populacion	populaci'o'n
populaciekologio	populaci'ekolog'i'o
populacikontrolo	populaci'kontrol'o
populaciomalkreskon	populaci'o'mal'kresk'o'n
populara	popular'a
popularaj	popular'a'j
popularajn	popular'a'j'n
popularan	popular'a'n
popularas	popular'as
populare	popular'e
popularis	popular'is
populareco	popular'ec'o
popularecon	popular'ec'o'n
popularigas	popular'ig'as
popularigi	popular'ig'i
popularigis	popular'ig'is
popularigo	popular'ig'o
popularigon	popular'ig'o'n
popularigado	popular'ig'ad'o
populariganto	popular'ig'ant'o
popularigisto	popular'ig'ist'o
popularigita	popular'ig'it'a
popularigitaj	popular'ig'it'a'j
populariĝas	popular'iĝ'as
populariĝis	popular'iĝ'is
populariĝo	popular'iĝ'o
popularismaj	popular'ism'a'j
popularmuzikaj	popular'muzik'a'j
popularmuziko	popular'muzik'o
popularscienca	popular'scienc'a
popularsciencaj	popular'scienc'a'j
por	por
pora	por'a
poraj	por'a'j
poran	por'a'n
poro	por'o
poroj	por'o'j
porojn	por'o'j'n
poron	por'o'n
porĉiama	por'ĉiam'a
porĉiaman	por'ĉiam'a'n
porĉiame	por'ĉiam'e
poreco	por'ec'o
poreksterlanda	por'ekster'land'a
poresperanta	por'esperant'a
poresperantaj	por'esperant'a'j
poresperantan	por'esperant'a'n
poreterna	por'etern'a
poreterne	por'etern'e
porinfana	por'infan'a
porinfanaj	por'infan'a'j
porinfanajn	por'infan'a'j'n
porinfanan	por'infan'a'n
porinstruista	por'instru'ist'a
porjunula	por'jun'ul'a
porjunulara	por'jun'ul'ar'a
porjunularaj	por'jun'ul'ar'a'j
porkomplemento	por'komplement'o
pormedia	por'medi'a
pormomente	por'moment'e
porokaza	por'okaz'a
porokazaj	por'okaz'a'j
porokaze	por'okaz'e
porpaca	por'pac'a
porpacaj	por'pac'a'j
porpacan	por'pac'a'n
porparolanto	por'parol'ant'o
porpastra	por'pastr'a
porpastraj	por'pastr'a'j
portempa	por'temp'a
portempaj	por'temp'a'j
portempajn	por'temp'a'j'n
portempan	por'temp'a'n
portempe	por'temp'e
porvira	por'vir'a
porvirina	por'vir'in'a
porviva	por'viv'a
porvivaj	por'viv'a'j
porvive	por'viv'e
porvivaĵo	por'viv'aĵ'o
porvivaĵoj	por'viv'aĵ'o'j
porvivaĵojn	por'viv'aĵ'o'j'n
porvivaĵon	por'viv'aĵ'o'n
porcelana	porcelan'a
porcelanaj	porcelan'a'j
porcelanan	porcelan'a'n
porcelano	porcelan'o
porcelanoj	porcelan'o'j
porcelanon	porcelan'o'n
porcelanaĵoj	porcelan'aĵ'o'j
porcelanaĵojn	porcelan'aĵ'o'j'n
porcio	porci'o
porcioj	porci'o'j
porciojn	porci'o'j'n
porcion	porci'o'n
porciigitaj	porci'ig'it'a'j
porda	pord'a
pordaj	pord'a'j
pordan	pord'a'n
pordo	pord'o
pordoj	pord'o'j
pordojn	pord'o'j'n
pordon	pord'o'n
pordega	pord'eg'a
pordego	pord'eg'o
pordegoj	pord'eg'o'j
pordegojn	pord'eg'o'j'n
pordegon	pord'eg'o'n
pordejo	pord'ej'o
pordejoj	pord'ej'o'j
pordejon	pord'ej'o'n
pordeto	pord'et'o
pordetoj	pord'et'o'j
pordeton	pord'et'o'n
pordisto	pord'ist'o
pordiston	pord'ist'o'n
pordistino	pord'ist'in'o
pordmalfermo	pord'mal'ferm'o
pordogardisto	pord'o'gard'ist'o
pordokadro	pord'o'kadr'o
pordomalfermo	pord'o'mal'ferm'o
poreo	pore'o
poreosupon	pore'o'sup'o'n
porfiro	porfir'o
porfirio	porfiri'o
porka	pork'a
porkaj	pork'a'j
porke	pork'e
porko	pork'o
porkoj	pork'o'j
porkojn	pork'o'j'n
porkon	pork'o'n
porkaĵo	pork'aĵ'o
porkaĵon	pork'aĵ'o'n
porkejo	pork'ej'o
porketo	pork'et'o
porketoj	pork'et'o'j
porketojn	pork'et'o'j'n
porketon	pork'et'o'n
porkido	pork'id'o
porkidoj	pork'id'o'j
porkidon	pork'id'o'n
porkino	pork'in'o
porkinoj	pork'in'o'j
pornografia	pornograf'i'a
pornografiaj	pornograf'i'a'j
pornografiajn	pornograf'i'a'j'n
pornografian	pornograf'i'a'n
pornografio	pornograf'i'o
pornografion	pornograf'i'o'n
porta	port'a
portas	port'as
porte	port'e
porti	port'i
portis	port'is
porto	port'o
portos	port'os
portu	port'u
portus	port'us
portadi	port'ad'i
portadis	port'ad'is
portado	port'ad'o
portadon	port'ad'o'n
portanta	port'ant'a
portantaj	port'ant'a'j
portantajn	port'ant'a'j'n
portantan	port'ant'a'n
portante	port'ant'e
portanto	port'ant'o
portantoj	port'ant'o'j
portanton	port'ant'o'n
portata	port'at'a
portataj	port'at'a'j
portatan	port'at'a'n
portebla	port'ebl'a
porteblaj	port'ebl'a'j
porteblajn	port'ebl'a'j'n
porteblan	port'ebl'a'n
porteblo	port'ebl'o
portigis	port'ig'is
portilo	port'il'o
portiloj	port'il'o'j
portilon	port'il'o'n
portinta	port'int'a
portisto	port'ist'o
portistoj	port'ist'o'j
portiston	port'ist'o'n
portita	port'it'a
portitaj	port'it'a'j
portitajn	port'it'a'j'n
portitan	port'it'a'n
portite	port'it'e
portondo	port'ond'o
portala	portal'a
portalo	portal'o
portaloj	portal'o'j
portalon	portal'o'n
portiko	portik'o
portikoj	portik'o'j
portikon	portik'o'n
portlanda	portland'a
portlando	portland'o
portoprinco	portoprinc'o
portretas	portret'as
portreti	portret'i
portretis	portret'is
portreto	portret'o
portretoj	portret'o'j
portretojn	portret'o'j'n
portreton	portret'o'n
portretado	portret'ad'o
portretadoj	portret'ad'o'j
portretadon	portret'ad'o'n
portretante	portret'ant'e
portretisto	portret'ist'o
portretita	portret'it'a
portretitaj	portret'it'a'j
portugala	portugal'a
portugalaj	portugal'a'j
portugalajn	portugal'a'j'n
portugalan	portugal'a'n
portugale	portugal'e
portugalo	portugal'o
portugaloj	portugal'o'j
portugalojn	portugal'o'j'n
portugalio	portugal'i'o
portugalion	portugal'i'o'n
portugallingva	portugal'lingv'a
portugallingvaj	portugal'lingv'a'j
portugallingve	portugal'lingv'e
portugalujo	portugal'uj'o
poŝa	poŝ'a
poŝo	poŝ'o
poŝoj	poŝ'o'j
poŝojn	poŝ'o'j'n
poŝon	poŝ'o'n
poŝhorloĝo	poŝ'horloĝ'o
poŝhorloĝon	poŝ'horloĝ'o'n
poŝkomputilo	poŝ'komput'il'o
poŝkomputiloj	poŝ'komput'il'o'j
poŝlampo	poŝ'lamp'o
poŝlampon	poŝ'lamp'o'n
poŝlegiloj	poŝ'leg'il'o'j
poŝlibro	poŝ'libr'o
poŝmono	poŝ'mon'o
poŝmonon	poŝ'mon'o'n
poŝoŝtelistoj	poŝ'o'ŝtel'ist'o'j
poŝtelefona	poŝ'telefon'a
poŝtelefonaj	poŝ'telefon'a'j
poŝtelefonajn	poŝ'telefon'a'j'n
poŝtelefonan	poŝ'telefon'a'n
poŝtelefono	poŝ'telefon'o
poŝtelefonoj	poŝ'telefon'o'j
poŝtelefonojn	poŝ'telefon'o'j'n
poŝtelefonon	poŝ'telefon'o'n
poŝtranĉilo	poŝ'tranĉ'il'o
poŝtranĉilon	poŝ'tranĉ'il'o'n
poŝtuko	poŝ'tuk'o
poŝtukojn	poŝ'tuk'o'j'n
poŝtukon	poŝ'tuk'o'n
poseda	posed'a
posedaj	posed'a'j
posedan	posed'a'n
posedas	posed'as
posedi	posed'i
posedis	posed'is
posedo	posed'o
posedoj	posed'o'j
posedojn	posed'o'j'n
posedon	posed'o'n
posedos	posed'os
posedu	posed'u
posedus	posed'us
posedado	posed'ad'o
posedajho	posed'aĵ'o
posedaĵo	posed'aĵ'o
posedaĵoj	posed'aĵ'o'j
posedaĵojn	posed'aĵ'o'j'n
posedaĵon	posed'aĵ'o'n
posedanta	posed'ant'a
posedantaj	posed'ant'a'j
posedante	posed'ant'e
posedanto	posed'ant'o
posedantoj	posed'ant'o'j
posedantojn	posed'ant'o'j'n
posedanton	posed'ant'o'n
posedantino	posed'ant'in'o
posedata	posed'at'a
posedataj	posed'at'a'j
posedatajn	posed'at'a'j'n
posedatan	posed'at'a'n
posedate	posed'at'e
posedema	posed'em'a
posedemaj	posed'em'a'j
posedita	posed'it'a
poseditaj	posed'it'a'j
posedrajto	posed'rajt'o
posedrajtoj	posed'rajt'o'j
posedrajton	posed'rajt'o'n
posesivo	posesiv'o
posesivoj	posesiv'o'j
post	post
posta	post'a
postaj	post'a'j
postajn	post'a'j'n
postan	post'a'n
poste	post'e
posten	post'e'n
postmorgaŭ	post'morgaŭ
posto	post'o
postaĵa	post'aĵ'a
postaĵo	post'aĵ'o
postaĵoj	post'aĵ'o'j
postaĵon	post'aĵ'o'n
postalveolara	post'alveolar'a
postapokalipsa	post'apokalips'a
postbakalaŭra	post'bakalaŭr'a
postbakalaŭraj	post'bakalaŭr'a'j
postbakalaŭrajn	post'bakalaŭr'a'j'n
postbakalaŭran	post'bakalaŭr'a'n
postdomo	post'dom'o
postdorse	post'dors'e
postesigno	post'e'sign'o
posteulo	post'e'ul'o
posteuloj	post'e'ul'o'j
posteulojn	post'e'ul'o'j'n
posteulon	post'e'ul'o'n
posteularo	post'e'ul'ar'o
posteularon	post'e'ul'ar'o'n
posteuleco	post'e'ul'ec'o
postebrion	post'ebri'o'n
posteduko	post'eduk'o
postefikoj	post'efik'o'j
postefikojn	post'efik'o'j'n
posteventa	post'event'a
postgimnazio	post'gimnazi'o
postgimnazion	post'gimnazi'o'n
postguston	post'gust'o'n
postiĝinta	post'iĝ'int'a
postiĝintaj	post'iĝ'int'a'j
postindustria	post'industri'a
postiris	post'ir'is
postkatastrofa	post'katastrof'a
postklasika	post'klasik'a
postkolonia	post'koloni'a
postkoloniaj	post'koloni'a'j
postkomunismaj	post'komun'ism'a'j
postkongresa	post'kongres'a
postkongresaj	post'kongres'a'j
postkongreso	post'kongres'o
postkuras	post'kur'as
postkuri	post'kur'i
postkuris	post'kur'is
postkuro	post'kur'o
postkuron	post'kur'o'n
postkuru	post'kur'u
postkurado	post'kur'ad'o
postkurante	post'kur'ant'e
postkurita	post'kur'it'a
postlabora	post'labor'a
postlaboraj	post'labor'a'j
postlasas	post'las'as
postlasi	post'las'i
postlasis	post'las'is
postlasos	post'las'os
postlasu	post'las'u
postlasado	post'las'ad'o
postlasaĵo	post'las'aĵ'o
postlasanta	post'las'ant'a
postlasante	post'las'ant'e
postlasinte	post'las'int'e
postlasita	post'las'it'a
postlasitaj	post'las'it'a'j
postlasitajn	post'las'it'a'j'n
postlasitan	post'las'it'a'n
postmilita	post'milit'a
postmilitaj	post'milit'a'j
postmilitajn	post'milit'a'j'n
postmilitan	post'milit'a'n
postmilite	post'milit'e
postmilito	post'milit'o
postmoderna	post'modern'a
postmodernaj	post'modern'a'j
postmodernismo	post'modern'ism'o
postmorta	post'mort'a
postmortaj	post'mort'a'j
postmortan	post'mort'a'n
postmorte	post'mort'e
postmorto	post'mort'o
postnaska	post'nask'a
postnelonge	post'ne'long'e
postoperacia	post'operaci'a
postparolo	post'parol'o
postparto	post'part'o
postproduktado	post'produkt'ad'o
postpurigo	post'pur'ig'o
postpurigon	post'pur'ig'o'n
postradoj	post'rad'o'j
postrestas	post'rest'as
postresti	post'rest'i
postrestis	post'rest'is
postrestos	post'rest'os
postrestaĵo	post'rest'aĵ'o
postrestaĵoj	post'rest'aĵ'o'j
postrestanta	post'rest'ant'a
postrestantaj	post'rest'ant'a'j
postrestanteco	post'rest'ant'ec'o
postrestinta	post'rest'int'a
postrestintaj	post'rest'int'a'j
postrevolucia	post'revoluci'a
postrigardis	post'rigard'is
postsekundara	post'sekundar'a
postsekva	post'sekv'a
postsekvaj	post'sekv'a'j
postsekvas	post'sekv'as
postsekve	post'sekv'e
postsekvi	post'sekv'i
postsekvis	post'sekv'is
postsekvo	post'sekv'o
postsekvoj	post'sekv'o'j
postsekvojn	post'sekv'o'j'n
postsigno	post'sign'o
postsignoj	post'sign'o'j
postsignojn	post'sign'o'j'n
postsignon	post'sign'o'n
postskribaĵo	post'skrib'aĵ'o
postsovetia	post'sovet'i'a
postsovetiaj	post'sovet'i'a'j
posttagmeza	post'tag'mez'a
posttagmezaj	post'tag'mez'a'j
posttagmezan	post'tag'mez'a'n
posttagmeze	post'tag'mez'e
posttagmezo	post'tag'mez'o
posttagmezoj	post'tag'mez'o'j
posttagmezon	post'tag'mez'o'n
posttraktado	post'trakt'ad'o
posttraŭmata	post'traŭmat'a
postumus	post'um'us
postumius	post'um'i'us
postvenda	post'vend'a
postvivas	post'viv'as
postvivi	post'viv'i
postvivis	post'viv'is
postvivo	post'viv'o
postvivon	post'viv'o'n
postvivos	post'viv'os
postvivus	post'viv'us
postvivado	post'viv'ad'o
postvivanta	post'viv'ant'a
postvivantaj	post'viv'ant'a'j
postvivante	post'viv'ant'e
postvivanto	post'viv'ant'o
postvivantoj	post'viv'ant'o'j
postvivantojn	post'viv'ant'o'j'n
postvivintaj	post'viv'int'a'j
postvivintoj	post'viv'int'o'j
postvivita	post'viv'it'a
poŝta	poŝt'a
poŝtaj	poŝt'a'j
poŝtajn	poŝt'a'j'n
poŝtan	poŝt'a'n
poŝtas	poŝt'as
poŝte	poŝt'e
poŝti	poŝt'i
poŝtis	poŝt'is
poŝto	poŝt'o
poŝtoj	poŝt'o'j
poŝton	poŝt'o'n
poŝtaĵo	poŝt'aĵ'o
poŝtaĵoj	poŝt'aĵ'o'j
poŝtaĵojn	poŝt'aĵ'o'j'n
poŝtaĵon	poŝt'aĵ'o'n
poŝtarto	poŝt'art'o
poŝtaŭtolinio	poŝt'aŭt'o'lini'o
poŝtaŭtolinioj	poŝt'aŭt'o'lini'o'j
poŝtejo	poŝt'ej'o
poŝtejoj	poŝt'ej'o'j
poŝtejon	poŝt'ej'o'n
poŝtestro	poŝt'estr'o
poŝtisto	poŝt'ist'o
poŝtistoj	poŝt'ist'o'j
poŝtita	poŝt'it'a
poŝtitaj	poŝt'it'a'j
poŝtkarto	poŝt'kart'o
poŝtkartoj	poŝt'kart'o'j
poŝtkartojn	poŝt'kart'o'j'n
poŝtkarton	poŝt'kart'o'n
poŝtkesto	poŝt'kest'o
poŝtkeston	poŝt'kest'o'n
poŝtkodo	poŝt'kod'o
poŝtkodoj	poŝt'kod'o'j
poŝtkodon	poŝt'kod'o'n
poŝtmarka	poŝt'mark'a
poŝtmarko	poŝt'mark'o
poŝtmarkoj	poŝt'mark'o'j
poŝtmarkojn	poŝt'mark'o'j'n
poŝtmarkon	poŝt'mark'o'n
poŝtoservilo	poŝt'o'serv'il'o
poŝtoficejo	poŝt'ofic'ej'o
poŝtoficejon	poŝt'ofic'ej'o'n
postamento	postament'o
postenis	posten'is
posteno	posten'o
postenoj	posten'o'j
postenojn	posten'o'j'n
postenon	posten'o'n
postenigas	posten'ig'as
postenigis	posten'ig'is
postenigita	posten'ig'it'a
postenigitaj	posten'ig'it'a'j
postenuloj	posten'ul'o'j
postpozicio	postpozici'o
postula	postul'a
postulaj	postul'a'j
postulas	postul'as
postuli	postul'i
postulis	postul'is
postulo	postul'o
postuloj	postul'o'j
postulojn	postul'o'j'n
postulon	postul'o'n
postulos	postul'os
postulu	postul'u
postulus	postul'us
postuladi	postul'ad'i
postuladis	postul'ad'is
postulado	postul'ad'o
postuladon	postul'ad'o'n
postuladita	postul'ad'it'a
postuladitaj	postul'ad'it'a'j
postuladite	postul'ad'it'e
postulanta	postul'ant'a
postulantaj	postul'ant'a'j
postulantajn	postul'ant'a'j'n
postulantan	postul'ant'a'n
postulante	postul'ant'e
postulanto	postul'ant'o
postulantoj	postul'ant'o'j
postulata	postul'at'a
postulataj	postul'at'a'j
postulatajn	postul'at'a'j'n
postulatan	postul'at'a'n
postulate	postul'at'e
postulato	postul'at'o
postulatoj	postul'at'o'j
postulaton	postul'at'o'n
postulema	postul'em'a
postulemaj	postul'em'a'j
postulemajn	postul'em'a'j'n
postulgrafeo	postul'grafe'o
postulinta	postul'int'a
postulintus	postul'int'us
postulita	postul'it'a
postulitaj	postul'it'a'j
postulitajn	postul'it'a'j'n
postulitan	postul'it'a'n
postulite	postul'it'e
postulrespondo	postul'respond'o
postulata	postulat'a
postulataj	postulat'a'j
postulatajn	postulat'a'j'n
postulatan	postulat'a'n
postulate	postulat'e
postulato	postulat'o
postulatoj	postulat'o'j
postulaton	postulat'o'n
poto	pot'o
potoj	pot'o'j
potojn	pot'o'j'n
poton	pot'o'n
potaĵoj	pot'aĵ'o'j
potetoj	pot'et'o'j
poteton	pot'et'o'n
potfarado	pot'far'ad'o
potisto	pot'ist'o
potenca	potenc'a
potencaj	potenc'a'j
potencajn	potenc'a'j'n
potencan	potenc'a'n
potencas	potenc'as
potence	potenc'e
potenco	potenc'o
potencoj	potenc'o'j
potencojn	potenc'o'j'n
potencon	potenc'o'n
potencaŭtoj	potenc'aŭt'o'j
potencavido	potenc'avid'o
potencdenseco	potenc'dens'ec'o
potencdensecon	potenc'dens'ec'o'n
potencdissendo	potenc'dis'send'o
potencdisipado	potenc'disip'ad'o
potencdistribuo	potenc'distribu'o
potencega	potenc'eg'a
potencekvilibro	potenc'ekvilibr'o
potencekvilibron	potenc'ekvilibr'o'n
potencigi	potenc'ig'i
potencigo	potenc'ig'o
potenciĝis	potenc'iĝ'is
potencpostulo	potenc'postul'o
potencpostuloj	potenc'postul'o'j
potencpreno	potenc'pren'o
potencrivaleco	potenc'rival'ec'o
potenculo	potenc'ul'o
potenculoj	potenc'ul'o'j
potenculojn	potenc'ul'o'j'n
potencularo	potenc'ul'ar'o
potenciala	potencial'a
potencialaj	potencial'a'j
potencialajn	potencial'a'j'n
potencialan	potencial'a'n
potenciale	potencial'e
potencialo	potencial'o
potencialoj	potencial'o'j
potencialojn	potencial'o'j'n
potencialon	potencial'o'n
potenciometro	potenciometr'o
poŭpo	poŭp'o
pova	pov'a
povaj	pov'a'j
povan	pov'a'n
povas	pov'as
pove	pov'e
povi	pov'i
povis	pov'is
povo	pov'o
povoj	pov'o'j
povojn	pov'o'j'n
povon	pov'o'n
povos	pov'os
povu	pov'u
povus	pov'us
povanta	pov'ant'a
povantaj	pov'ant'a'j
povantan	pov'ant'a'n
povante	pov'ant'e
povdisiĝo	pov'dis'iĝ'o
povega	pov'eg'a
povegaj	pov'eg'a'j
povigas	pov'ig'as
povigi	pov'ig'i
povigis	pov'ig'is
povigo	pov'ig'o
povigon	pov'ig'o'n
povigado	pov'ig'ad'o
povigita	pov'ig'it'a
povigitaj	pov'ig'it'a'j
povinta	pov'int'a
povintaj	pov'int'a'j
povinte	pov'int'e
povintus	pov'int'us
povoscias	pov'o'sci'as
povosciis	pov'o'sci'is
povosistemo	pov'o'sistem'o
povosistemoj	pov'o'sistem'o'j
povovakuo	pov'o'vaku'o
povuma	pov'um'a
povumo	pov'um'o
povumon	pov'um'o'n
povra	povr'a
povraj	povr'a'j
povrajn	povr'a'j'n
povran	povr'a'n
povreco	povr'ec'o
povrulo	povr'ul'o
povruloj	povr'ul'o'j
povrulon	povr'ul'o'n
pozas	poz'as
pozi	poz'i
pozis	poz'is
pozo	poz'o
pozoj	poz'o'j
pozojn	poz'o'j'n
pozon	poz'o'n
pozado	poz'ad'o
pozanta	poz'ant'a
pozantaj	poz'ant'a'j
pozante	poz'ant'e
pozita	poz'it'a
pozitaj	poz'it'a'j
pozicia	pozici'a
poziciaj	pozici'a'j
pozician	pozici'a'n
pozicio	pozici'o
pozicioj	pozici'o'j
poziciojn	pozici'o'j'n
pozicion	pozici'o'n
poziciigas	pozici'ig'as
poziciigi	pozici'ig'i
poziciigis	pozici'ig'is
poziciigado	pozici'ig'ad'o
poziciigadon	pozici'ig'ad'o'n
poziciigante	pozici'ig'ant'e
poziciigita	pozici'ig'it'a
poziciigitaj	pozici'ig'it'a'j
poziciita	pozici'it'a
pozidono	pozidon'o
pozidonon	pozidon'o'n
pozitiva	pozitiv'a
pozitivaj	pozitiv'a'j
pozitivajn	pozitiv'a'j'n
pozitivan	pozitiv'a'n
pozitive	pozitiv'e
pozitivo	pozitiv'o
pozitivoj	pozitiv'o'j
pozitivon	pozitiv'o'n
pozitivismo	pozitiv'ism'o
pozitivisto	pozitiv'ist'o
pozitivistoj	pozitiv'ist'o'j
pozitrona	pozitron'a
pozitrono	pozitron'o
poznano	poznan'o
praa	pra'a
praaj	pra'a'j
praajn	pra'a'j'n
praan	pra'a'n
praarbaro	pra'arb'ar'o
praarbaroj	pra'arb'ar'o'j
praarbaron	pra'arb'ar'o'n
praavo	pra'av'o
praavoj	pra'av'o'j
praavino	pra'av'in'o
prabulgaroj	pra'bulgar'o'j
praĉeloj	pra'ĉel'o'j
praeksplodo	pra'eksplod'o
praepoko	pra'epok'o
praformo	pra'form'o
praformoj	pra'form'o'j
pragepatroj	pra'ge'patr'o'j
praĝermana	pra'ĝerman'a
prahindeŭropa	pra'hind'eŭrop'a
prahistoria	pra'histori'a
prahistoriaj	pra'histori'a'j
prahistoriajn	pra'histori'a'j'n
prahistorian	pra'histori'a'n
prahistorio	pra'histori'o
prahomaj	pra'hom'a'j
prahomo	pra'hom'o
prahomoj	pra'hom'o'j
prakatolika	pra'katolik'a
prakristana	pra'krist'an'a
prakristanaj	pra'krist'an'a'j
pralingvo	pra'lingv'o
praloĝantoj	pra'loĝ'ant'o'j
pranepo	pra'nep'o
pranepoj	pra'nep'o'j
praonklo	pra'onkl'o
prapatra	pra'patr'a
prapatran	pra'patr'a'n
prapatro	pra'patr'o
prapatroj	pra'patr'o'j
prapatrojn	pra'patr'o'j'n
prapatron	pra'patr'o'n
prapatroĉeloj	pra'patr'o'ĉel'o'j
prapeko	pra'pek'o
prapiano	pra'pian'o
prapraavo	pra'pra'av'o
praroko	pra'rok'o
pratempa	pra'temp'a
pratempaj	pra'temp'a'j
pratempo	pra'temp'o
pratempoj	pra'temp'o'j
praula	pra'ul'a
praulaj	pra'ul'a'j
praulajn	pra'ul'a'j'n
praulan	pra'ul'a'n
praulo	pra'ul'o
prauloj	pra'ul'o'j
praulojn	pra'ul'o'j'n
praulon	pra'ul'o'n
praularo	pra'ul'ar'o
pragmata	pragmat'a
pragmataj	pragmat'a'j
pragmatan	pragmat'a'n
pragmate	pragmat'e
pragmatismo	pragmat'ism'o
pragmatismon	pragmat'ism'o'n
pragmatistoj	pragmat'ist'o'j
pragmatika	pragmatik'a
pragmatiko	pragmatik'o
praha	prah'a
praktika	praktik'a
praktikaj	praktik'a'j
praktikajn	praktik'a'j'n
praktikan	praktik'a'n
praktikas	praktik'as
praktike	praktik'e
praktiki	praktik'i
praktikis	praktik'is
praktiko	praktik'o
praktikoj	praktik'o'j
praktikojn	praktik'o'j'n
praktikon	praktik'o'n
praktikos	praktik'os
praktiku	praktik'u
praktikadi	praktik'ad'i
praktikadis	praktik'ad'is
praktikado	praktik'ad'o
praktikadon	praktik'ad'o'n
praktikanta	praktik'ant'a
praktikantaj	praktik'ant'a'j
praktikante	praktik'ant'e
praktikanto	praktik'ant'o
praktikantoj	praktik'ant'o'j
praktikata	praktik'at'a
praktikataj	praktik'at'a'j
praktikebla	praktik'ebl'a
praktikeco	praktik'ec'o
praktikecon	praktik'ec'o'n
praktikejo	praktik'ej'o
praktikema	praktik'em'a
praktikiĝas	praktik'iĝ'as
praktikita	praktik'it'a
praktikitaj	praktik'it'a'j
praktikperiodo	praktik'period'o
pramo	pram'o
pramoj	pram'o'j
pramon	pram'o'n
pramejo	pram'ej'o
pramisto	pram'ist'o
pramŝipo	pram'ŝip'o
prava	prav'a
pravaj	prav'a'j
pravajn	prav'a'j'n
pravan	prav'a'n
pravas	prav'as
prave	prav'e
pravi	prav'i
pravis	prav'is
pravo	prav'o
pravon	prav'o'n
pravos	prav'os
pravus	prav'us
praveco	prav'ec'o
pravecon	prav'ec'o'n
pravigas	prav'ig'as
pravigi	prav'ig'i
pravigis	prav'ig'is
pravigo	prav'ig'o
pravigoj	prav'ig'o'j
pravigojn	prav'ig'o'j'n
pravigon	prav'ig'o'n
pravigos	prav'ig'os
pravigu	prav'ig'u
pravigus	prav'ig'us
pravigado	prav'ig'ad'o
praviganta	prav'ig'ant'a
pravigante	prav'ig'ant'e
pravigebla	prav'ig'ebl'a
pravigeblaj	prav'ig'ebl'a'j
pravigeblas	prav'ig'ebl'as
pravigeble	prav'ig'ebl'e
pravigita	prav'ig'it'a
pravigitaj	prav'ig'it'a'j
pravigite	prav'ig'it'e
precedenco	precedenc'o
precedencoj	precedenc'o'j
precedencojn	precedenc'o'j'n
precedencon	precedenc'o'n
preceptoj	precept'o'j
preceptojn	precept'o'j'n
precesio	precesi'o
precipa	precip'a
precipaj	precip'a'j
precipajn	precip'a'j'n
precipan	precip'a'n
precipe	precip'e
precipitado	precipit'ad'o
precipitaĵo	precipit'aĵ'o
precipitaĵoj	precipit'aĵ'o'j
precipitaĵon	precipit'aĵ'o'n
precipitiĝas	precipit'iĝ'as
preciza	preciz'a
precizaj	preciz'a'j
precizajn	preciz'a'j'n
precizan	preciz'a'n
precize	preciz'e
precizo	preciz'o
precizon	preciz'o'n
precizecaj	preciz'ec'a'j
precizeco	preciz'ec'o
precizecon	preciz'ec'o'n
precizegaj	preciz'eg'a'j
precizema	preciz'em'a
preciziga	preciz'ig'a
precizigaj	preciz'ig'a'j
precizigas	preciz'ig'as
precizigi	preciz'ig'i
precizigis	preciz'ig'is
precizigo	preciz'ig'o
precizigon	preciz'ig'o'n
precizigu	preciz'ig'u
precizigado	preciz'ig'ad'o
precizigante	preciz'ig'ant'e
precizigita	preciz'ig'it'a
precizigitaj	preciz'ig'it'a'j
precizigitajn	preciz'ig'it'a'j'n
precizigitan	preciz'ig'it'a'n
precizigite	preciz'ig'it'e
predas	pred'as
predi	pred'i
predo	pred'o
predoj	pred'o'j
predojn	pred'o'j'n
predon	pred'o'n
predado	pred'ad'o
predadon	pred'ad'o'n
predanto	pred'ant'o
predantoj	pred'ant'o'j
predantojn	pred'ant'o'j'n
predanton	pred'ant'o'n
predspecioj	pred'speci'o'j
predikas	predik'as
prediki	predik'i
predikis	predik'is
prediko	predik'o
predikoj	predik'o'j
predikojn	predik'o'j'n
predikon	predik'o'n
predikos	predik'os
prediku	predik'u
predikadis	predik'ad'is
predikado	predik'ad'o
predikadon	predik'ad'o'n
predikante	predik'ant'e
predikanto	predik'ant'o
predikantoj	predik'ant'o'j
predikato	predik'at'o
predikatoj	predik'at'o'j
predikatojn	predik'at'o'j'n
predikaton	predik'at'o'n
predikejo	predik'ej'o
predikisto	predik'ist'o
predikistoj	predik'ist'o'j
predikata	predikat'a
predikato	predikat'o
predikatoj	predikat'o'j
predikatojn	predikat'o'j'n
predikaton	predikat'o'n
predikativa	predikativ'a
predikativo	predikativ'o
predikativoj	predikativ'o'j
prefaco	prefac'o
prefekto	prefekt'o
prefektoj	prefekt'o'j
prefektejo	prefekt'ej'o
prefektejoj	prefekt'ej'o'j
prefektujo	prefekt'uj'o
prefera	prefer'a
preferas	prefer'as
prefere	prefer'e
preferi	prefer'i
preferis	prefer'is
prefero	prefer'o
preferoj	prefer'o'j
preferojn	prefer'o'j'n
preferon	prefer'o'n
preferos	prefer'os
preferu	prefer'u
preferus	prefer'us
preferado	prefer'ad'o
preferanta	prefer'ant'a
preferantaj	prefer'ant'a'j
preferante	prefer'ant'e
preferata	prefer'at'a
preferataj	prefer'at'a'j
preferatajn	prefer'at'a'j'n
preferatan	prefer'at'a'n
preferate	prefer'at'e
prefereble	prefer'ebl'e
preferinda	prefer'ind'a
preferindaj	prefer'ind'a'j
preferindas	prefer'ind'as
preferinde	prefer'ind'e
preferindus	prefer'ind'us
preferinta	prefer'int'a
preferintus	prefer'int'us
preferita	prefer'it'a
preferitaj	prefer'it'a'j
preferitajn	prefer'it'a'j'n
preferitan	prefer'it'a'n
preferite	prefer'it'e
prefikso	prefiks'o
prefiksoj	prefiks'o'j
prefiksojn	prefiks'o'j'n
prefikson	prefiks'o'n
prefikseca	prefiks'ec'a
prefiksece	prefiks'ec'e
prefiksita	prefiks'it'a
prefiksitaj	prefiks'it'a'j
preĝa	preĝ'a
preĝaj	preĝ'a'j
preĝas	preĝ'as
preĝe	preĝ'e
preĝi	preĝ'i
preĝis	preĝ'is
preĝo	preĝ'o
preĝoj	preĝ'o'j
preĝojn	preĝ'o'j'n
preĝon	preĝ'o'n
preĝos	preĝ'os
preĝu	preĝ'u
preĝus	preĝ'us
preĝadis	preĝ'ad'is
preĝado	preĝ'ad'o
preĝadoj	preĝ'ad'o'j
preĝadon	preĝ'ad'o'n
preĝanta	preĝ'ant'a
preĝantaj	preĝ'ant'a'j
preĝante	preĝ'ant'e
preĝanto	preĝ'ant'o
preĝantoj	preĝ'ant'o'j
preĝata	preĝ'at'a
preĝeja	preĝ'ej'a
preĝejaj	preĝ'ej'a'j
preĝejajn	preĝ'ej'a'j'n
preĝejan	preĝ'ej'a'n
preĝejo	preĝ'ej'o
preĝejoj	preĝ'ej'o'j
preĝejojn	preĝ'ej'o'j'n
preĝejon	preĝ'ej'o'n
preĝejeto	preĝ'ej'et'o
preĝhalo	preĝ'hal'o
preĝlibro	preĝ'libr'o
preĝlibroj	preĝ'libr'o'j
preĝlibron	preĝ'libr'o'n
prelato	prelat'o
prelatoj	prelat'o'j
prelega	preleg'a
prelegas	preleg'as
prelegi	preleg'i
prelegis	preleg'is
prelego	preleg'o
prelegoj	preleg'o'j
prelegojn	preleg'o'j'n
prelegon	preleg'o'n
prelegos	preleg'os
prelegado	preleg'ad'o
prelegante	preleg'ant'e
preleganto	preleg'ant'o
prelegantoj	preleg'ant'o'j
prelegantojn	preleg'ant'o'j'n
preleganton	preleg'ant'o'n
prelegaro	preleg'ar'o
prelegejo	preleg'ej'o
prelegisto	preleg'ist'o
preludo	prelud'o
preludon	prelud'o'n
prema	prem'a
premaj	prem'a'j
preman	prem'a'n
premas	prem'as
preme	prem'e
premi	prem'i
premis	prem'is
premo	prem'o
premoj	prem'o'j
premojn	prem'o'j'n
premon	prem'o'n
premos	prem'os
premu	prem'u
premus	prem'us
premadas	prem'ad'as
premadi	prem'ad'i
premadis	prem'ad'is
premado	prem'ad'o
premadon	prem'ad'o'n
premaero	prem'aer'o
premaeron	prem'aer'o'n
premanta	prem'ant'a
premantaj	prem'ant'a'j
premante	prem'ant'e
premata	prem'at'a
premataj	prem'at'a'j
premdiferenco	prem'diferenc'o
premdiferencoj	prem'diferenc'o'j
premegas	prem'eg'as
premegis	prem'eg'is
premfalo	prem'fal'o
premforto	prem'fort'o
premforton	prem'fort'o'n
premgrupo	prem'grup'o
premgrupoj	prem'grup'o'j
premiĝas	prem'iĝ'as
premiĝis	prem'iĝ'is
premilo	prem'il'o
preminte	prem'int'e
premita	prem'it'a
premitaj	prem'it'a'j
premitan	prem'it'a'n
premite	prem'it'e
premsigno	prem'sign'o
premsignoj	prem'sign'o'j
premsignojn	prem'sign'o'j'n
premsignon	prem'sign'o'n
premsonĝo	prem'sonĝ'o
premujo	prem'uj'o
premia	premi'a
premias	premi'as
premii	premi'i
premiis	premi'is
premio	premi'o
premioj	premi'o'j
premiojn	premi'o'j'n
premion	premi'o'n
premios	premi'os
premiado	premi'ad'o
premiante	premi'ant'e
premiita	premi'it'a
premiitaj	premi'it'a'j
premiitajn	premi'it'a'j'n
premiito	premi'it'o
premiitoj	premi'it'o'j
premioceremonio	premi'o'ceremoni'o
premiere	premier'e
premieris	premier'is
premiero	premier'o
premieroj	premier'o'j
premieron	premier'o'n
premisas	premis'as
premiso	premis'o
premisoj	premis'o'j
premisojn	premis'o'j'n
prenas	pren'as
preni	pren'i
prenis	pren'is
preno	pren'o
prenoj	pren'o'j
prenon	pren'o'n
prenos	pren'os
prenu	pren'u
prenus	pren'us
prenadis	pren'ad'is
prenado	pren'ad'o
prenanta	pren'ant'a
prenantaj	pren'ant'a'j
prenantan	pren'ant'a'n
prenante	pren'ant'e
prenanto	pren'ant'o
prenata	pren'at'a
prenataj	pren'at'a'j
prenilo	pren'il'o
preniloj	pren'il'o'j
preninta	pren'int'a
prenintaj	pren'int'a'j
preninte	pren'int'e
prenintus	pren'int'us
prenita	pren'it'a
prenitaj	pren'it'a'j
prenitajn	pren'it'a'j'n
prenitan	pren'it'a'n
prenite	pren'it'e
prenota	pren'ot'a
prepara	prepar'a
preparaj	prepar'a'j
preparajn	prepar'a'j'n
preparan	prepar'a'n
preparas	prepar'as
prepare	prepar'e
prepari	prepar'i
preparis	prepar'is
preparo	prepar'o
preparoj	prepar'o'j
preparojn	prepar'o'j'n
preparon	prepar'o'n
preparos	prepar'os
preparu	prepar'u
preparus	prepar'us
preparadis	prepar'ad'is
preparado	prepar'ad'o
preparadoj	prepar'ad'o'j
preparadon	prepar'ad'o'n
preparaĵo	prepar'aĵ'o
preparaĵoj	prepar'aĵ'o'j
preparanta	prepar'ant'a
preparantaj	prepar'ant'a'j
preparantas	prepar'ant'as
preparante	prepar'ant'e
preparata	prepar'at'a
preparataj	prepar'at'a'j
preparatas	prepar'at'as
preparebla	prepar'ebl'a
prepareblaj	prepar'ebl'a'j
prepareblas	prepar'ebl'as
prepariĝas	prepar'iĝ'as
prepariĝi	prepar'iĝ'i
prepariĝis	prepar'iĝ'is
prepariĝo	prepar'iĝ'o
prepariĝu	prepar'iĝ'u
prepariĝante	prepar'iĝ'ant'e
preparinta	prepar'int'a
preparinte	prepar'int'e
preparita	prepar'it'a
preparitaj	prepar'it'a'j
preparitajn	prepar'it'a'j'n
preparitan	prepar'it'a'n
preparite	prepar'it'e
prepariteco	prepar'it'ec'o
preparitecon	prepar'it'ec'o'n
preparlaboro	prepar'labor'o
preparlaboroj	prepar'labor'o'j
preparlaboron	prepar'labor'o'n
preposto	prepost'o
prepozicia	prepozici'a
prepoziciaj	prepozici'a'j
prepozicio	prepozici'o
prepozicioj	prepozici'o'j
prepoziciojn	prepozici'o'j'n
prepozicion	prepozici'o'n
prepucio	prepuci'o
prepucion	prepuci'o'n
prerio	preri'o
prerioj	preri'o'j
preriojn	preri'o'j'n
prerogativo	prerogativ'o
prerogativoj	prerogativ'o'j
prerogativojn	prerogativ'o'j'n
prerogativon	prerogativ'o'n
presa	pres'a
presas	pres'as
presi	pres'i
presis	pres'is
preso	pres'o
presos	pres'os
presado	pres'ad'o
presadon	pres'ad'o'n
presaĵo	pres'aĵ'o
presaĵoj	pres'aĵ'o'j
presaĵojn	pres'aĵ'o'j'n
presaĵon	pres'aĵ'o'n
presaĵkreado	pres'aĵ'kre'ad'o
presanta	pres'ant'a
presantaj	pres'ant'a'j
presantan	pres'ant'a'n
presante	pres'ant'e
presarto	pres'art'o
presata	pres'at'a
presataj	pres'at'a'j
presejo	pres'ej'o
presejoj	pres'ej'o'j
presejon	pres'ej'o'n
preseraro	pres'erar'o
preseraroj	pres'erar'o'j
preserarojn	pres'erar'o'j'n
preserargrafika	pres'erar'grafik'a
preserargrafikaj	pres'erar'grafik'a'j
presigas	pres'ig'as
presigi	pres'ig'i
presigis	pres'ig'is
presigo	pres'ig'o
presiĝis	pres'iĝ'is
presilo	pres'il'o
presiloj	pres'il'o'j
presilon	pres'il'o'n
presisto	pres'ist'o
presistoj	pres'ist'o'j
presita	pres'it'a
presitaj	pres'it'a'j
presitajn	pres'it'a'j'n
presitan	pres'it'a'n
presite	pres'it'e
presliteroj	pres'liter'o'j
presmaŝino	pres'maŝin'o
presorgano	pres'organ'o
prespreta	pres'pret'a
presbitoj	presbit'o'j
presbitera	presbiter'a
presbitero	presbiter'o
presbiteroj	presbiter'o'j
presbiterejo	presbiter'ej'o
presbiterkristana	presbiter'krist'an'a
presbiterianoj	presbiterian'o'j
preskaŭ	preskaŭ
preskaŭa	preskaŭ'a
preskaŭesprima	preskaŭ'esprim'a
preskriba	preskrib'a
preskribaj	preskrib'a'j
preskribas	preskrib'as
preskribi	preskrib'i
preskribis	preskrib'is
preskribo	preskrib'o
preskriboj	preskrib'o'j
preskribojn	preskrib'o'j'n
preskribon	preskrib'o'n
preskribado	preskrib'ad'o
preskribita	preskrib'it'a
preskribitaj	preskrib'it'a'j
preskribitajn	preskrib'it'a'j'n
preskribitan	preskrib'it'a'n
prestiĝa	prestiĝ'a
prestigha	prestiĝ'a
prestiĝaj	prestiĝ'a'j
prestiĝajn	prestiĝ'a'j'n
prestiĝan	prestiĝ'a'n
prestigho	prestiĝ'o
prestiĝo	prestiĝ'o
prestiĝon	prestiĝ'o'n
preta	pret'a
pretaj	pret'a'j
pretajn	pret'a'j'n
pretan	pret'a'n
pretas	pret'as
prete	pret'e
preti	pret'i
pretis	pret'is
preto	pret'o
pretos	pret'os
pretu	pret'u
pretus	pret'us
preteco	pret'ec'o
pretecon	pret'ec'o'n
pretigas	pret'ig'as
pretigi	pret'ig'i
pretigis	pret'ig'is
pretigo	pret'ig'o
pretigon	pret'ig'o'n
pretigos	pret'ig'os
pretigu	pret'ig'u
pretigado	pret'ig'ad'o
pretiganta	pret'ig'ant'a
pretigante	pret'ig'ant'e
pretigataj	pret'ig'at'a'j
pretigita	pret'ig'it'a
pretigitaj	pret'ig'it'a'j
pretigitajn	pret'ig'it'a'j'n
pretigpotenco	pret'ig'potenc'o
pretiĝas	pret'iĝ'as
pretiĝi	pret'iĝ'i
pretiĝis	pret'iĝ'is
pretiĝu	pret'iĝ'u
pretitaj	pret'it'a'j
pretmanĝaĵoj	pret'manĝ'aĵ'o'j
pretekstas	pretekst'as
pretekste	pretekst'e
pretekstis	pretekst'is
preteksto	pretekst'o
pretekstoj	pretekst'o'j
pretekstojn	pretekst'o'j'n
pretekston	pretekst'o'n
pretekstante	pretekst'ant'e
pretenda	pretend'a
pretendas	pretend'as
pretendi	pretend'i
pretendis	pretend'is
pretendo	pretend'o
pretendoj	pretend'o'j
pretendojn	pretend'o'j'n
pretendon	pretend'o'n
pretendu	pretend'u
pretendus	pretend'us
pretendante	pretend'ant'e
pretendata	pretend'at'a
pretendema	pretend'em'a
pretendemaj	pretend'em'a'j
preter	preter
preteras	preter'as
pretere	preter'e
preteri	preter'i
preteris	preter'is
preteratentas	preter'atent'as
preteratenti	preter'atent'i
preteratentis	preter'atent'is
preteratentu	preter'atent'u
preteratentanta	preter'atent'ant'a
preteratentante	preter'atent'ant'e
preteratentita	preter'atent'it'a
preteratentitaj	preter'atent'it'a'j
preterdormis	preter'dorm'is
preterflugas	preter'flug'as
preterflugis	preter'flug'is
preterintenca	preter'intenc'a
preterintence	preter'intenc'e
preteriras	preter'ir'as
preteriri	preter'ir'i
preteriris	preter'ir'is
preteriros	preter'ir'os
preteriranta	preter'ir'ant'a
preterirante	preter'ir'ant'e
preterirantoj	preter'ir'ant'o'j
preteririta	preter'ir'it'a
preteriritaj	preter'ir'it'a'j
preterkuris	preter'kur'is
preterlasas	preter'las'as
preterlasi	preter'las'i
preterlasis	preter'las'is
preterlaso	preter'las'o
preterlasoj	preter'las'o'j
preterlasos	preter'las'os
preterlasu	preter'las'u
preterlasus	preter'las'us
preterlasante	preter'las'ant'e
preterlasita	preter'las'it'a
preterlasitaj	preter'las'it'a'j
pretermemora	preter'memor'a
preterpasa	preter'pas'a
preterpasas	preter'pas'as
preterpase	preter'pas'e
preterpasi	preter'pas'i
preterpasis	preter'pas'is
preterpaso	preter'pas'o
preterpasos	preter'pas'os
preterpasu	preter'pas'u
preterpasado	preter'pas'ad'o
preterpasanta	preter'pas'ant'a
preterpasantaj	preter'pas'ant'a'j
preterpasantajn	preter'pas'ant'a'j'n
preterpasantan	preter'pas'ant'a'n
preterpasante	preter'pas'ant'e
preterpasanto	preter'pas'ant'o
preterpasantoj	preter'pas'ant'o'j
preterpasantojn	preter'pas'ant'o'j'n
preterpasinte	preter'pas'int'e
preterpasita	preter'pas'it'a
preterpasitaj	preter'pas'it'a'j
preterpasite	preter'pas'it'e
preterpaŝis	preter'paŝ'is
preterplanaj	preter'plan'a'j
preterveturi	preter'vetur'i
preterveturis	preter'vetur'is
preterveturanta	preter'vetur'ant'a
pretervidas	preter'vid'as
pretervidi	preter'vid'i
pretervidis	preter'vid'is
pretervivi	preter'viv'i
pretervivis	preter'viv'is
pretervojo	preter'voj'o
pretervola	preter'vol'a
pretervolaj	preter'vol'a'j
pretervole	preter'vol'e
preterito	preterit'o
preteriton	preterit'o'n
pretoro	pretor'o
pretoroj	pretor'o'j
pretorio	pretori'o
pretoriana	pretori'an'a
pretorianoj	pretori'an'o'j
preventa	prevent'a
preventaj	prevent'a'j
preventajn	prevent'a'j'n
preventan	prevent'a'n
preventas	prevent'as
preventi	prevent'i
preventis	prevent'is
prevento	prevent'o
preventon	prevent'o'n
preventado	prevent'ad'o
preventadon	prevent'ad'o'n
preventebla	prevent'ebl'a
preventilo	prevent'il'o
preza	prez'a
prezo	prez'o
prezoj	prez'o'j
prezojn	prez'o'j'n
prezon	prez'o'n
prezaltiĝo	prez'alt'iĝ'o
prezaltiĝoj	prez'alt'iĝ'o'j
prezaro	prez'ar'o
prezaron	prez'ar'o'n
preziga	prez'ig'a
prezigi	prez'ig'i
prezigado	prez'ig'ad'o
preziganta	prez'ig'ant'a
prezigita	prez'ig'it'a
prezkontroloj	prez'kontrol'o'j
prezenca	prezenc'a
prezenco	prezenc'o
prezencoj	prezenc'o'j
prezenta	prezent'a
prezentaj	prezent'a'j
prezentan	prezent'a'n
prezentas	prezent'as
prezenti	prezent'i
prezentis	prezent'is
prezento	prezent'o
prezentoj	prezent'o'j
prezentojn	prezent'o'j'n
prezenton	prezent'o'n
prezentos	prezent'os
prezentu	prezent'u
prezentus	prezent'us
prezentada	prezent'ad'a
prezentadis	prezent'ad'is
prezentado	prezent'ad'o
prezentadoj	prezent'ad'o'j
prezentadojn	prezent'ad'o'j'n
prezentadon	prezent'ad'o'n
prezentaĵo	prezent'aĵ'o
prezentaĵoj	prezent'aĵ'o'j
prezentaĵojn	prezent'aĵ'o'j'n
prezentaĵon	prezent'aĵ'o'n
prezentanta	prezent'ant'a
prezentantaj	prezent'ant'a'j
prezentantajn	prezent'ant'a'j'n
prezentantan	prezent'ant'a'n
prezentante	prezent'ant'e
prezentanto	prezent'ant'o
prezentantoj	prezent'ant'o'j
prezentartoj	prezent'art'o'j
prezentata	prezent'at'a
prezentataj	prezent'at'a'j
prezentatas	prezent'at'as
prezentebla	prezent'ebl'a
prezenteblaj	prezent'ebl'a'j
prezentiĝas	prezent'iĝ'as
prezentiĝi	prezent'iĝ'i
prezentiĝis	prezent'iĝ'is
prezentiĝo	prezent'iĝ'o
prezentiĝoj	prezent'iĝ'o'j
prezentiĝojn	prezent'iĝ'o'j'n
prezentiĝon	prezent'iĝ'o'n
prezentiĝos	prezent'iĝ'os
prezentiĝus	prezent'iĝ'us
prezentiĝante	prezent'iĝ'ant'e
prezentinta	prezent'int'a
prezentisto	prezent'ist'o
prezentistoj	prezent'ist'o'j
prezentistojn	prezent'ist'o'j'n
prezentiston	prezent'ist'o'n
prezentita	prezent'it'a
prezentitaj	prezent'it'a'j
prezentitajn	prezent'it'a'j'n
prezentitan	prezent'it'a'n
prezentite	prezent'it'e
prezentota	prezent'ot'a
prezida	prezid'a
prezidas	prezid'as
prezidi	prezid'i
prezidis	prezid'is
prezido	prezid'o
prezidon	prezid'o'n
prezidos	prezid'os
prezidado	prezid'ad'o
prezidadoficiro	prezid'ad'oficir'o
prezidanta	prezid'ant'a
prezidantaj	prezid'ant'a'j
prezidantan	prezid'ant'a'n
prezidante	prezid'ant'e
prezidanto	prezid'ant'o
prezidantoj	prezid'ant'o'j
prezidantojn	prezid'ant'o'j'n
prezidanton	prezid'ant'o'n
prezidantaro	prezid'ant'ar'o
prezidanteco	prezid'ant'ec'o
prezidantecon	prezid'ant'ec'o'n
prezidantedzino	prezid'ant'edz'in'o
prezidantelekto	prezid'ant'elekt'o
prezidantelektoj	prezid'ant'elekt'o'j
prezidantiĝo	prezid'ant'iĝ'o
prezidantino	prezid'ant'in'o
prezidantinon	prezid'ant'in'o'n
prezidata	prezid'at'a
prezidinto	prezid'int'o
prezidita	prezid'it'a
prezidenta	prezident'a
prezidentaj	prezident'a'j
prezidentajn	prezident'a'j'n
prezidentan	prezident'a'n
prezidento	prezident'o
prezidentoj	prezident'o'j
prezidenton	prezident'o'n
prezidenteco	prezident'ec'o
prezidentecon	prezident'ec'o'n
prezidentedzino	prezident'edz'in'o
prezidentejo	prezident'ej'o
prezidentelekto	prezident'elekt'o
prezidentiĝo	prezident'iĝ'o
prezidentino	prezident'in'o
prezidio	prezidi'o
pri	pri
prie	pri'e
priama	pri'am'a
priamo	pri'am'o
priamon	pri'am'o'n
priatentas	pri'atent'as
priatenti	pri'atent'i
priatentis	pri'atent'is
priatentu	pri'atent'u
pribatalita	pri'batal'it'a
pribatalitaj	pri'batal'it'a'j
pridemandas	pri'demand'as
pridemandi	pri'demand'i
pridemandis	pri'demand'is
pridemando	pri'demand'o
pridemandu	pri'demand'u
pridemandadis	pri'demand'ad'is
pridemandado	pri'demand'ad'o
pridemandata	pri'demand'at'a
pridemandita	pri'demand'it'a
pridemanditaj	pri'demand'it'a'j
pridemandite	pri'demand'it'e
pridiskutas	pri'diskut'as
pridiskuti	pri'diskut'i
pridiskutis	pri'diskut'is
pridiskuto	pri'diskut'o
pridiskutos	pri'diskut'os
pridiskutu	pri'diskut'u
pridiskutata	pri'diskut'at'a
pridiskutataj	pri'diskut'at'a'j
pridiskutita	pri'diskut'it'a
pridiskutitaj	pri'diskut'it'a'j
pridisputas	pri'disput'as
pridisputis	pri'disput'is
pridisputata	pri'disput'at'a
pridisputataj	pri'disput'at'a'j
pridisputita	pri'disput'it'a
pridonacas	pri'donac'as
pridubas	pri'dub'as
pridubi	pri'dub'i
pridubis	pri'dub'is
pridubado	pri'dub'ad'o
pridubante	pri'dub'ant'e
pridubata	pri'dub'at'a
pridubita	pri'dub'it'a
pridubitaj	pri'dub'it'a'j
pridubite	pri'dub'it'e
prienketas	pri'enket'as
prienketi	pri'enket'i
prienketis	pri'enket'is
prienketado	pri'enket'ad'o
prienketitaj	pri'enket'it'a'j
priesperanta	pri'esperant'a
priesperantaj	pri'esperant'a'j
priesploras	pri'esplor'as
priesplori	pri'esplor'i
priesploris	pri'esplor'is
priesplorado	pri'esplor'ad'o
prifajfas	pri'fajf'as
prifajfis	pri'fajf'is
prifosado	pri'fos'ad'o
prigardas	pri'gard'as
prigardi	pri'gard'i
prijuĝas	pri'juĝ'as
prijuĝi	pri'juĝ'i
prijuĝis	pri'juĝ'is
prijuĝo	pri'juĝ'o
prijuĝoj	pri'juĝ'o'j
prijuĝon	pri'juĝ'o'n
prijuĝos	pri'juĝ'os
prijuĝu	pri'juĝ'u
prijuĝado	pri'juĝ'ad'o
prikantas	pri'kant'as
prikanti	pri'kant'i
prikantis	pri'kant'is
prikantita	pri'kant'it'a
priklarigi	pri'klar'ig'i
prikomentas	pri'koment'as
prikomenti	pri'koment'i
prikomentis	pri'koment'is
prikomplemento	pri'komplement'o
prikonsideri	pri'konsider'i
prikreskita	pri'kresk'it'a
prilabora	pri'labor'a
prilaboraj	pri'labor'a'j
prilaboran	pri'labor'a'n
prilaboras	pri'labor'as
prilabori	pri'labor'i
prilaboris	pri'labor'is
prilaboro	pri'labor'o
prilaboron	pri'labor'o'n
prilaboros	pri'labor'os
prilaboru	pri'labor'u
prilaborado	pri'labor'ad'o
prilaboradon	pri'labor'ad'o'n
prilaboranta	pri'labor'ant'a
prilaborante	pri'labor'ant'e
prilaborata	pri'labor'at'a
prilaborataj	pri'labor'at'a'j
prilaborebla	pri'labor'ebl'a
prilaborita	pri'labor'it'a
prilaboritaj	pri'labor'it'a'j
prilaboritajn	pri'labor'it'a'j'n
prilaboritan	pri'labor'it'a'n
prilaborite	pri'labor'it'e
prilingva	pri'lingv'a
prilingvaj	pri'lingv'a'j
prilumas	pri'lum'as
prilumi	pri'lum'i
prilumis	pri'lum'is
prilumo	pri'lum'o
prilumado	pri'lum'ad'o
prilumanta	pri'lum'ant'a
prilumante	pri'lum'ant'e
prilumata	pri'lum'at'a
prilumataj	pri'lum'at'a'j
prilumita	pri'lum'it'a
prilumitaj	pri'lum'it'a'j
prilumitan	pri'lum'it'a'n
primediti	pri'medit'i
primokas	pri'mok'as
primoki	pri'mok'i
primokis	pri'mok'is
primoko	pri'mok'o
primoku	pri'mok'u
primovada	pri'mov'ad'a
primovadaj	pri'mov'ad'a'j
prinotita	pri'not'it'a
priokupiĝis	pri'okup'iĝ'is
priokupiĝo	pri'okup'iĝ'o
pripafis	pri'paf'is
pripafado	pri'paf'ad'o
pripagis	pri'pag'is
priparolas	pri'parol'as
priparoli	pri'parol'i
priparolis	pri'parol'is
priparolo	pri'parol'o
priparolos	pri'parol'os
priparolu	pri'parol'u
priparolante	pri'parol'ant'e
priparolata	pri'parol'at'a
priparolataj	pri'parol'at'a'j
priparoligi	pri'parol'ig'i
priparolita	pri'parol'it'a
priparolitaj	pri'parol'it'a'j
pripensa	pri'pens'a
pripensas	pri'pens'as
pripense	pri'pens'e
pripensi	pri'pens'i
pripensis	pri'pens'is
pripenso	pri'pens'o
pripensoj	pri'pens'o'j
pripensojn	pri'pens'o'j'n
pripenson	pri'pens'o'n
pripensos	pri'pens'os
pripensu	pri'pens'u
pripensus	pri'pens'us
pripensadi	pri'pens'ad'i
pripensadis	pri'pens'ad'is
pripensado	pri'pens'ad'o
pripensadoj	pri'pens'ad'o'j
pripensadon	pri'pens'ad'o'n
pripensanta	pri'pens'ant'a
pripensantaj	pri'pens'ant'a'j
pripensante	pri'pens'ant'e
pripensata	pri'pens'at'a
pripensema	pri'pens'em'a
pripensemaj	pri'pens'em'a'j
pripenseme	pri'pens'em'e
pripensiga	pri'pens'ig'a
pripensinda	pri'pens'ind'a
pripensindaj	pri'pens'ind'a'j
pripensinte	pri'pens'int'e
pripensita	pri'pens'it'a
pripensitaj	pri'pens'it'a'j
pripensitan	pri'pens'it'a'n
pripensite	pri'pens'it'e
pripentrita	pri'pentr'it'a
priplantis	pri'plant'is
priplantita	pri'plant'it'a
priplantitaj	pri'plant'it'a'j
priploras	pri'plor'as
priplori	pri'plor'i
priploris	pri'plor'is
priplorinda	pri'plor'ind'a
prirabas	pri'rab'as
prirabi	pri'rab'i
prirabis	pri'rab'is
prirabado	pri'rab'ad'o
prirabante	pri'rab'ant'e
prirabita	pri'rab'it'a
prirabitaj	pri'rab'it'a'j
priraportado	pri'raport'ad'o
priraportadon	pri'raport'ad'o'n
priregi	pri'reg'i
priregis	pri'reg'is
prirezignas	pri'rezign'as
prirezigni	pri'rezign'i
prirezignis	pri'rezign'is
prirezignus	pri'rezign'us
prirezignado	pri'rezign'ad'o
prirezignante	pri'rezign'ant'e
prirezignita	pri'rezign'it'a
prirezignitaj	pri'rezign'it'a'j
priridas	pri'rid'as
priridi	pri'rid'i
priridis	pri'rid'is
priridos	pri'rid'os
priridu	pri'rid'u
pririgardas	pri'rigard'as
pririgardi	pri'rigard'i
pririgardis	pri'rigard'is
pririgardo	pri'rigard'o
pririgardadis	pri'rigard'ad'is
pririgardanta	pri'rigard'ant'a
pririgardante	pri'rigard'ant'e
pririgardinte	pri'rigard'int'e
prisana	pri'san'a
prisanaj	pri'san'a'j
prisemis	pri'sem'is
prisemita	pri'sem'it'a
priserĉas	pri'serĉ'as
priserĉi	pri'serĉ'i
priserĉis	pri'serĉ'is
priserĉo	pri'serĉ'o
priserĉado	pri'serĉ'ad'o
priserĉitaj	pri'serĉ'it'a'j
priservas	pri'serv'as
priservi	pri'serv'i
priservis	pri'serv'is
priservo	pri'serv'o
priservado	pri'serv'ad'o
priservata	pri'serv'at'a
prisignas	pri'sign'as
prisignita	pri'sign'it'a
prisignitaj	pri'sign'it'a'j
prisilentas	pri'silent'as
prisilenti	pri'silent'i
prisilentis	pri'silent'is
prisilentu	pri'silent'u
prisilentado	pri'silent'ad'o
priskriba	pri'skrib'a
priskribaj	pri'skrib'a'j
priskribajn	pri'skrib'a'j'n
priskriban	pri'skrib'a'n
priskribas	pri'skrib'as
priskribe	pri'skrib'e
priskribi	pri'skrib'i
priskribis	pri'skrib'is
priskribo	pri'skrib'o
priskriboj	pri'skrib'o'j
priskribojn	pri'skrib'o'j'n
priskribon	pri'skrib'o'n
priskribos	pri'skrib'os
priskribu	pri'skrib'u
priskribus	pri'skrib'us
priskribado	pri'skrib'ad'o
priskribanta	pri'skrib'ant'a
priskribantaj	pri'skrib'ant'a'j
priskribantajn	pri'skrib'ant'a'j'n
priskribantan	pri'skrib'ant'a'n
priskribante	pri'skrib'ant'e
priskribata	pri'skrib'at'a
priskribataj	pri'skrib'at'a'j
priskribatan	pri'skrib'at'a'n
priskribebla	pri'skrib'ebl'a
priskribeblaj	pri'skrib'ebl'a'j
priskribeblas	pri'skrib'ebl'as
priskribiĝas	pri'skrib'iĝ'as
priskribilo	pri'skrib'il'o
priskribita	pri'skrib'it'a
priskribitaj	pri'skrib'it'a'j
priskribitajn	pri'skrib'it'a'j'n
priskribitan	pri'skrib'it'a'n
priskribite	pri'skrib'it'e
priŝtelas	pri'ŝtel'as
priŝteli	pri'ŝtel'i
priŝtelis	pri'ŝtel'is
priŝtelita	pri'ŝtel'it'a
pristudas	pri'stud'as
pristudi	pri'stud'i
pristudis	pri'stud'is
pristudo	pri'stud'o
pristudu	pri'stud'u
pristudata	pri'stud'at'a
pristudita	pri'stud'it'a
pritaksas	pri'taks'as
pritaksi	pri'taks'i
pritaksis	pri'taks'is
pritakso	pri'taks'o
pritaksoj	pri'taks'o'j
pritakson	pri'taks'o'n
pritaksado	pri'taks'ad'o
pritaksata	pri'taks'at'a
pritaksita	pri'taks'it'a
pritemas	pri'tem'as
pritondis	pri'tond'is
pritraktaj	pri'trakt'a'j
pritraktas	pri'trakt'as
pritrakti	pri'trakt'i
pritraktis	pri'trakt'is
pritrakto	pri'trakt'o
pritrakton	pri'trakt'o'n
pritraktos	pri'trakt'os
pritraktu	pri'trakt'u
pritraktus	pri'trakt'us
pritraktado	pri'trakt'ad'o
pritraktadon	pri'trakt'ad'o'n
pritraktanta	pri'trakt'ant'a
pritraktantaj	pri'trakt'ant'a'j
pritraktantajn	pri'trakt'ant'a'j'n
pritraktante	pri'trakt'ant'e
pritraktata	pri'trakt'at'a
pritraktataj	pri'trakt'at'a'j
pritraktita	pri'trakt'it'a
pritraktitaj	pri'trakt'it'a'j
pritraktite	pri'trakt'it'e
priverŝita	pri'verŝ'it'a
prizorgas	pri'zorg'as
prizorgi	pri'zorg'i
prizorgis	pri'zorg'is
prizorgo	pri'zorg'o
prizorgoj	pri'zorg'o'j
prizorgon	pri'zorg'o'n
prizorgos	pri'zorg'os
prizorgu	pri'zorg'u
prizorgus	pri'zorg'us
prizorgado	pri'zorg'ad'o
prizorgadon	pri'zorg'ad'o'n
prizorganta	pri'zorg'ant'a
prizorgantaj	pri'zorg'ant'a'j
prizorgante	pri'zorg'ant'e
prizorganto	pri'zorg'ant'o
prizorgantoj	pri'zorg'ant'o'j
prizorganton	pri'zorg'ant'o'n
prizorgata	pri'zorg'at'a
prizorgataj	pri'zorg'at'a'j
prizorgita	pri'zorg'it'a
prizorgitaj	pri'zorg'it'a'j
prizorgitan	pri'zorg'it'a'n
prizorgite	pri'zorg'it'e
prizorgokostoj	pri'zorg'o'kost'o'j
prizorgokostojn	pri'zorg'o'kost'o'j'n
priapo	priap'o
prima	prim'a
primaj	prim'a'j
prime	prim'e
primo	prim'o
primoj	prim'o'j
primadono	primadon'o
primara	primar'a
primaraj	primar'a'j
primarajn	primar'a'j'n
primaran	primar'a'n
primare	primar'e
primarkoloroj	primar'kolor'o'j
primarproduktado	primar'produkt'ad'o
primaso	primas'o
primaseco	primas'ec'o
primato	primat'o
primatoj	primat'o'j
primavera	primaver'a
primavero	primaver'o
primitiva	primitiv'a
primitivaj	primitiv'a'j
primitivajn	primitiv'a'j'n
primitivan	primitiv'a'n
primitive	primitiv'e
primitiveco	primitiv'ec'o
primitivismo	primitiv'ism'o
primitivulo	primitiv'ul'o
primitivuloj	primitiv'ul'o'j
primitivulojn	primitiv'ul'o'j'n
primoloj	primol'o'j
primuso	primus'o
primuson	primus'o'n
princa	princ'a
princaj	princ'a'j
princan	princ'a'n
prince	princ'e
princo	princ'o
princoj	princ'o'j
princojn	princ'o'j'n
princon	princ'o'n
princelektisto	princ'elekt'ist'o
princepiskopo	princ'episkop'o
princepiskopejo	princ'episkop'ej'o
princepiskopujo	princ'episkop'uj'o
princeton	princ'et'o'n
princido	princ'id'o
princidino	princ'id'in'o
princino	princ'in'o
princinoj	princ'in'o'j
princinojn	princ'in'o'j'n
princinon	princ'in'o'n
princlando	princ'land'o
princlandoj	princ'land'o'j
princlandojn	princ'land'o'j'n
princlandon	princ'land'o'n
princoelektisto	princ'o'elekt'ist'o
principa	princip'a
principaj	princip'a'j
principajn	princip'a'j'n
principan	princip'a'n
principe	princip'e
principo	princip'o
principoj	princip'o'j
principojn	princip'o'j'n
principon	princip'o'n
principaro	princip'ar'o
principeo	principe'o
printi	print'i
printado	print'ad'o
printadon	print'ad'o'n
printilo	print'il'o
printiloj	print'il'o'j
printilojn	print'il'o'j'n
printilon	print'il'o'n
printita	print'it'a
printitaj	print'it'a'j
printempa	printemp'a
printempaj	printemp'a'j
printempajn	printemp'a'j'n
printempan	printemp'a'n
printempe	printemp'e
printempo	printemp'o
printempoj	printemp'o'j
printempon	printemp'o'n
prionaj	prion'a'j
prionoj	prion'o'j
prioro	prior'o
prioroj	prior'o'j
priorejo	prior'ej'o
prioritata	prioritat'a
prioritataj	prioritat'a'j
prioritatan	prioritat'a'n
prioritatas	prioritat'as
prioritate	prioritat'e
prioritati	prioritat'i
prioritatis	prioritat'is
prioritato	prioritat'o
prioritatoj	prioritat'o'j
prioritatojn	prioritat'o'j'n
prioritaton	prioritat'o'n
prioritatigi	prioritat'ig'i
prisma	prism'a
prismaj	prism'a'j
prismo	prism'o
prismoj	prism'o'j
prismon	prism'o'n
privata	privat'a
privataj	privat'a'j
privatajn	privat'a'j'n
privatan	privat'a'n
private	privat'e
privatdetektivo	privat'detektiv'o
privateco	privat'ec'o
privatecon	privat'ec'o'n
privateckonzernoj	privat'ec'konzern'o'j
privatentrepreno	privat'entrepren'o
privatfirmao	privat'firma'o
privatfirmaoj	privat'firma'o'j
privatigi	privat'ig'i
privatigo	privat'ig'o
privatigoj	privat'ig'o'j
privatigon	privat'ig'o'n
privatigita	privat'ig'it'a
privatigitaj	privat'ig'it'a'j
privatindustrio	privat'industri'o
privatlernejoj	privat'lern'ej'o'j
privatposedata	privat'posed'at'a
privatposedataj	privat'posed'at'a'j
privatproprieto	privat'propriet'o
privatproprieton	privat'propriet'o'n
privatsektora	privat'sektor'a
privatsektoraj	privat'sektor'a'j
privatulo	privat'ul'o
privatuloj	privat'ul'o'j
privilegia	privilegi'a
privilegiaj	privilegi'a'j
privilegian	privilegi'a'n
privilegias	privilegi'as
privilegie	privilegi'e
privilegii	privilegi'i
privilegio	privilegi'o
privilegioj	privilegi'o'j
privilegiojn	privilegi'o'j'n
privilegion	privilegi'o'n
privilegiita	privilegi'it'a
privilegiitaj	privilegi'it'a'j
privilegiuloj	privilegi'ul'o'j
prizona	prizon'a
prizonaj	prizon'a'j
prizonan	prizon'a'n
prizono	prizon'o
prizonoj	prizon'o'j
prizonon	prizon'o'n
prizonestro	prizon'estr'o
prizonpastro	prizon'pastr'o
prizonulo	prizon'ul'o
prizonuloj	prizon'ul'o'j
prizonulojn	prizon'ul'o'j'n
prizonulon	prizon'ul'o'n
pro	pro
proparolanto	pro'parol'ant'o
proparolantoj	pro'parol'ant'o'j
proparolantino	pro'parol'ant'in'o
propeka	pro'pek'a
propeti	pro'pet'i
propeto	pro'pet'o
probabla	probabl'a
probablaj	probabl'a'j
probablan	probabl'a'n
probablas	probabl'as
probable	probabl'e
probablo	probabl'o
probabloj	probabl'o'j
probablon	probabl'o'n
probableco	probabl'ec'o
probablecoj	probabl'ec'o'j
probablecon	probabl'ec'o'n
probablokalkulo	probabl'o'kalkul'o
problema	problem'a
problemaj	problem'a'j
problemajn	problem'a'j'n
probleman	problem'a'n
problemas	problem'as
probleme	problem'e
problemo	problem'o
problemoj	problem'o'j
problemojn	problem'o'j'n
problemon	problem'o'n
problemaro	problem'ar'o
problemaron	problem'ar'o'n
problemego	problem'eg'o
problemeto	problem'et'o
problemetoj	problem'et'o'j
problemsolva	problem'solv'a
problemsolvaj	problem'solv'a'j
problemsolvo	problem'solv'o
procedas	proced'as
procede	proced'e
procedi	proced'i
procedis	proced'is
procedo	proced'o
procedoj	proced'o'j
procedojn	proced'o'j'n
procedon	proced'o'n
procedu	proced'u
procedmaniero	proced'manier'o
procedmanieron	proced'manier'o'n
procedura	procedur'a
proceduraj	procedur'a'j
procedurajn	procedur'a'j'n
proceduran	procedur'a'n
proceduro	procedur'o
proceduroj	procedur'o'j
procedurojn	procedur'o'j'n
proceduron	procedur'o'n
procelarioformaj	procelari'o'form'a'j
procento	procent'o
procentoj	procent'o'j
procentojn	procent'o'j'n
procenton	procent'o'n
procentaĵo	procent'aĵ'o
procentaĵon	procent'aĵ'o'n
procesas	proces'as
procesi	proces'i
procesis	proces'is
proceso	proces'o
procesoj	proces'o'j
procesojn	proces'o'j'n
proceson	proces'o'n
procesantoj	proces'ant'o'j
procesigi	proces'ig'i
procesigo	proces'ig'o
procesigoj	proces'ig'o'j
procesigon	proces'ig'o'n
procesigita	proces'ig'it'a
procesigitaj	proces'ig'it'a'j
procesie	procesi'e
procesio	procesi'o
procesioj	procesi'o'j
procesiojn	procesi'o'j'n
procesion	procesi'o'n
procesoro	procesor'o
procesoroj	procesor'o'j
procesorojn	procesor'o'j'n
procesoron	procesor'o'n
proceza	procez'a
procezo	procez'o
procezoj	procez'o'j
procezojn	procez'o'j'n
procezon	procez'o'n
procezado	procez'ad'o
procezilo	procez'il'o
proceziloj	procez'il'o'j
procezitaj	procez'it'a'j
produkta	produkt'a
produktaj	produkt'a'j
produktajn	produkt'a'j'n
produktan	produkt'a'n
produktas	produkt'as
produkti	produkt'i
produktis	produkt'is
produkto	produkt'o
produktoj	produkt'o'j
produktojn	produkt'o'j'n
produkton	produkt'o'n
produktos	produkt'os
produktu	produkt'u
produktus	produkt'us
produktada	produkt'ad'a
produktadaj	produkt'ad'a'j
produktadajn	produkt'ad'a'j'n
produktadan	produkt'ad'a'n
produktadis	produkt'ad'is
produktado	produkt'ad'o
produktadoj	produkt'ad'o'j
produktadojn	produkt'ad'o'j'n
produktadon	produkt'ad'o'n
produktadaŭtoj	produkt'ad'aŭt'o'j
produktadfortoj	produkt'ad'fort'o'j
produktadfunkcio	produkt'ad'funkci'o
produktadinstalaĵoj	produkt'ad'instal'aĵ'o'j
produktadmaniero	produkt'ad'manier'o
produktadmetodo	produkt'ad'metod'o
produktadmetodoj	produkt'ad'metod'o'j
produktadokosto	produkt'ad'o'kost'o
produktadoteknikoj	produkt'ad'o'teknik'o'j
produktadoperacioj	produkt'ad'operaci'o'j
produktadrimedoj	produkt'ad'rimed'o'j
produktadsistemo	produkt'ad'sistem'o
produktadsistemoj	produkt'ad'sistem'o'j
produktaĵo	produkt'aĵ'o
produktaĵoj	produkt'aĵ'o'j
produktaĵojn	produkt'aĵ'o'j'n
produktaĵon	produkt'aĵ'o'n
produktaĵsignalo	produkt'aĵ'signal'o
produktaĵtensio	produkt'aĵ'tensi'o
produktaĵtension	produkt'aĵ'tensi'o'n
produktanta	produkt'ant'a
produktantaj	produkt'ant'a'j
produktantajn	produkt'ant'a'j'n
produktantan	produkt'ant'a'n
produktante	produkt'ant'e
produktanto	produkt'ant'o
produktantoj	produkt'ant'o'j
produktantojn	produkt'ant'o'j'n
produktanton	produkt'ant'o'n
produktata	produkt'at'a
produktataj	produkt'at'a'j
produktatas	produkt'at'as
produktebla	produkt'ebl'a
produktejo	produkt'ej'o
produktejoj	produkt'ej'o'j
produktema	produkt'em'a
produktemaj	produkt'em'a'j
produktentrepreno	produkt'entrepren'o
produktentreprenoj	produkt'entrepren'o'j
produktevoluigo	produkt'evolu'ig'o
produktiĝas	produkt'iĝ'as
produktiĝis	produkt'iĝ'is
produktiloj	produkt'il'o'j
produktinta	produkt'int'a
produktisto	produkt'ist'o
produktistoj	produkt'ist'o'j
produktita	produkt'it'a
produktitaj	produkt'it'a'j
produktitajn	produkt'it'a'j'n
produktitan	produkt'it'a'n
produktite	produkt'it'e
produktiva	produkt'iv'a
produktivaj	produkt'iv'a'j
produktivajn	produkt'iv'a'j'n
produktivan	produkt'iv'a'n
produktive	produkt'iv'e
produktiveco	produkt'iv'ec'o
produktivecon	produkt'iv'ec'o'n
produktodezajno	produkt'o'dezajn'o
produktokosto	produkt'o'kost'o
produktokostoj	produkt'o'kost'o'j
produktokostojn	produkt'o'kost'o'j'n
produktokoston	produkt'o'kost'o'n
produktokvalito	produkt'o'kvalit'o
produktokvanto	produkt'o'kvant'o
produktokvanton	produkt'o'kvant'o'n
produktovaloro	produkt'o'valor'o
produktserio	produkt'seri'o
produktserioj	produkt'seri'o'j
produktteamo	produkt'team'o
produktoro	produktor'o
produktoroj	produktor'o'j
produto	produt'o
produtoj	produt'o'j
profana	profan'a
profanaj	profan'a'j
profanan	profan'a'n
profano	profan'o
profanado	profan'ad'o
profanita	profan'it'a
profesia	profesi'a
profesiaj	profesi'a'j
profesiajn	profesi'a'j'n
profesian	profesi'a'n
profesie	profesi'e
profesio	profesi'o
profesioj	profesi'o'j
profesiojn	profesi'o'j'n
profesion	profesi'o'n
profesieca	profesi'ec'a
profesieco	profesi'ec'o
profesiigi	profesi'ig'i
profesiigo	profesi'ig'o
profesiiĝo	profesi'iĝ'o
profesiismo	profesi'ism'o
profesinivelaj	profesi'nivel'a'j
profesinivele	profesi'nivel'e
profesiulo	profesi'ul'o
profesiuloj	profesi'ul'o'j
profesiulojn	profesi'ul'o'j'n
profesiulon	profesi'ul'o'n
profesora	profesor'a
profesoris	profesor'is
profesoro	profesor'o
profesoroj	profesor'o'j
profesorojn	profesor'o'j'n
profesoron	profesor'o'n
profesoreco	profesor'ec'o
profesorino	profesor'in'o
profeta	profet'a
profetaj	profet'a'j
profetan	profet'a'n
profetas	profet'as
profeti	profet'i
profetis	profet'is
profeto	profet'o
profetoj	profet'o'j
profetojn	profet'o'j'n
profeton	profet'o'n
profetaĵo	profet'aĵ'o
profetaĵoj	profet'aĵ'o'j
profetaĵojn	profet'aĵ'o'j'n
profetaĵon	profet'aĵ'o'n
profetanto	profet'ant'o
profetino	profet'in'o
profetita	profet'it'a
profile	profil'e
profilo	profil'o
profiloj	profil'o'j
profilojn	profil'o'j'n
profilon	profil'o'n
profilado	profil'ad'o
profilakta	profilakt'a
profilaktaj	profilakt'a'j
profilaktan	profilakt'a'n
profilaktiko	profilakt'ik'o
profita	profit'a
profitaj	profit'a'j
profitan	profit'a'n
profitas	profit'as
profite	profit'e
profiti	profit'i
profitis	profit'is
profito	profit'o
profitoj	profit'o'j
profitojn	profit'o'j'n
profiton	profit'o'n
profitos	profit'os
profitu	profit'u
profitus	profit'us
profitantaj	profit'ant'a'j
profitante	profit'ant'e
profitanto	profit'ant'o
profitantoj	profit'ant'o'j
profitcela	profit'cel'a
profitcelaj	profit'cel'a'j
profitdona	profit'don'a
profitdonaj	profit'don'a'j
profitdone	profit'don'e
profiteco	profit'ec'o
profitecon	profit'ec'o'n
profitema	profit'em'a
profitemo	profit'em'o
profitfontoj	profit'font'o'j
profitiga	profit'ig'a
profitigas	profit'ig'as
profitigi	profit'ig'i
profitigis	profit'ig'is
profitigos	profit'ig'os
profitkvoto	profit'kvot'o
profitodona	profit'o'don'a
profunda	profund'a
profundaj	profund'a'j
profundajn	profund'a'j'n
profundan	profund'a'n
profundas	profund'as
profunde	profund'e
profunden	profund'e'n
profundo	profund'o
profundoj	profund'o'j
profundojn	profund'o'j'n
profundon	profund'o'n
profundaĵo	profund'aĵ'o
profundaĵoj	profund'aĵ'o'j
profundaĵojn	profund'aĵ'o'j'n
profundaĵon	profund'aĵ'o'n
profundakva	profund'akv'a
profundakvaj	profund'akv'a'j
profundeco	profund'ec'o
profundecoj	profund'ec'o'j
profundecon	profund'ec'o'n
profundega	profund'eg'a
profundigas	profund'ig'as
profundigi	profund'ig'i
profundigis	profund'ig'is
profundigo	profund'ig'o
profundigos	profund'ig'os
profundigante	profund'ig'ant'e
profundigita	profund'ig'it'a
profundiĝas	profund'iĝ'as
profundiĝi	profund'iĝ'i
profundiĝis	profund'iĝ'is
profundiĝo	profund'iĝ'o
profundradika	profund'radik'a
progesterono	progesteron'o
prognoza	prognoz'a
prognozaj	prognoz'a'j
prognozajn	prognoz'a'j'n
prognozan	prognoz'a'n
prognozas	prognoz'as
prognozi	prognoz'i
prognozis	prognoz'is
prognozo	prognoz'o
prognozoj	prognoz'o'j
prognozojn	prognoz'o'j'n
prognozon	prognoz'o'n
prognozado	prognoz'ad'o
prognozanta	prognoz'ant'a
prognozilo	prognoz'il'o
prognoziloj	prognoz'il'o'j
programa	program'a
programaj	program'a'j
programajn	program'a'j'n
programan	program'a'n
programas	program'as
programe	program'e
programi	program'i
programis	program'is
programo	program'o
programoj	program'o'j
programojn	program'o'j'n
programon	program'o'n
programada	program'ad'a
programadaj	program'ad'a'j
programado	program'ad'o
programadon	program'ad'o'n
programanta	program'ant'a
programante	program'ant'e
programara	program'ar'a
programaro	program'ar'o
programaroj	program'ar'o'j
programarojn	program'ar'o'j'n
programaron	program'ar'o'n
programarofundamento	program'ar'o'fundament'o
programarpakaĵoj	program'ar'pak'aĵ'o'j
programebla	program'ebl'a
programeblaj	program'ebl'a'j
programeca	program'ec'a
programero	program'er'o
programeroj	program'er'o'j
programerojn	program'er'o'j'n
programeron	program'er'o'n
programereto	program'er'et'o
programeto	program'et'o
programetoj	program'et'o'j
programevoluo	program'evolu'o
programisto	program'ist'o
programistoj	program'ist'o'j
programistojn	program'ist'o'j'n
programiston	program'ist'o'n
programita	program'it'a
programitaj	program'it'a'j
programlingva	program'lingv'a
programlingvo	program'lingv'o
programlingvoj	program'lingv'o'j
programlingvojn	program'lingv'o'j'n
programlingvon	program'lingv'o'n
programmuziko	program'muzik'o
progresa	progres'a
progresaj	progres'a'j
progresan	progres'a'n
progresas	progres'as
progrese	progres'e
progresi	progres'i
progresis	progres'is
progreso	progres'o
progresoj	progres'o'j
progresojn	progres'o'j'n
progreson	progres'o'n
progresos	progres'os
progresu	progres'u
progresus	progres'us
progresado	progres'ad'o
progresadon	progres'ad'o'n
progresanta	progres'ant'a
progresantaj	progres'ant'a'j
progresantan	progres'ant'a'n
progresante	progres'ant'e
progresanto	progres'ant'o
progresantoj	progres'ant'o'j
progresema	progres'em'a
progresemaj	progres'em'a'j
progresemajn	progres'em'a'j'n
progreseman	progres'em'a'n
progresemo	progres'em'o
progresemulo	progres'em'ul'o
progresemuloj	progres'em'ul'o'j
progresio	progres'i'o
progresiga	progres'ig'a
progresigas	progres'ig'as
progresigi	progres'ig'i
progresigis	progres'ig'is
progresigo	progres'ig'o
progresinta	progres'int'a
progresintaj	progres'int'a'j
progresintajn	progres'int'a'j'n
progresintan	progres'int'a'n
progresintoj	progres'int'o'j
progresiva	progresiv'a
progresive	progresiv'e
prohiba	prohib'a
prohibe	prohib'e
prohibi	prohib'i
prohibicio	prohibici'o
prohibicioj	prohibici'o'j
prohibicion	prohibici'o'n
projekcia	projekci'a
projekcias	projekci'as
projekcii	projekci'i
projekciis	projekci'is
projekcio	projekci'o
projekcioj	projekci'o'j
projekciojn	projekci'o'j'n
projekcion	projekci'o'n
projekciado	projekci'ad'o
projekciaĵo	projekci'aĵ'o
projekciante	projekci'ant'e
projekciilo	projekci'il'o
projekciiloj	projekci'il'o'j
projekciilon	projekci'il'o'n
projekciita	projekci'it'a
projekciitaj	projekci'it'a'j
projekta	projekt'a
projektaj	projekt'a'j
projektan	projekt'a'n
projektas	projekt'as
projekti	projekt'i
projektis	projekt'is
projekto	projekt'o
projektoj	projekt'o'j
projektojn	projekt'o'j'n
projekton	projekt'o'n
projektado	projekt'ad'o
projektadon	projekt'ad'o'n
projektadministrado	projekt'administr'ad'o
projektata	projekt'at'a
projektestro	projekt'estr'o
projektisto	projekt'ist'o
projektistoj	projekt'ist'o'j
projektita	projekt'it'a
projektitaj	projekt'it'a'j
projektkapitalistoj	projekt'kapital'ist'o'j
prokariotaj	prokariot'a'j
prokariotoj	prokariot'o'j
proklamas	proklam'as
proklami	proklam'i
proklamis	proklam'is
proklamo	proklam'o
proklamoj	proklam'o'j
proklamojn	proklam'o'j'n
proklamon	proklam'o'n
proklamos	proklam'os
proklamu	proklam'u
proklamado	proklam'ad'o
proklamante	proklam'ant'e
proklamata	proklam'at'a
proklamita	proklam'it'a
proklamitaj	proklam'it'a'j
prokonsulo	prokonsul'o
prokrastas	prokrast'as
prokrasti	prokrast'i
prokrastis	prokrast'is
prokrasto	prokrast'o
prokrastoj	prokrast'o'j
prokrastojn	prokrast'o'j'n
prokraston	prokrast'o'n
prokrastos	prokrast'os
prokrastu	prokrast'u
prokrastus	prokrast'us
prokrastado	prokrast'ad'o
prokrastante	prokrast'ant'e
prokrastata	prokrast'at'a
prokrastiĝis	prokrast'iĝ'is
prokrastita	prokrast'it'a
prokrastitaj	prokrast'it'a'j
proksima	proksim'a
proksimaj	proksim'a'j
proksimajn	proksim'a'j'n
proksiman	proksim'a'n
proksimas	proksim'as
proksime	proksim'e
proksimen	proksim'e'n
proksimis	proksim'is
proksimo	proksim'o
proksimaĵoj	proksim'aĵ'o'j
proksimbatalo	proksim'batal'o
proksimeco	proksim'ec'o
proksimecon	proksim'ec'o'n
proksimigas	proksim'ig'as
proksimigi	proksim'ig'i
proksimigis	proksim'ig'is
proksimigo	proksim'ig'o
proksimiĝas	proksim'iĝ'as
proksimiĝi	proksim'iĝ'i
proksimiĝis	proksim'iĝ'is
proksimiĝo	proksim'iĝ'o
proksimiĝon	proksim'iĝ'o'n
proksimiĝos	proksim'iĝ'os
proksimiĝu	proksim'iĝ'u
proksimiĝanta	proksim'iĝ'ant'a
proksimiĝantaj	proksim'iĝ'ant'a'j
proksimiĝantan	proksim'iĝ'ant'a'n
proksimiĝante	proksim'iĝ'ant'e
proksimulo	proksim'ul'o
proksimuloj	proksim'ul'o'j
proksimulojn	proksim'ul'o'j'n
proksimulon	proksim'ul'o'n
proksimularo	proksim'ul'ar'o
proksimuma	proksim'um'a
proksimumaj	proksim'um'a'j
proksimumajn	proksim'um'a'j'n
proksimuman	proksim'um'a'n
proksimume	proksim'um'e
prokuristo	prokur'ist'o
prokuratoro	prokurator'o
prokurilo	prokuril'o
prokuroro	prokuror'o
prokuroroj	prokuror'o'j
prokuroron	prokuror'o'n
prokurorejo	prokuror'ej'o
proleta	prolet'a
proletaj	prolet'a'j
proletan	prolet'a'n
proleto	prolet'o
proletoj	prolet'o'j
proletara	prolet'ar'a
proletaro	prolet'ar'o
proletaron	prolet'ar'o'n
proliferado	prolifer'ad'o
proliferadon	prolifer'ad'o'n
prologo	prolog'o
promena	promen'a
promenas	promen'as
promene	promen'e
promeni	promen'i
promenis	promen'is
promeno	promen'o
promenoj	promen'o'j
promenojn	promen'o'j'n
promenon	promen'o'n
promenos	promen'os
promenu	promen'u
promenadas	promen'ad'as
promenadi	promen'ad'i
promenadis	promen'ad'is
promenado	promen'ad'o
promenadoj	promen'ad'o'j
promenadojn	promen'ad'o'j'n
promenadon	promen'ad'o'n
promenanta	promen'ant'a
promenantaj	promen'ant'a'j
promenante	promen'ant'e
promenanto	promen'ant'o
promenantoj	promen'ant'o'j
promenbastono	promen'baston'o
promenbastonon	promen'baston'o'n
promenejo	promen'ej'o
promenejoj	promen'ej'o'j
promenigas	promen'ig'as
promenigi	promen'ig'i
promenigis	promen'ig'is
promesa	promes'a
promesas	promes'as
promesi	promes'i
promesis	promes'is
promeso	promes'o
promesoj	promes'o'j
promesojn	promes'o'j'n
promeson	promes'o'n
promesos	promes'os
promesu	promes'u
promesado	promes'ad'o
promesanta	promes'ant'a
promesante	promes'ant'e
promesinta	promes'int'a
promesinte	promes'int'e
promesita	promes'it'a
promesitaj	promes'it'a'j
promesitajn	promes'it'a'j'n
promesitan	promes'it'a'n
promesite	promes'it'e
promesoplena	promes'o'plen'a
promesplena	promes'plen'a
promesplenaj	promes'plen'a'j
prometeo	promete'o
prominenta	prominent'a
prominentaj	prominent'a'j
promocias	promoci'as
promocii	promoci'i
promociis	promoci'is
promocio	promoci'o
promocion	promoci'o'n
promociado	promoci'ad'o
promociante	promoci'ant'e
promociiĝis	promoci'iĝ'is
promociita	promoci'it'a
promociitaj	promoci'it'a'j
promontoro	promontor'o
promontoroj	promontor'o'j
prompta	prompt'a
prompte	prompt'e
promptilo	prompt'il'o
pronoma	pronom'a
pronomaj	pronom'a'j
pronomo	pronom'o
pronomoj	pronom'o'j
pronomojn	pronom'o'j'n
pronomon	pronom'o'n
prononca	prononc'a
prononcaj	prononc'a'j
prononcas	prononc'as
prononce	prononc'e
prononci	prononc'i
prononcis	prononc'is
prononco	prononc'o
prononcoj	prononc'o'j
prononcon	prononc'o'n
prononcu	prononc'u
prononcado	prononc'ad'o
prononcadon	prononc'ad'o'n
prononcante	prononc'ant'e
prononcata	prononc'at'a
prononcataj	prononc'at'a'j
prononcebla	prononc'ebl'a
prononceblaj	prononc'ebl'a'j
prononciĝas	prononc'iĝ'as
prononcita	prononc'it'a
prononcitaj	prononc'it'a'j
prononcite	prononc'it'e
prononcmaniero	prononc'manier'o
prononcmanieron	prononc'manier'o'n
propano	prop'an'o
propila	prop'il'a
propagas	propag'as
propagi	propag'i
propagado	propag'ad'o
propaganda	propagand'a
propagandaj	propagand'a'j
propagandajn	propagand'a'j'n
propagandan	propagand'a'n
propagandas	propagand'as
propagandi	propagand'i
propagandis	propagand'is
propagando	propagand'o
propagandon	propagand'o'n
propagandos	propagand'os
propagandu	propagand'u
propagandado	propagand'ad'o
propagandanto	propagand'ant'o
propagandantoj	propagand'ant'o'j
propagandantojn	propagand'ant'o'j'n
propagandata	propagand'at'a
propagandilo	propagand'il'o
propagandilojn	propagand'il'o'j'n
propagandilon	propagand'il'o'n
propagandisto	propagand'ist'o
propagandistoj	propagand'ist'o'j
propedeŭtika	propedeŭtik'a
propionato	propion'at'o
proponas	propon'as
proponi	propon'i
proponis	propon'is
propono	propon'o
proponoj	propon'o'j
proponojn	propon'o'j'n
proponon	propon'o'n
proponos	propon'os
proponu	propon'u
proponus	propon'us
proponadis	propon'ad'is
proponado	propon'ad'o
proponanta	propon'ant'a
proponante	propon'ant'e
proponanto	propon'ant'o
proponantoj	propon'ant'o'j
proponata	propon'at'a
proponataj	propon'at'a'j
proponatan	propon'at'a'n
proponinta	propon'int'a
proponinto	propon'int'o
proponintoj	propon'int'o'j
proponita	propon'it'a
proponitaj	propon'it'a'j
proponitajn	propon'it'a'j'n
proponitan	propon'it'a'n
proponite	propon'it'e
proporcia	proporci'a
proporciaj	proporci'a'j
proporciajn	proporci'a'j'n
proporcian	proporci'a'n
proporcie	proporci'e
proporcio	proporci'o
proporcioj	proporci'o'j
proporciojn	proporci'o'j'n
proporcion	proporci'o'n
proporcieco	proporci'ec'o
propozicia	propozici'a
propoziciaj	propozici'a'j
propozicio	propozici'o
propozicioj	propozici'o'j
propoziciojn	propozici'o'j'n
propozicion	propozici'o'n
propra	propr'a
propraj	propr'a'j
proprajn	propr'a'j'n
propran	propr'a'n
propras	propr'as
propre	propr'e
propraaŭtoritate	propr'a'aŭtoritat'e
propradire	propr'a'dir'e
propraforte	propr'a'fort'e
proprainiciate	propr'a'iniciat'e
proprakoste	propr'a'kost'e
propramane	propr'a'man'e
propranome	propr'a'nom'e
propraokule	propr'a'okul'e
proprariske	propr'a'risk'e
proprasence	propr'a'senc'e
proprasperte	propr'a'spert'e
propravola	propr'a'vol'a
propravole	propr'a'vol'e
proprajho	propr'aĵ'o
propraĵo	propr'aĵ'o
propraĵoj	propr'aĵ'o'j
propraĵojn	propr'aĵ'o'j'n
propraĵon	propr'aĵ'o'n
propreco	propr'ec'o
proprecoj	propr'ec'o'j
proprecojn	propr'ec'o'j'n
proprecon	propr'ec'o'n
proprigi	propr'ig'i
proprigis	propr'ig'is
proprokule	propr'okul'e
proprieta	propriet'a
proprietaj	propriet'a'j
proprietajn	propriet'a'j'n
proprietan	propriet'a'n
proprieto	propriet'o
proprietoj	propriet'o'j
proprietojn	propriet'o'j'n
proprieton	propriet'o'n
proprietaĵo	propriet'aĵ'o
proprietaĵon	propriet'aĵ'o'n
proprietrajtoj	propriet'rajt'o'j
proprietulo	propriet'ul'o
proprietuloj	propriet'ul'o'j
propulsas	propuls'as
propulsi	propuls'i
propulsis	propuls'is
propulso	propuls'o
propulson	propuls'o'n
propulsado	propuls'ad'o
propulsita	propuls'it'a
propulsitaj	propuls'it'a'j
propulssistemo	propuls'sistem'o
propulssistemoj	propuls'sistem'o'j
propulssistemon	propuls'sistem'o'n
prospekto	prospekt'o
prospektoj	prospekt'o'j
prospekton	prospekt'o'n
prospera	prosper'a
prosperaj	prosper'a'j
prosperajn	prosper'a'j'n
prosperan	prosper'a'n
prosperas	prosper'as
prospere	prosper'e
prosperi	prosper'i
prosperis	prosper'is
prospero	prosper'o
prosperon	prosper'o'n
prosperos	prosper'os
prosperu	prosper'u
prosperus	prosper'us
prosperado	prosper'ad'o
prosperadon	prosper'ad'o'n
prosperanta	prosper'ant'a
prosperigi	prosper'ig'i
prosperigis	prosper'ig'is
prosperigo	prosper'ig'o
prosperiĝo	prosper'iĝ'o
prosperiĝon	prosper'iĝ'o'n
prostata	prostat'a
prostato	prostat'o
prostatkancero	prostat'kancer'o
prostituo	prostitu'o
prostituado	prostitu'ad'o
prostituadon	prostitu'ad'o'n
prostituisto	prostitu'ist'o
prostituitino	prostitu'it'in'o
prostituitinoj	prostitu'it'in'o'j
prostituitinojn	prostitu'it'in'o'j'n
protagonisto	protagonist'o
protagonistoj	protagonist'o'j
protagonistojn	protagonist'o'j'n
protagoniston	protagonist'o'n
protagoro	protagor'o
protaktinio	protaktini'o
proteo	prote'o
proteina	protein'a
proteinaj	protein'a'j
proteino	protein'o
proteinoj	protein'o'j
proteinojn	protein'o'j'n
proteinon	protein'o'n
proteinsintezo	protein'sintez'o
protekta	protekt'a
protektaj	protekt'a'j
protektajn	protekt'a'j'n
protektan	protekt'a'n
protektas	protekt'as
protekti	protekt'i
protektis	protekt'is
protekto	protekt'o
protektoj	protekt'o'j
protektojn	protekt'o'j'n
protekton	protekt'o'n
protektos	protekt'os
protektu	protekt'u
protektus	protekt'us
protektado	protekt'ad'o
protektadon	protekt'ad'o'n
protektanta	protekt'ant'a
protektantaj	protekt'ant'a'j
protektantan	protekt'ant'a'n
protektante	protekt'ant'e
protektanto	protekt'ant'o
protektantoj	protekt'ant'o'j
protektanton	protekt'ant'o'n
protektantino	protekt'ant'in'o
protektata	protekt'at'a
protektataj	protekt'at'a'j
protektejo	protekt'ej'o
protektejoj	protekt'ej'o'j
protektilo	protekt'il'o
protektiloj	protekt'il'o'j
protektisma	protekt'ism'a
protektismo	protekt'ism'o
protektismon	protekt'ism'o'n
protektita	protekt'it'a
protektitaj	protekt'it'a'j
protektitajn	protekt'it'a'j'n
protektitan	protekt'it'a'n
protektite	protekt'it'e
protektmetalizo	protekt'metal'iz'o
protektokulvitroj	protekt'okul'vitr'o'j
protektorato	protektorat'o
protektoratoj	protektorat'o'j
protektoraton	protektorat'o'n
protesta	protest'a
protestaj	protest'a'j
protestajn	protest'a'j'n
protestan	protest'a'n
protestas	protest'as
proteste	protest'e
protesti	protest'i
protestis	protest'is
protesto	protest'o
protestoj	protest'o'j
protestojn	protest'o'j'n
proteston	protest'o'n
protestos	protest'os
protestu	protest'u
protestus	protest'us
protestado	protest'ad'o
protestanta	protest'ant'a
protestantaj	protest'ant'a'j
protestantajn	protest'ant'a'j'n
protestantan	protest'ant'a'n
protestante	protest'ant'e
protestanto	protest'ant'o
protestantoj	protest'ant'o'j
protestantojn	protest'ant'o'j'n
protestantisma	protest'ant'ism'a
protestantismo	protest'ant'ism'o
protestantismon	protest'ant'ism'o'n
protestego	protest'eg'o
protezo	protez'o
protezoj	protez'o'j
protezon	protez'o'n
protoplasmo	proto'plasm'o
protozooj	proto'zo'o'j
protokola	protokol'a
protokolas	protokol'as
protokolis	protokol'is
protokolo	protokol'o
protokoloj	protokol'o'j
protokolojn	protokol'o'j'n
protokolon	protokol'o'n
protokolitaj	protokol'it'a'j
protona	proton'a
protono	proton'o
protonoj	proton'o'j
protonojn	proton'o'j'n
protonon	proton'o'n
prototipa	prototip'a
prototipaj	prototip'a'j
prototipan	prototip'a'n
prototipo	prototip'o
prototipoj	prototip'o'j
prototipojn	prototip'o'j'n
prototipon	prototip'o'n
protrudaj	protrud'a'j
protrudas	protrud'as
prova	prov'a
provaj	prov'a'j
provajn	prov'a'j'n
provan	prov'a'n
provas	prov'as
prove	prov'e
provi	prov'i
provis	prov'is
provo	prov'o
provoj	prov'o'j
provojn	prov'o'j'n
provon	prov'o'n
provos	prov'os
provu	prov'u
provus	prov'us
provadis	prov'ad'is
provado	prov'ad'o
provadon	prov'ad'o'n
provaĵa	prov'aĵ'a
provaĵo	prov'aĵ'o
provaĵoj	prov'aĵ'o'j
provaĵojn	prov'aĵ'o'j'n
provaĵon	prov'aĵ'o'n
provaĵmeznombro	prov'aĵ'mez'nombr'o
provanta	prov'ant'a
provantaj	prov'ant'a'j
provantajn	prov'ant'a'j'n
provantan	prov'ant'a'n
provante	prov'ant'e
provata	prov'at'a
provekzemplero	prov'ekzempler'o
provilo	prov'il'o
provinta	prov'int'a
provinte	prov'int'e
provita	prov'it'a
provitaj	prov'it'a'j
provlegi	prov'leg'i
provlegis	prov'leg'is
provlegado	prov'leg'ad'o
provlegantoj	prov'leg'ant'o'j
provludo	prov'lud'o
provludoj	prov'lud'o'j
provtempo	prov'temp'o
provtubo	prov'tub'o
proverba	proverb'a
proverbo	proverb'o
proverboj	proverb'o'j
proverbojn	proverb'o'j'n
proverbon	proverb'o'n
proverbaro	proverb'ar'o
provianto	proviant'o
proviantoj	proviant'o'j
proviantojn	proviant'o'j'n
provianton	proviant'o'n
proviantado	proviant'ad'o
providenca	providenc'a
providencan	providenc'a'n
providenco	providenc'o
provinca	provinc'a
provincaj	provinc'a'j
provincajn	provinc'a'j'n
provincan	provinc'a'n
province	provinc'e
provinco	provinc'o
provincoj	provinc'o'j
provincojn	provinc'o'j'n
provincon	provinc'o'n
provincanoj	provinc'an'o'j
provincestro	provinc'estr'o
provincnivelaj	provinc'nivel'a'j
proviza	proviz'a
provizas	proviz'as
provizi	proviz'i
provizis	proviz'is
provizo	proviz'o
provizoj	proviz'o'j
provizojn	proviz'o'j'n
provizon	proviz'o'n
provizos	proviz'os
provizu	proviz'u
provizus	proviz'us
provizado	proviz'ad'o
provizadon	proviz'ad'o'n
provizaĵoj	proviz'aĵ'o'j
provizaĵojn	proviz'aĵ'o'j'n
provizanta	proviz'ant'a
provizantaj	proviz'ant'a'j
provizante	proviz'ant'e
provizanto	proviz'ant'o
provizantoj	proviz'ant'o'j
provizantojn	proviz'ant'o'j'n
provizanton	proviz'ant'o'n
provizaroj	proviz'ar'o'j
provizata	proviz'at'a
provizataj	proviz'at'a'j
provizejo	proviz'ej'o
provizejoj	proviz'ej'o'j
provizejon	proviz'ej'o'n
provizita	proviz'it'a
provizitaj	proviz'it'a'j
provizitajn	proviz'it'a'j'n
provizitan	proviz'it'a'n
provizite	proviz'it'e
provizoĉeno	proviz'o'ĉen'o
provizoĉenoj	proviz'o'ĉen'o'j
provizoĉenadministrado	proviz'o'ĉen'administr'ad'o
provizoliniojn	proviz'o'lini'o'j'n
provizora	provizor'a
provizoraj	provizor'a'j
provizorajn	provizor'a'j'n
provizoran	provizor'a'n
provizore	provizor'e
provoka	provok'a
provokaj	provok'a'j
provokas	provok'as
provoke	provok'e
provoki	provok'i
provokis	provok'is
provoko	provok'o
provokoj	provok'o'j
provokon	provok'o'n
provokos	provok'os
provoku	provok'u
provokus	provok'us
provokado	provok'ad'o
provokante	provok'ant'e
provokema	provok'em'a
provokita	provok'it'a
provokitaj	provok'it'a'j
provoso	provos'o
provosoj	provos'o'j
provosto	provost'o
proza	proz'a
prozaj	proz'a'j
prozan	proz'a'n
proze	proz'e
prozo	proz'o
prozoj	proz'o'j
prozon	proz'o'n
prozaĵo	proz'aĵ'o
prozaĵoj	proz'aĵ'o'j
prozaĵojn	proz'aĵ'o'j'n
prozaĵon	proz'aĵ'o'n
prozisto	proz'ist'o
prozodiaj	prozodi'a'j
prozodio	prozodi'o
prua	pru'a
pruo	pru'o
pruon	pru'o'n
pruda	prud'a
prudeco	prud'ec'o
prudenta	prudent'a
prudentaj	prudent'a'j
prudentajn	prudent'a'j'n
prudentan	prudent'a'n
prudente	prudent'e
prudento	prudent'o
prudenton	prudent'o'n
prudenteco	prudent'ec'o
prudentulo	prudent'ul'o
prudentuloj	prudent'ul'o'j
prujna	prujn'a
prujno	prujn'o
pruno	prun'o
prunoj	prun'o'j
prunojn	prun'o'j'n
prunarbo	prun'arb'o
prunta	prunt'a
pruntas	prunt'as
prunte	prunt'e
prunti	prunt'i
pruntis	prunt'is
prunto	prunt'o
pruntoj	prunt'o'j
pruntojn	prunt'o'j'n
prunton	prunt'o'n
pruntos	prunt'os
pruntu	prunt'u
pruntado	prunt'ad'o
pruntaĵoj	prunt'aĵ'o'j
pruntante	prunt'ant'e
pruntedonas	prunt'e'don'as
pruntedoni	prunt'e'don'i
pruntedonis	prunt'e'don'is
pruntedono	prunt'e'don'o
pruntedonos	prunt'e'don'os
pruntedonu	prunt'e'don'u
pruntedonus	prunt'e'don'us
pruntedonado	prunt'e'don'ad'o
pruntedonante	prunt'e'don'ant'e
pruntedonanto	prunt'e'don'ant'o
pruntedonantoj	prunt'e'don'ant'o'j
pruntedonita	prunt'e'don'it'a
pruntedonitaj	prunt'e'don'it'a'j
prunteprenas	prunt'e'pren'as
pruntepreni	prunt'e'pren'i
prunteprenis	prunt'e'pren'is
pruntepreno	prunt'e'pren'o
prunteprenoj	prunt'e'pren'o'j
prunteprenon	prunt'e'pren'o'n
prunteprenu	prunt'e'pren'u
prunteprenanto	prunt'e'pren'ant'o
prunteprenantoj	prunt'e'pren'ant'o'j
prunteprenita	prunt'e'pren'it'a
prunteprenitaj	prunt'e'pren'it'a'j
pruntita	prunt'it'a
pruntitaj	prunt'it'a'j
pruntitajn	prunt'it'a'j'n
pruntitan	prunt'it'a'n
pruntokolekto	prunt'o'kolekt'o
pruntvortoj	prunt'vort'o'j
pruntvortojn	prunt'vort'o'j'n
prusa	prus'a
prusaj	prus'a'j
prusajn	prus'a'j'n
prusan	prus'a'n
prusoj	prus'o'j
prusia	prus'i'a
prusio	prus'i'o
prusion	prus'i'o'n
pruslando	prus'land'o
prusujo	prus'uj'o
pruva	pruv'a
pruvaj	pruv'a'j
pruvas	pruv'as
pruvi	pruv'i
pruvis	pruv'is
pruvo	pruv'o
pruvoj	pruv'o'j
pruvojn	pruv'o'j'n
pruvon	pruv'o'n
pruvos	pruv'os
pruvu	pruv'u
pruvus	pruv'us
pruvado	pruv'ad'o
pruvaĵo	pruv'aĵ'o
pruvaĵoj	pruv'aĵ'o'j
pruvanta	pruv'ant'a
pruvante	pruv'ant'e
pruvaro	pruv'ar'o
pruvata	pruv'at'a
pruvebla	pruv'ebl'a
pruveblaj	pruv'ebl'a'j
pruveblas	pruv'ebl'as
pruveble	pruv'ebl'e
pruviĝas	pruv'iĝ'as
pruviĝis	pruv'iĝ'is
pruvita	pruv'it'a
pruvitaj	pruv'it'a'j
pruvite	pruv'it'e
pruvodevo	pruv'o'dev'o
pruvodevon	pruv'o'dev'o'n
psalmo	psalm'o
psalmoj	psalm'o'j
psalmojn	psalm'o'j'n
psalmon	psalm'o'n
psalmaro	psalm'ar'o
psalmaron	psalm'ar'o'n
psalmisto	psalm'ist'o
pseŭdokodo	pseŭdo'kod'o
pseŭdonomo	pseŭdo'nom'o
pseŭdonomon	pseŭdo'nom'o'n
pseŭdoscienca	pseŭdo'scienc'a
pseŭdoscienco	pseŭdo'scienc'o
pseŭdonime	pseŭdonim'e
pseŭdonimo	pseŭdonim'o
pseŭdonimoj	pseŭdonim'o'j
pseŭdonimojn	pseŭdonim'o'j'n
pseŭdonimon	pseŭdonim'o'n
psika	psik'a
psikaj	psik'a'j
psikajn	psik'a'j'n
psikan	psik'a'n
psike	psik'e
psiko	psik'o
psikoj	psik'o'j
psikon	psik'o'n
psikanaliza	psik'analiz'a
psikanalizaj	psik'analiz'a'j
psikanalizo	psik'analiz'o
psikoaktiva	psik'o'aktiv'a
psikoaktivaj	psik'o'aktiv'a'j
psikoanaliza	psik'o'analiz'a
psikoanalizo	psik'o'analiz'o
psikolingvistiko	psik'o'lingv'ist'ik'o
psikometrikaj	psik'o'metr'ik'a'j
psikopatio	psik'o'pati'o
psikopatologio	psik'o'patolog'i'o
psikosocia	psik'o'soci'a
psikosociaj	psik'o'soci'a'j
psikostimulaj	psik'o'stimul'a'j
psikoterapia	psik'o'terapi'a
psikoterapio	psik'o'terapi'o
psikoterapiisto	psik'o'terapi'ist'o
psikoterapiistoj	psik'o'terapi'ist'o'j
psikologo	psik'olog'o
psikologoj	psik'olog'o'j
psikologon	psik'olog'o'n
psikologia	psik'olog'i'a
psikologiaj	psik'olog'i'a'j
psikologiajn	psik'olog'i'a'j'n
psikologian	psik'olog'i'a'n
psikologie	psik'olog'i'e
psikologio	psik'olog'i'o
psikologion	psik'olog'i'o'n
psikozaj	psik'oz'a'j
psikozo	psik'oz'o
psikozon	psik'oz'o'n
psikiatra	psikiatr'a
psikiatro	psikiatr'o
psikiatroj	psikiatr'o'j
psikiatron	psikiatr'o'n
psikiatria	psikiatr'i'a
psikiatriaj	psikiatr'i'a'j
psikiatrian	psikiatr'i'a'n
psikiatrio	psikiatr'i'o
psikopato	psikopat'o
psikopatoj	psikopat'o'j
ptolemea	ptoleme'a
ptolemeo	ptoleme'o
ptolemeon	ptoleme'o'n
pubereca	puber'ec'a
pubereco	puber'ec'o
puberecon	puber'ec'o'n
publica	public'a
publicisto	public'ist'o
publicistoj	public'ist'o'j
publika	publik'a
publikaj	publik'a'j
publikajn	publik'a'j'n
publikan	publik'a'n
publikas	publik'as
publike	publik'e
publikis	publik'is
publiko	publik'o
publikoj	publik'o'j
publikojn	publik'o'j'n
publikon	publik'o'n
publikado	publik'ad'o
publikaĵo	publik'aĵ'o
publikaĵoj	publik'aĵ'o'j
publikaĵojn	publik'aĵ'o'j'n
publikatento	publik'atent'o
publikatenton	publik'atent'o'n
publikeco	publik'ec'o
publikecon	publik'ec'o'n
publikiga	publik'ig'a
publikigaj	publik'ig'a'j
publikigas	publik'ig'as
publikigi	publik'ig'i
publikigis	publik'ig'is
publikigo	publik'ig'o
publikigoj	publik'ig'o'j
publikigon	publik'ig'o'n
publikigos	publik'ig'os
publikigu	publik'ig'u
publikigus	publik'ig'us
publikigado	publik'ig'ad'o
publikigadoj	publik'ig'ad'o'j
publikigaĵo	publik'ig'aĵ'o
publikigaĵoj	publik'ig'aĵ'o'j
publikiganta	publik'ig'ant'a
publikigante	publik'ig'ant'e
publikigata	publik'ig'at'a
publikigataj	publik'ig'at'a'j
publikigisto	publik'ig'ist'o
publikigita	publik'ig'it'a
publikigitaj	publik'ig'it'a'j
publikigitajn	publik'ig'it'a'j'n
publikigitan	publik'ig'it'a'n
publikigite	publik'ig'it'e
publikiĝas	publik'iĝ'as
publikiĝis	publik'iĝ'is
publikiĝo	publik'iĝ'o
publikiĝos	publik'iĝ'os
publikita	publik'it'a
publikitaj	publik'it'a'j
publiklernejaj	publik'lern'ej'a'j
publikserva	publik'serv'a
publikŝlosila	publik'ŝlos'il'a
publiktransporta	publik'trans'port'a
publiktransportaj	publik'trans'port'a'j
publikulino	publik'ul'in'o
puĉo	puĉ'o
puĉoj	puĉ'o'j
puĉojn	puĉ'o'j'n
puĉon	puĉ'o'n
puĉistoj	puĉ'ist'o'j
pudelo	pudel'o
pudingo	puding'o
pudingon	puding'o'n
pudoro	pudor'o
pudra	pudr'a
pudraj	pudr'a'j
pudran	pudr'a'n
pudro	pudr'o
pudron	pudr'o'n
pufa	puf'a
pufaj	puf'a'j
pufmaizo	puf'maiz'o
pufmaizon	puf'maiz'o'n
pufino	pufin'o
pufinoj	pufin'o'j
pugo	pug'o
pugon	pug'o'n
pugnis	pugn'is
pugno	pugn'o
pugnoj	pugn'o'j
pugnojn	pugn'o'j'n
pugnon	pugn'o'n
pugnigis	pugn'ig'is
pugnobatis	pugn'o'bat'is
pugnobato	pugn'o'bat'o
pula	pul'a
pulo	pul'o
puloj	pul'o'j
pulojn	pul'o'j'n
pulbazaro	pul'bazar'o
pulĉinelo	pulĉinel'o
pulio	puli'o
pulioj	puli'o'j
puliojn	puli'o'j'n
pulma	pulm'a
pulmaj	pulm'a'j
pulman	pulm'a'n
pulmo	pulm'o
pulmoj	pulm'o'j
pulmojn	pulm'o'j'n
pulmon	pulm'o'n
pulminflamo	pulm'inflam'o
pulminflamon	pulm'inflam'o'n
pulmokancero	pulm'o'kancer'o
pulovero	pulover'o
puloveroj	pulover'o'j
puloverojn	pulover'o'j'n
puloveron	pulover'o'n
pulpo	pulp'o
pulpon	pulp'o'n
pulsa	puls'a
pulsaj	puls'a'j
pulsan	puls'a'n
pulsas	puls'as
pulse	puls'e
pulsis	puls'is
pulso	puls'o
pulsoj	puls'o'j
pulsojn	puls'o'j'n
pulson	puls'o'n
pulsado	puls'ad'o
pulsadon	puls'ad'o'n
pulsanta	puls'ant'a
pulsita	puls'it'a
pulsitaj	puls'it'a'j
pulsaroj	pulsar'o'j
pulsatilo	pulsatil'o
pulvo	pulv'o
pulvon	pulv'o'n
pulvora	pulvor'a
pulvoro	pulvor'o
pulvoroj	pulvor'o'j
pulvorojn	pulvor'o'j'n
pulvoron	pulvor'o'n
pulvorigas	pulvor'ig'as
pulvorigita	pulvor'ig'it'a
pumo	pum'o
pumoj	pum'o'j
pumiko	pumik'o
pumpas	pump'as
pumpi	pump'i
pumpis	pump'is
pumpado	pump'ad'o
pumpante	pump'ant'e
pumpilo	pump'il'o
pumpiloj	pump'il'o'j
pumpilojn	pump'il'o'j'n
pumpilon	pump'il'o'n
pumpita	pump'it'a
pumpitaj	pump'it'a'j
puna	pun'a
punaj	pun'a'j
punan	pun'a'n
punas	pun'as
pune	pun'e
puni	pun'i
punis	pun'is
puno	pun'o
punoj	pun'o'j
punojn	pun'o'j'n
punon	pun'o'n
punos	pun'os
punu	pun'u
punus	pun'us
punado	pun'ad'o
punadon	pun'ad'o'n
punanta	pun'ant'a
punante	pun'ant'e
punata	pun'at'a
punataj	pun'at'a'j
punebla	pun'ebl'a
punenda	pun'end'a
puninda	pun'ind'a
punindaj	pun'ind'a'j
punisto	pun'ist'o
punita	pun'it'a
punitaj	pun'it'a'j
punlaboro	pun'labor'o
punmono	pun'mon'o
punpago	pun'pag'o
punca	punc'a
punĉo	punĉ'o
pundo	pund'o
pundoj	pund'o'j
pundojn	pund'o'j'n
punika	punik'a
punikaj	punik'a'j
punkta	punkt'a
punktaj	punkt'a'j
punktan	punkt'a'n
punktas	punkt'as
punktis	punkt'is
punkto	punkt'o
punktoj	punkt'o'j
punktojn	punkt'o'j'n
punkton	punkt'o'n
punktado	punkt'ad'o
punktalpunkta	punkt'al'punkt'a
punkteca	punkt'ec'a
punkteco	punkt'ec'o
punktetoj	punkt'et'o'j
punktfonto	punkt'font'o
punktita	punkt'it'a
punktitaj	punkt'it'a'j
punktitajn	punkt'it'a'j'n
punktitan	punkt'it'a'n
punktokomo	punkt'o'kom'o
punktokomoj	punkt'o'kom'o'j
punktskribita	punkt'skrib'it'a
punktskribitaj	punkt'skrib'it'a'j
punta	punt'a
puntan	punt'a'n
punto	punt'o
puntoj	punt'o'j
punton	punt'o'n
pupo	pup'o
pupoj	pup'o'j
pupojn	pup'o'j'n
pupon	pup'o'n
pupeton	pup'et'o'n
pupteatra	pup'teatr'a
pupteatro	pup'teatr'o
pupilo	pupil'o
pupiloj	pupil'o'j
pupilojn	pupil'o'j'n
pupilon	pupil'o'n
pupitro	pupitr'o
pura	pur'a
puraj	pur'a'j
purajn	pur'a'j'n
puran	pur'a'n
puras	pur'as
pure	pur'e
puri	pur'i
puro	pur'o
pureca	pur'ec'a
pureco	pur'ec'o
purecon	pur'ec'o'n
purega	pur'eg'a
purema	pur'em'a
puriga	pur'ig'a
purigaj	pur'ig'a'j
purigan	pur'ig'a'n
purigas	pur'ig'as
purigi	pur'ig'i
purigis	pur'ig'is
purigo	pur'ig'o
purigoj	pur'ig'o'j
purigon	pur'ig'o'n
purigos	pur'ig'os
purigu	pur'ig'u
purigus	pur'ig'us
purigado	pur'ig'ad'o
purigadon	pur'ig'ad'o'n
purigagento	pur'ig'agent'o
puriganta	pur'ig'ant'a
purigante	pur'ig'ant'e
purigata	pur'ig'at'a
purigilo	pur'ig'il'o
purigisto	pur'ig'ist'o
purigistoj	pur'ig'ist'o'j
purigistino	pur'ig'ist'in'o
purigita	pur'ig'it'a
purigitaj	pur'ig'it'a'j
purigitajn	pur'ig'it'a'j'n
purigitan	pur'ig'it'a'n
puriĝas	pur'iĝ'as
purismo	pur'ism'o
puristoj	pur'ist'o'j
purlanda	pur'land'a
purrasa	pur'ras'a
purrasaj	pur'ras'a'j
purana	puran'a
puranaj	puran'a'j
pureo	pure'o
purgatorio	purgatori'o
purgatorion	purgatori'o'n
purimo	purim'o
puritana	puritan'a
puritanoj	puritan'o'j
puritanismo	puritan'ism'o
purpura	purpur'a
purpuraj	purpur'a'j
purpurajn	purpur'a'j'n
purpuran	purpur'a'n
purpure	purpur'e
purpuro	purpur'o
purpuron	purpur'o'n
puso	pus'o
puson	pus'o'n
puŝa	puŝ'a
puŝas	puŝ'as
puŝe	puŝ'e
puŝi	puŝ'i
puŝis	puŝ'is
puŝo	puŝ'o
puŝoj	puŝ'o'j
puŝojn	puŝ'o'j'n
puŝon	puŝ'o'n
puŝos	puŝ'os
puŝu	puŝ'u
puŝadis	puŝ'ad'is
puŝado	puŝ'ad'o
puŝanta	puŝ'ant'a
puŝante	puŝ'ant'e
puŝata	puŝ'at'a
puŝataj	puŝ'at'a'j
puŝbutono	puŝ'buton'o
puŝbutonoj	puŝ'buton'o'j
puŝetis	puŝ'et'is
puŝiĝas	puŝ'iĝ'as
puŝiĝis	puŝ'iĝ'is
puŝita	puŝ'it'a
puŝitaj	puŝ'it'a'j
puŝite	puŝ'it'e
pusano	pusan'o
puta	put'a
puto	put'o
putoj	put'o'j
putojn	put'o'j'n
puton	put'o'n
putina	putin'a
putino	putin'o
putinoj	putin'o'j
putinojn	putin'o'j'n
putinido	putin'id'o
putoro	putor'o
putoroj	putor'o'j
putra	putr'a
putraj	putr'a'j
putrajn	putr'a'j'n
putran	putr'a'n
putras	putr'as
putri	putr'i
putris	putr'is
putro	putr'o
putros	putr'os
putrado	putr'ad'o
putraĵo	putr'aĵ'o
putranta	putr'ant'a
putriĝas	putr'iĝ'as
putriĝis	putr'iĝ'is
putriĝo	putr'iĝ'o
putriĝon	putr'iĝ'o'n
putriĝintaj	putr'iĝ'int'a'j
putrinta	putr'int'a
putrintaj	putr'int'a'j
puzlo	puzl'o
puzloj	puzl'o'j
puzlojn	puzl'o'j'n
puzlon	puzl'o'n