raba	rab'a
rabaj	rab'a'j
rabas	rab'as
rabe	rab'e
rabi	rab'i
rabis	rab'is
rabo	rab'o
raboj	rab'o'j
rabon	rab'o'n
rabos	rab'os
rabado	rab'ad'o
rabadoj	rab'ad'o'j
rabadon	rab'ad'o'n
rabaĵo	rab'aĵ'o
rabaĵoj	rab'aĵ'o'j
rabaĵon	rab'aĵ'o'n
rabatakantoj	rab'atak'ant'o'j
rabista	rab'ist'a
rabisto	rab'ist'o
rabistoj	rab'ist'o'j
rabistojn	rab'ist'o'j'n
rabiston	rab'ist'o'n
rabita	rab'it'a
rabitaj	rab'it'a'j
rabmevoj	rab'mev'o'j
rabobesto	rab'o'best'o
rabobestoj	rab'o'best'o'j
rabobirdo	rab'o'bird'o
rabobirdoj	rab'o'bird'o'j
rabobirdojn	rab'o'bird'o'j'n
rabarbo	rabarb'o
rabata	rabat'a
rabati	rabat'i
rabatis	rabat'is
rabato	rabat'o
rabatoj	rabat'o'j
rabatojn	rabat'o'j'n
rabaton	rabat'o'n
rabataĉeto	rabat'aĉet'o
rabataĉeton	rabat'aĉet'o'n
rabatita	rabat'it'a
rabatitaj	rabat'it'a'j
rabatreklamoj	rabat'reklam'o'j
rabattarifo	rabat'tarif'o
rabena	raben'a
rabenaj	raben'a'j
rabenan	raben'a'n
rabeno	raben'o
rabenoj	raben'o'j
rabenojn	raben'o'j'n
rabenon	raben'o'n
rabia	rabi'a
rabio	rabi'o
raboti	rabot'i
rabotaĵoj	rabot'aĵ'o'j
racia	raci'a
raciaj	raci'a'j
raciajn	raci'a'j'n
racian	raci'a'n
racie	raci'e
racio	raci'o
racion	raci'o'n
raciaĵo	raci'aĵ'o
raciaĵon	raci'aĵ'o'n
racieco	raci'ec'o
raciecon	raci'ec'o'n
raciigas	raci'ig'as
raciigi	raci'ig'i
raciigo	raci'ig'o
raciigon	raci'ig'o'n
raciisma	raci'ism'a
raciismo	raci'ism'o
raciismon	raci'ism'o'n
raciuloj	raci'ul'o'j
racionalaj	racional'a'j
racionalismo	racional'ism'o
racionalisto	racional'ist'o
racionalistoj	racional'ist'o'j
rada	rad'a
rade	rad'e
rado	rad'o
radoj	rad'o'j
radojn	rad'o'j'n
radon	rad'o'n
radetoj	rad'et'o'j
radoaro	rad'o'ar'o
radrando	rad'rand'o
radŝpinilo	rad'ŝpin'il'o
radara	radar'a
radaraj	radar'a'j
radaro	radar'o
radaroj	radar'o'j
radarojn	radar'o'j'n
radaron	radar'o'n
radarsistemo	radar'sistem'o
radarsistemoj	radar'sistem'o'j
radia	radi'a
radiaj	radi'a'j
radiajn	radi'a'j'n
radian	radi'a'n
radias	radi'as
radie	radi'e
radii	radi'i
radiis	radi'is
radio	radi'o
radioj	radi'o'j
radiojn	radi'o'j'n
radion	radi'o'n
radiada	radi'ad'a
radiadaj	radi'ad'a'j
radiado	radi'ad'o
radiadoj	radi'ad'o'j
radiadojn	radi'ad'o'j'n
radiadon	radi'ad'o'n
radianta	radi'ant'a
radiantaj	radi'ant'a'j
radiantan	radi'ant'a'n
radiante	radi'ant'e
radielsenda	radi'el'send'a
radielsendaj	radi'el'send'a'j
radielsendajn	radi'el'send'a'j'n
radielsendan	radi'el'send'a'n
radielsendoj	radi'el'send'o'j
radiilo	radi'il'o
radiisto	radi'ist'o
radiita	radi'it'a
radioamatora	radi'o'amator'a
radioamatoraj	radi'o'amator'a'j
radioamatoro	radi'o'amator'o
radioamatoroj	radi'o'amator'o'j
radioaparato	radi'o'aparat'o
radioaparatoj	radi'o'aparat'o'j
radioaparaton	radi'o'aparat'o'n
radioastronomio	radi'o'astronom'i'o
radioaŭskultantoj	radi'o'aŭskult'ant'o'j
radiodisaŭdigo	radi'o'dis'aŭd'ig'o
radiodramoj	radi'o'dram'o'j
radioelsendo	radi'o'el'send'o
radioelsendoj	radi'o'el'send'o'j
radioelsendojn	radi'o'el'send'o'j'n
radiofrekvenco	radi'o'frekvenc'o
radiofrekvencoj	radi'o'frekvenc'o'j
radioizotopoj	radi'o'izotop'o'j
radiokomunikiloj	radi'o'komunik'il'o'j
radiometrika	radi'o'metr'ik'a
radioondoj	radi'o'ond'o'j
radioondojn	radi'o'ond'o'j'n
radioprogramo	radi'o'program'o
radioprogramoj	radi'o'program'o'j
radioprogramojn	radi'o'program'o'j'n
radioricevilo	radi'o'ricev'il'o
radioriceviloj	radi'o'ricev'il'o'j
radioricevilon	radi'o'ricev'il'o'n
radiosendilo	radi'o'send'il'o
radiosendiloj	radi'o'send'il'o'j
radiosimetriaj	radi'o'simetri'a'j
radiospektakloj	radi'o'spektakl'o'j
radiostacio	radi'o'staci'o
radiostacioj	radi'o'staci'o'j
radiostaciojn	radi'o'staci'o'j'n
radiostacion	radi'o'staci'o'n
radioteleskopo	radi'o'tele'skop'o
radioteleskopoj	radi'o'tele'skop'o'j
radioterapio	radi'o'terapi'o
radiondoj	radi'ond'o'j
radiondojn	radi'ond'o'j'n
radisignaloj	radi'signal'o'j
radisimetriaj	radi'simetri'a'j
radispektro	radi'spektr'o
radiala	radial'a
radialaj	radial'a'j
radialajn	radial'a'j'n
radialan	radial'a'n
radiale	radial'e
radiatoro	radiator'o
radiatoroj	radiator'o'j
radiatoron	radiator'o'n
radika	radik'a
radikaj	radik'a'j
radikajn	radik'a'j'n
radikan	radik'a'n
radikas	radik'as
radike	radik'e
radikis	radik'is
radiko	radik'o
radikoj	radik'o'j
radikojn	radik'o'j'n
radikon	radik'o'n
radikado	radik'ad'o
radikaro	radik'ar'o
radikaron	radik'ar'o'n
radiketoj	radik'et'o'j
radikiĝas	radik'iĝ'as
radikiĝis	radik'iĝ'is
radikpetroselo	radik'petrosel'o
radikvorto	radik'vort'o
radikvortoj	radik'vort'o'j
radikala	radikal'a
radikalaj	radikal'a'j
radikalajn	radikal'a'j'n
radikalan	radikal'a'n
radikale	radikal'e
radikalo	radikal'o
radikaloj	radikal'o'j
radikalismo	radikal'ism'o
radikalsocialisto	radikal'social'ist'o
radikalulo	radikal'ul'o
radikaluloj	radikal'ul'o'j
radikalulojn	radikal'ul'o'j'n
radioaktiva	radioaktiv'a
radioaktivaj	radioaktiv'a'j
radioaktivajn	radioaktiv'a'j'n
radioaktivan	radioaktiv'a'n
radioaktive	radioaktiv'e
radioaktiveco	radioaktiv'ec'o
radioaktivecon	radioaktiv'ec'o'n
radiofonia	radiofoni'a
radiofoniaj	radiofoni'a'j
radiofonio	radiofoni'o
radiologia	radiolog'i'a
radiologio	radiolog'i'o
radiumo	radium'o
radiusa	radius'a
radiuso	radius'o
radiusoj	radius'o'j
radiuson	radius'o'n
radono	radon'o
radulo	radul'o
raduloj	radul'o'j
rafaelo	rafael'o
rafano	rafan'o
rafanoj	rafan'o'j
rafanetoj	rafan'et'o'j
rafinas	rafin'as
rafini	rafin'i
rafinis	rafin'is
rafinado	rafin'ad'o
rafinadoj	rafin'ad'o'j
rafinadon	rafin'ad'o'n
rafinaĵo	rafin'aĵ'o
rafinejo	rafin'ej'o
rafinejoj	rafin'ej'o'j
rafinita	rafin'it'a
rafinitaj	rafin'it'a'j
rafinitajn	rafin'it'a'j'n
rafinitan	rafin'it'a'n
rafinite	rafin'it'e
raga	rag'a
rago	rag'o
ragtimo	ragtim'o
raguo	ragu'o
raĝo	raĝ'o
raĝastano	raĝastan'o
raja	raj'a
rajo	raj'o
rajda	rajd'a
rajdas	rajd'as
rajde	rajd'e
rajdi	rajd'i
rajdis	rajd'is
rajdo	rajd'o
rajdos	rajd'os
rajdu	rajd'u
rajdadis	rajd'ad'is
rajdado	rajd'ad'o
rajdadon	rajd'ad'o'n
rajdanta	rajd'ant'a
rajdantaj	rajd'ant'a'j
rajdante	rajd'ant'e
rajdanto	rajd'ant'o
rajdantoj	rajd'ant'o'j
rajdantojn	rajd'ant'o'j'n
rajdanton	rajd'ant'o'n
rajdarto	rajd'art'o
rajdbesto	rajd'best'o
rajdĉevaloj	rajd'ĉeval'o'j
rajdisto	rajd'ist'o
rajdistoj	rajd'ist'o'j
rajmondo	rajmond'o
rajono	rajon'o
rajta	rajt'a
rajtaj	rajt'a'j
rajtan	rajt'a'n
rajtas	rajt'as
rajte	rajt'e
rajti	rajt'i
rajtis	rajt'is
rajto	rajt'o
rajtoj	rajt'o'j
rajtojn	rajt'o'j'n
rajton	rajt'o'n
rajtos	rajt'os
rajtu	rajt'u
rajtus	rajt'us
rajtigas	rajt'ig'as
rajtigi	rajt'ig'i
rajtigis	rajt'ig'is
rajtigo	rajt'ig'o
rajtigoj	rajt'ig'o'j
rajtigojn	rajt'ig'o'j'n
rajtigon	rajt'ig'o'n
rajtigos	rajt'ig'os
rajtigus	rajt'ig'us
rajtigado	rajt'ig'ad'o
rajtigante	rajt'ig'ant'e
rajtigilon	rajt'ig'il'o'n
rajtigita	rajt'ig'it'a
rajtigitaj	rajt'ig'it'a'j
rajtigite	rajt'ig'it'e
rajtigito	rajt'ig'it'o
rajtigitoj	rajt'ig'it'o'j
rakedo	raked'o
rakedoj	raked'o'j
rakedojn	raked'o'j'n
rakedon	raked'o'n
raketa	raket'a
raketaj	raket'a'j
raketo	raket'o
raketoj	raket'o'j
raketojn	raket'o'j'n
raketon	raket'o'n
raketmotoro	raket'motor'o
raketmotoroj	raket'motor'o'j
raketscienco	raket'scienc'o
rakonta	rakont'a
rakontaj	rakont'a'j
rakontajn	rakont'a'j'n
rakontan	rakont'a'n
rakontas	rakont'as
rakonti	rakont'i
rakontis	rakont'is
rakonto	rakont'o
rakontoj	rakont'o'j
rakontojn	rakont'o'j'n
rakonton	rakont'o'n
rakontos	rakont'os
rakontu	rakont'u
rakontus	rakont'us
rakontadis	rakont'ad'is
rakontado	rakont'ad'o
rakontadon	rakont'ad'o'n
rakontanta	rakont'ant'a
rakontantaj	rakont'ant'a'j
rakontantan	rakont'ant'a'n
rakontante	rakont'ant'e
rakontanto	rakont'ant'o
rakontantoj	rakont'ant'o'j
rakontanton	rakont'ant'o'n
rakontaro	rakont'ar'o
rakontata	rakont'at'a
rakontataj	rakont'at'a'j
rakontestraroj	rakont'estr'ar'o'j
rakonteto	rakont'et'o
rakontetoj	rakont'et'o'j
rakontetojn	rakont'et'o'j'n
rakonteton	rakont'et'o'n
rakontfadeno	rakont'faden'o
rakontfadenoj	rakont'faden'o'j
rakontinta	rakont'int'a
rakontisto	rakont'ist'o
rakontistoj	rakont'ist'o'j
rakontita	rakont'it'a
rakontitaj	rakont'it'a'j
rakontitan	rakont'it'a'n
rakontite	rakont'it'e
rakontofadeno	rakont'o'faden'o
rakontofadenoj	rakont'o'faden'o'j
ramadano	ramadan'o
ramajano	ramajan'o
rampas	ramp'as
rampi	ramp'i
rampis	ramp'is
rampu	ramp'u
rampadis	ramp'ad'is
rampado	ramp'ad'o
rampaĵoj	ramp'aĵ'o'j
rampanta	ramp'ant'a
rampantaj	ramp'ant'a'j
rampantan	ramp'ant'a'n
rampante	ramp'ant'e
rampuloj	ramp'ul'o'j
rana	ran'a
rano	ran'o
ranoj	ran'o'j
ranojn	ran'o'j'n
ranon	ran'o'n
raneto	ran'et'o
ranido	ran'id'o
ranidoj	ran'id'o'j
ranidojn	ran'id'o'j'n
ranca	ranc'a
rance	ranc'e
randa	rand'a
randaj	rand'a'j
rande	rand'e
rando	rand'o
randoj	rand'o'j
randojn	rand'o'j'n
randon	rand'o'n
randomigita	random'ig'it'a
randomigitaj	random'ig'it'a'j
ranga	rang'a
rangas	rang'as
range	rang'e
rangi	rang'i
rango	rang'o
rangoj	rang'o'j
rangojn	rang'o'j'n
rangon	rang'o'n
rangigo	rang'ig'o
rangigoj	rang'ig'o'j
rangigojn	rang'ig'o'j'n
rangigon	rang'ig'o'n
rangigita	rang'ig'it'a
rangigitaj	rang'ig'it'a'j
rangotabelo	rang'o'tabel'o
rangotabeloj	rang'o'tabel'o'j
rangotabelojn	rang'o'tabel'o'j'n
rangotabelon	rang'o'tabel'o'n
ranguloj	rang'ul'o'j
rangiferoj	rangifer'o'j
rankoras	rankor'as
rankoro	rankor'o
rankoron	rankor'o'n
rapa	rap'a
rape	rap'e
rapo	rap'o
rapoj	rap'o'j
raphael	raphael
rapida	rapid'a
rapidaj	rapid'a'j
rapidajn	rapid'a'j'n
rapidan	rapid'a'n
rapidas	rapid'as
rapide	rapid'e
rapidi	rapid'i
rapidis	rapid'is
rapido	rapid'o
rapidoj	rapid'o'j
rapidojn	rapid'o'j'n
rapidon	rapid'o'n
rapidos	rapid'os
rapidu	rapid'u
rapidus	rapid'us
rapidante	rapid'ant'e
rapideca	rapid'ec'a
rapideco	rapid'ec'o
rapidecoj	rapid'ec'o'j
rapidecojn	rapid'ec'o'j'n
rapidecon	rapid'ec'o'n
rapideclimo	rapid'ec'lim'o
rapidecregulilo	rapid'ec'regul'il'o
rapidecvektoro	rapid'ec'vektor'o
rapidega	rapid'eg'a
rapidegaj	rapid'eg'a'j
rapidegas	rapid'eg'as
rapidege	rapid'eg'e
rapidegis	rapid'eg'is
rapidema	rapid'em'a
rapideme	rapid'em'e
rapidigas	rapid'ig'as
rapidigi	rapid'ig'i
rapidigis	rapid'ig'is
rapidigo	rapid'ig'o
rapidigos	rapid'ig'os
rapidigu	rapid'ig'u
rapidigita	rapid'ig'it'a
rapidiĝas	rapid'iĝ'as
rapidiĝis	rapid'iĝ'is
rapidiĝu	rapid'iĝ'u
rapidkreskema	rapid'kresk'em'a
rapidkreskemaj	rapid'kresk'em'a'j
rapidmanĝejo	rapid'manĝ'ej'o
rapidmanĝejoj	rapid'manĝ'ej'o'j
rapidometro	rapid'o'metr'o
rapidpaŝe	rapid'paŝ'e
rapidtrajno	rapid'trajn'o
rapidtrajnoj	rapid'trajn'o'j
rapidumado	rapid'um'ad'o
rapidumŝanĝilo	rapid'um'ŝanĝ'il'o
rapidumujo	rapid'um'uj'o
rapidumujoj	rapid'um'uj'o'j
rapidvojo	rapid'voj'o
rapidvojoj	rapid'voj'o'j
raporta	raport'a
raportaj	raport'a'j
raportas	raport'as
raporti	raport'i
raportis	raport'is
raporto	raport'o
raportoj	raport'o'j
raportojn	raport'o'j'n
raporton	raport'o'n
raportos	raport'os
raportu	raport'u
raportus	raport'us
raportado	raport'ad'o
raportadon	raport'ad'o'n
raportaĵo	raport'aĵ'o
raportaĵoj	raport'aĵ'o'j
raportaĵojn	raport'aĵ'o'j'n
raportaĵon	raport'aĵ'o'n
raportanta	raport'ant'a
raportantaj	raport'ant'a'j
raportante	raport'ant'e
raportanto	raport'ant'o
raportata	raport'at'a
raportista	raport'ist'a
raportisto	raport'ist'o
raportistoj	raport'ist'o'j
raportistojn	raport'ist'o'j'n
raportiston	raport'ist'o'n
raportistino	raport'ist'in'o
raportita	raport'it'a
raportitaj	raport'it'a'j
raportitan	raport'it'a'n
raportite	raport'it'e
rapsodio	rapsodi'o
rara	rar'a
raraj	rar'a'j
rarajn	rar'a'j'n
raran	rar'a'n
raras	rar'as
rare	rar'e
raraĵo	rar'aĵ'o
raraĵoj	rar'aĵ'o'j
raroia	raroia
rasa	ras'a
rasaj	ras'a'j
rasajn	ras'a'j'n
rasan	ras'a'n
rase	ras'e
raso	ras'o
rasoj	ras'o'j
rasojn	ras'o'j'n
rason	ras'o'n
rasapartismo	ras'apart'ism'o
rasisma	ras'ism'a
rasismaj	ras'ism'a'j
rasismajn	ras'ism'a'j'n
rasisman	ras'ism'a'n
rasisme	ras'ism'e
rasismo	ras'ism'o
rasismon	ras'ism'o'n
rasista	ras'ist'a
rasisto	ras'ist'o
rasistoj	ras'ist'o'j
raspa	rasp'a
raspi	rasp'i
raspilo	rasp'il'o
raspita	rasp'it'a
rastas	rast'as
rasti	rast'i
rastilo	rast'il'o
rastilon	rast'il'o'n
rastrumaj	rastr'um'a'j
rastrumo	rastr'um'o
rastrumon	rastr'um'o'n
rastrumero	rastr'um'er'o
rastrumeroj	rastr'um'er'o'j
rata	rat'a
rato	rat'o
ratoj	rat'o'j
ratojn	rat'o'j'n
raton	rat'o'n
ratio	rati'o
ratifas	ratif'as
ratifi	ratif'i
ratifis	ratif'is
ratifo	ratif'o
ratifita	ratif'it'a
ratifitaj	ratif'it'a'j
ratifikis	ratifik'is
ratifiko	ratifik'o
raŭka	raŭk'a
raŭkaj	raŭk'a'j
raŭkan	raŭk'a'n
raŭke	raŭk'e
raŭmisma	raŭm'ism'a
raŭmismaj	raŭm'ism'a'j
raŭmisman	raŭm'ism'a'n
raŭmisme	raŭm'ism'e
raŭmismo	raŭm'ism'o
raŭpo	raŭp'o
raŭpoj	raŭp'o'j
raŭpojn	raŭp'o'j'n
rava	rav'a
ravaj	rav'a'j
ravajn	rav'a'j'n
ravan	rav'a'n
ravas	rav'as
rave	rav'e
ravi	rav'i
ravis	rav'is
ravo	rav'o
ravon	rav'o'n
raviga	rav'ig'a
raviĝas	rav'iĝ'as
raviĝis	rav'iĝ'is
raviĝo	rav'iĝ'o
ravita	rav'it'a
ravitaj	rav'it'a'j
ravite	rav'it'e
ravino	ravin'o
ravinoj	ravin'o'j
ravinon	ravin'o'n
ravioloj	raviol'o'j
razas	raz'as
razi	raz'i
razis	raz'is
razu	raz'u
razado	raz'ad'o
razilo	raz'il'o
raziloj	raz'il'o'j
razilon	raz'il'o'n
razisto	raz'ist'o
razita	raz'it'a
razitaj	raz'it'a'j
razeno	razen'o
razenoj	razen'o'j
rea	re'a
reaj	re'a'j
reajn	re'a'j'n
rean	re'a'n
ree	re'e
reen	re'e'n
reo	re'o
reoj	re'o'j
reon	re'o'n
reaboni	re'abon'i
reabsorbita	re'absorb'it'a
reaĉeti	re'aĉet'i
readmono	re'admon'o
reaga	re'ag'a
reagan	re'ag'a'n
reagas	re'ag'as
reage	re'ag'e
reagi	re'ag'i
reagis	re'ag'is
reago	re'ag'o
reagoj	re'ag'o'j
reagojn	re'ag'o'j'n
reagon	re'ag'o'n
reagos	re'ag'os
reagu	re'ag'u
reagus	re'ag'us
reagado	re'ag'ad'o
reaganta	re'ag'ant'a
reagantaj	re'ag'ant'a'j
reagante	re'ag'ant'e
reagaviadiloj	re'ag'aviad'il'o'j
reagemo	re'ag'em'o
reagemon	re'ag'em'o'n
reagita	re'ag'it'a
reagtempo	re'ag'temp'o
reagtempon	re'ag'temp'o'n
reagordi	re'agord'i
reakiras	re'akir'as
reakiri	re'akir'i
reakiris	re'akir'is
reakiro	re'akir'o
reakiron	re'akir'o'n
reakiros	re'akir'os
reakiru	re'akir'u
reakirus	re'akir'us
reakirado	re'akir'ad'o
reakirante	re'akir'ant'e
reakirebla	re'akir'ebl'a
reakirita	re'akir'it'a
reakiritaj	re'akir'it'a'j
reaktiva	re'aktiv'a
reaktivaj	re'aktiv'a'j
reaktivajn	re'aktiv'a'j'n
reaktivan	re'aktiv'a'n
reaktivigi	re'aktiv'ig'i
reaktivigo	re'aktiv'ig'o
reaktivigita	re'aktiv'ig'it'a
reanimado	re'anim'ad'o
reanimadon	re'anim'ad'o'n
reaperas	re'aper'as
reaperi	re'aper'i
reaperis	re'aper'is
reapero	re'aper'o
reaperon	re'aper'o'n
reaperos	re'aper'os
reaperanto	re'aper'ant'o
reaperantoj	re'aper'ant'o'j
reaperigas	re'aper'ig'as
reaperigi	re'aper'ig'i
reaperigis	re'aper'ig'is
rearanĝas	re'aranĝ'as
rearanĝi	re'aranĝ'i
rearanĝis	re'aranĝ'is
rearanĝo	re'aranĝ'o
rearanĝon	re'aranĝ'o'n
rearanĝita	re'aranĝ'it'a
rearanĝitaj	re'aranĝ'it'a'j
rearbarigo	re'arb'ar'ig'o
reasertas	re'asert'as
reaserti	re'asert'i
reasertis	re'asert'is
reatingi	re'ating'i
reatingis	re'ating'is
rebaptistoj	re'bapt'ist'o'j
rebatas	re'bat'as
rebati	re'bat'i
rebatis	re'bat'is
rebato	re'bat'o
rebaton	re'bat'o'n
rebatos	re'bat'os
rebatado	re'bat'ad'o
rebatita	re'bat'it'a
rebatitaj	re'bat'it'a'j
rebonigi	re'bon'ig'i
rebonigo	re'bon'ig'o
rebrilas	re'bril'as
rebrilis	re'bril'is
rebrilo	re'bril'o
rebriloj	re'bril'o'j
rebrilon	re'bril'o'n
recikla	re'cikl'a
reciklaj	re'cikl'a'j
reciklas	re'cikl'as
recikli	re'cikl'i
reciklado	re'cikl'ad'o
recikladon	re'cikl'ad'o'n
reciklebla	re'cikl'ebl'a
recikleblaj	re'cikl'ebl'a'j
recikligas	re'cikl'ig'as
recikligi	re'cikl'ig'i
recikligo	re'cikl'ig'o
recikligado	re'cikl'ig'ad'o
recikligita	re'cikl'ig'it'a
recikligitaj	re'cikl'ig'it'a'j
reciklita	re'cikl'it'a
reciklitaj	re'cikl'it'a'j
redemandas	re'demand'as
redifinas	re'difin'as
redifini	re'difin'i
redifinis	re'difin'is
redifinita	re'difin'it'a
rediras	re'dir'as
rediri	re'dir'i
rediris	re'dir'is
rediru	re'dir'u
redirektas	re'direkt'as
redirekti	re'direkt'i
redirektis	re'direkt'is
redirektante	re'direkt'ant'e
redirektita	re'direkt'it'a
redirektitaj	re'direkt'it'a'j
redistribui	re'distribu'i
redistribuo	re'distribu'o
redistribuon	re'distribu'o'n
redistribuita	re'distribu'it'a
redonas	re'don'as
redoni	re'don'i
redonis	re'don'is
redono	re'don'o
redonon	re'don'o'n
redonos	re'don'os
redonu	re'don'u
redonus	re'don'us
redonante	re'don'ant'e
redonita	re'don'it'a
redonitaj	re'don'it'a'j
reedukado	re'eduk'ad'o
reedziĝi	re'edz'iĝ'i
reedziĝis	re'edz'iĝ'is
reedziniĝis	re'edz'in'iĝ'is
reeĥas	re'eĥ'as
reeĥis	re'eĥ'is
reeĥo	re'eĥ'o
reeĥon	re'eĥ'o'n
reekzameni	re'ekzamen'i
reekzameno	re'ekzamen'o
reeldoni	re'el'don'i
reeldonis	re'el'don'is
reeldono	re'el'don'o
reeldonoj	re'el'don'o'j
reeldonon	re'el'don'o'n
reeldonita	re'el'don'it'a
reeldonitaj	re'el'don'it'a'j
reeltrovaĵo	re'el'trov'aĵ'o
reelekti	re'elekt'i
reelekto	re'elekt'o
reelekton	re'elekt'o'n
reelektiĝo	re'elekt'iĝ'o
reelektita	re'elekt'it'a
reelektitaj	re'elekt'it'a'j
reeniras	re'en'ir'as
reeniri	re'en'ir'i
reeniris	re'en'ir'is
reeniro	re'en'ir'o
reeniron	re'en'ir'o'n
reenkarniĝo	re'en'karn'iĝ'o
reenkarniĝoj	re'en'karn'iĝ'o'j
reenkarniĝon	re'en'karn'iĝ'o'n
reenkonduki	re'en'konduk'i
reenkondukis	re'en'konduk'is
reenkonduko	re'en'konduk'o
reenkondukon	re'en'konduk'o'n
reenkondukita	re'en'konduk'it'a
reenkondukitaj	re'en'konduk'it'a'j
reenmeto	re'en'met'o
reenpostenigi	re'en'posten'ig'i
reenpostenigis	re'en'posten'ig'is
reenpostenigita	re'en'posten'ig'it'a
reestos	re'est'os
reestigas	re'est'ig'as
reestigi	re'est'ig'i
reestigis	re'est'ig'is
reestigado	re'est'ig'ad'o
reestigante	re'est'ig'ant'e
reestigita	re'est'ig'it'a
reestigitaj	re'est'ig'it'a'j
reestabli	re'establ'i
reestablis	re'establ'is
reestablitaj	re'establ'it'a'j
refalas	re'fal'as
refali	re'fal'i
refalis	re'fal'is
refalo	re'fal'o
refaldis	re'fald'is
refaldita	re'fald'it'a
refalditaj	re'fald'it'a'j
refaras	re'far'as
refari	re'far'i
refaris	re'far'is
refaros	re'far'os
refaru	re'far'u
refariĝis	re'far'iĝ'is
refariĝos	re'far'iĝ'os
refarita	re'far'it'a
refarbis	re'farb'is
refermis	re'ferm'is
refilmigo	re'film'ig'o
refluo	re'flu'o
reflugis	re'flug'is
refoja	re'foj'a
refojan	re'foj'a'n
refoje	re'foj'e
refondis	re'fond'is
refondo	re'fond'o
reforma	re'form'a
reformaj	re'form'a'j
reformas	re'form'as
reformi	re'form'i
reformis	re'form'is
reformo	re'form'o
reformoj	re'form'o'j
reformojn	re'form'o'j'n
reformon	re'form'o'n
reformu	re'form'u
reformada	re'form'ad'a
reformado	re'form'ad'o
reformadon	re'form'ad'o'n
reformanta	re'form'ant'a
reformante	re'form'ant'e
reformanto	re'form'ant'o
reformantoj	re'form'ant'o'j
reformema	re'form'em'a
reformemaj	re'form'em'a'j
reformemo	re'form'em'o
reformemuloj	re'form'em'ul'o'j
reformiĝis	re'form'iĝ'is
reformisma	re'form'ism'a
reformismo	re'form'ism'o
reformista	re'form'ist'a
reformisto	re'form'ist'o
reformistoj	re'form'ist'o'j
reformita	re'form'it'a
reformitaj	re'form'it'a'j
reformitan	re'form'it'a'n
reformmovado	re'form'mov'ad'o
reformprojektoj	re'form'projekt'o'j
reformproponoj	re'form'propon'o'j
reformuli	re'formul'i
reformulita	re'formul'it'a
refortiĝis	re'fort'iĝ'is
refreŝiga	re'freŝ'ig'a
refreŝigaj	re'freŝ'ig'a'j
refreŝigajn	re'freŝ'ig'a'j'n
refreŝigan	re'freŝ'ig'a'n
refreŝigas	re'freŝ'ig'as
refreŝigi	re'freŝ'ig'i
refreŝigis	re'freŝ'ig'is
refreŝigo	re'freŝ'ig'o
refreŝigu	re'freŝ'ig'u
refreŝigado	re'freŝ'ig'ad'o
refreŝigita	re'freŝ'ig'it'a
refreŝiĝi	re'freŝ'iĝ'i
refreŝiĝo	re'freŝ'iĝ'o
refunkciigi	re'funkci'ig'i
refunkciigo	re'funkci'ig'o
regajnas	re'gajn'as
regajni	re'gajn'i
regajnis	re'gajn'is
regajnos	re'gajn'os
regajneblaj	re'gajn'ebl'a'j
regeedziĝo	re'ge'edz'iĝ'o
regenera	re'gener'a
regeneraj	re'gener'a'j
regeneran	re'gener'a'n
regeneras	re'gener'as
regeneri	re'gener'i
regenerado	re'gener'ad'o
regeneradon	re'gener'ad'o'n
regeneriĝi	re'gener'iĝ'i
regenerita	re'gener'it'a
regrupiĝis	re'grup'iĝ'is
reĝustigi	re'ĝust'ig'i
reĝustigis	re'ĝust'ig'is
rehavi	re'hav'i
rehavis	re'hav'is
rehavos	re'hav'os
rehavigi	re'hav'ig'i
rehavigis	re'hav'ig'is
rehavigo	re'hav'ig'o
rehavigon	re'hav'ig'o'n
rehejmiĝas	re'hejm'iĝ'as
rehejmiĝi	re'hejm'iĝ'i
rehejmiĝis	re'hejm'iĝ'is
rehejmiĝos	re'hejm'iĝ'os
rehejmiĝu	re'hejm'iĝ'u
reigebla	re'ig'ebl'a
reigeblaj	re'ig'ebl'a'j
reigeblan	re'ig'ebl'a'n
reigeble	re'ig'ebl'e
reiĝis	re'iĝ'is
reinstali	re'instal'i
reinstalis	re'instal'is
reinstalo	re'instal'o
reinstalita	re'instal'it'a
reinstalitaj	re'instal'it'a'j
reinterpreti	re'interpret'i
reinterpreto	re'interpret'o
reinventi	re'invent'i
reiras	re'ir'as
reiri	re'ir'i
reiris	re'ir'is
reiro	re'ir'o
reiros	re'ir'os
reiru	re'ir'u
reirus	re'ir'us
reirante	re'ir'ant'e
reirigas	re'ir'ig'as
rejunigi	re'jun'ig'i
reĵetas	re'ĵet'as
reĵeti	re'ĵet'i
reĵetis	re'ĵet'is
rekandidatiĝi	re'kandidat'iĝ'i
rekantis	re'kant'is
rekantaĵo	re'kant'aĵ'o
rekapti	re'kapt'i
rekaptis	re'kapt'is
rekaptita	re'kapt'it'a
rekombina	re'kombin'a
rekombinas	re'kombin'as
rekombini	re'kombin'i
rekombinada	re'kombin'ad'a
rekombinigo	re'kombin'ig'o
rekombinigon	re'kombin'ig'o'n
rekomencas	re'komenc'as
rekomenci	re'komenc'i
rekomencis	re'komenc'is
rekomenco	re'komenc'o
rekomencon	re'komenc'o'n
rekomencos	re'komenc'os
rekomencu	re'komenc'u
rekomencus	re'komenc'us
rekomencado	re'komenc'ad'o
rekomencigi	re'komenc'ig'i
rekomencigita	re'komenc'ig'it'a
rekomenciĝas	re'komenc'iĝ'as
rekomenciĝis	re'komenc'iĝ'is
rekomenciĝos	re'komenc'iĝ'os
rekomencita	re'komenc'it'a
rekomencitaj	re'komenc'it'a'j
rekompensas	re'kompens'as
rekompensi	re'kompens'i
rekompensis	re'kompens'is
rekompenso	re'kompens'o
rekompenson	re'kompens'o'n
rekompensita	re'kompens'it'a
rekompensitaj	re'kompens'it'a'j
rekonas	re'kon'as
rekoni	re'kon'i
rekonis	re'kon'is
rekono	re'kon'o
rekonoj	re'kon'o'j
rekonon	re'kon'o'n
rekonos	re'kon'os
rekonu	re'kon'u
rekonus	re'kon'us
rekonada	re'kon'ad'a
rekonado	re'kon'ad'o
rekonante	re'kon'ant'e
rekonata	re'kon'at'a
rekonataj	re'kon'at'a'j
rekonebla	re'kon'ebl'a
rekoneblaj	re'kon'ebl'a'j
rekoneblajn	re'kon'ebl'a'j'n
rekoneblan	re'kon'ebl'a'n
rekoneblas	re'kon'ebl'as
rekoneble	re'kon'ebl'e
rekonilo	re'kon'il'o
rekoniloj	re'kon'il'o'j
rekoninta	re'kon'int'a
rekoninte	re'kon'int'e
rekonita	re'kon'it'a
rekonitaj	re'kon'it'a'j
rekonitajn	re'kon'it'a'j'n
rekonitan	re'kon'it'a'n
rekonite	re'kon'it'e
rekondukas	re'konduk'as
rekonduki	re'konduk'i
rekondukis	re'konduk'is
rekondukos	re'konduk'os
rekonkeri	re'konker'i
rekonkeris	re'konker'is
rekonkero	re'konker'o
rekonsciigis	re'konsci'ig'is
rekonsciiĝas	re'konsci'iĝ'as
rekonsciiĝi	re'konsci'iĝ'i
rekonsciiĝis	re'konsci'iĝ'is
rekonsciiĝo	re'konsci'iĝ'o
rekonsciiĝinte	re'konsci'iĝ'int'e
rekonsideras	re'konsider'as
rekonsideri	re'konsider'i
rekonsideris	re'konsider'is
rekonsideros	re'konsider'os
rekonsideru	re'konsider'u
rekonstrua	re'konstru'a
rekonstruaj	re'konstru'a'j
rekonstruan	re'konstru'a'n
rekonstruas	re'konstru'as
rekonstrui	re'konstru'i
rekonstruis	re'konstru'is
rekonstruo	re'konstru'o
rekonstruoj	re'konstru'o'j
rekonstruojn	re'konstru'o'j'n
rekonstruon	re'konstru'o'n
rekonstruos	re'konstru'os
rekonstruu	re'konstru'u
rekonstruado	re'konstru'ad'o
rekonstruadon	re'konstru'ad'o'n
rekonstruante	re'konstru'ant'e
rekonstruata	re'konstru'at'a
rekonstruiĝis	re'konstru'iĝ'is
rekonstruita	re'konstru'it'a
rekonstruitaj	re'konstru'it'a'j
rekonstruitan	re'konstru'it'a'n
rekreas	re'kre'as
rekrei	re'kre'i
rekreis	re'kre'is
rekreado	re'kre'ad'o
rekreita	re'kre'it'a
rekreitaj	re'kre'it'a'j
rekreskas	re'kresk'as
rekreskis	re'kresk'is
rekresko	re'kresk'o
rekreskos	re'kresk'os
rekreskantaj	re'kresk'ant'a'j
rekreskigi	re'kresk'ig'i
rekuniĝas	re'kun'iĝ'as
rekuniĝi	re'kun'iĝ'i
rekuniĝis	re'kun'iĝ'is
rekuniĝo	re'kun'iĝ'o
rekunmeti	re'kun'met'i
rekunmetis	re'kun'met'is
rekuris	re'kur'is
rekuraĝigi	re'kuraĝ'ig'i
rekursiva	re'kursiv'a
rekursivaj	re'kursiv'a'j
rekursivan	re'kursiv'a'n
rekursive	re'kursiv'e
relanĉi	re'lanĉ'i
relanĉo	re'lanĉ'o
relegas	re'leg'as
relegi	re'leg'i
relegis	re'leg'is
relegu	re'leg'u
relegado	re'leg'ad'o
relegante	re'leg'ant'e
relerni	re'lern'i
relevi	re'lev'i
relevis	re'lev'is
releviĝas	re'lev'iĝ'as
releviĝis	re'lev'iĝ'is
releviĝo	re'lev'iĝ'o
religas	re'lig'as
religi	re'lig'i
religo	re'lig'o
religoj	re'lig'o'j
religon	re'lig'o'n
relivero	re'liver'o
reliveron	re'liver'o'n
reloki	re'lok'i
reludigo	re'lud'ig'o
reludigon	re'lud'ig'o'n
remaĉas	re'maĉ'as
remaĉuloj	re'maĉ'ul'o'j
remalfermi	re'mal'ferm'i
remalfermis	re'mal'ferm'is
remalfermo	re'mal'ferm'o
remalfermita	re'mal'ferm'it'a
remalfermitaj	re'mal'ferm'it'a'j
remalkovri	re'mal'kovr'i
remalkovris	re'mal'kovr'is
remalkovro	re'mal'kovr'o
rememoras	re'memor'as
rememore	re'memor'e
rememori	re'memor'i
rememoris	re'memor'is
rememoro	re'memor'o
rememoroj	re'memor'o'j
rememorojn	re'memor'o'j'n
rememoron	re'memor'o'n
rememoros	re'memor'os
rememoru	re'memor'u
rememorus	re'memor'us
rememoradis	re'memor'ad'is
rememorado	re'memor'ad'o
rememoraĵoj	re'memor'aĵ'o'j
rememorante	re'memor'ant'e
rememoriga	re'memor'ig'a
rememorigaj	re'memor'ig'a'j
rememorigas	re'memor'ig'as
rememorigi	re'memor'ig'i
rememorigis	re'memor'ig'is
rememorigo	re'memor'ig'o
rememorigu	re'memor'ig'u
rememoriganta	re'memor'ig'ant'a
rememorigante	re'memor'ig'ant'e
rememorinte	re'memor'int'e
remetas	re'met'as
remeti	re'met'i
remetis	re'met'is
remetos	re'met'os
remetu	re'met'u
renaski	re'nask'i
renaskiĝas	re'nask'iĝ'as
renaskiĝi	re'nask'iĝ'i
renaskiĝis	re'nask'iĝ'is
renaskiĝo	re'nask'iĝ'o
renaskiĝoj	re'nask'iĝ'o'j
renaskiĝon	re'nask'iĝ'o'n
renaskiĝos	re'nask'iĝ'os
renaskita	re'nask'it'a
renaskitaj	re'nask'it'a'j
renoma	re'nom'a
renomaj	re'nom'a'j
renomi	re'nom'i
renomis	re'nom'is
renomo	re'nom'o
renomon	re'nom'o'n
renomiĝis	re'nom'iĝ'is
renomita	re'nom'it'a
renomitaj	re'nom'it'a'j
renormaliĝas	re'normal'iĝ'as
renormaliĝi	re'normal'iĝ'i
renormaliĝis	re'normal'iĝ'is
renoviga	re'nov'ig'a
renovigaj	re'nov'ig'a'j
renovigas	re'nov'ig'as
renovigi	re'nov'ig'i
renovigis	re'nov'ig'is
renovigo	re'nov'ig'o
renovigon	re'nov'ig'o'n
renovigos	re'nov'ig'os
renovigu	re'nov'ig'u
renovigado	re'nov'ig'ad'o
renovigadon	re'nov'ig'ad'o'n
renovigata	re'nov'ig'at'a
renovigebla	re'nov'ig'ebl'a
renovigeblaj	re'nov'ig'ebl'a'j
renovigeblajn	re'nov'ig'ebl'a'j'n
renovigeblan	re'nov'ig'ebl'a'n
renovigita	re'nov'ig'it'a
renovigitaj	re'nov'ig'it'a'j
renovigitan	re'nov'ig'it'a'n
renoviĝas	re'nov'iĝ'as
renoviĝi	re'nov'iĝ'i
renoviĝis	re'nov'iĝ'is
renoviĝo	re'nov'iĝ'o
renoviĝon	re'nov'iĝ'o'n
renoviĝanta	re'nov'iĝ'ant'a
renoviĝantaj	re'nov'iĝ'ant'a'j
renoviĝantan	re'nov'iĝ'ant'a'n
renoviĝantenergia	re'nov'iĝ'ant'energi'a
renoviĝantenergiaj	re'nov'iĝ'ant'energi'a'j
renoviĝantenergiajn	re'nov'iĝ'ant'energi'a'j'n
renoviĝinta	re'nov'iĝ'int'a
renoviĝintan	re'nov'iĝ'int'a'n
renuligi	re'nul'ig'i
reokupis	re'okup'is
reordigi	re'ord'ig'i
reordigis	re'ord'ig'is
reordigo	re'ord'ig'o
reorganizas	re'organiz'as
reorganizi	re'organiz'i
reorganizis	re'organiz'is
reorganizo	re'organiz'o
reorganizon	re'organiz'o'n
reorganizado	re'organiz'ad'o
reorganizadon	re'organiz'ad'o'n
reorganizante	re'organiz'ant'e
reorganizita	re'organiz'it'a
reorganizitaj	re'organiz'it'a'j
repacigi	re'pac'ig'i
repacigis	re'pac'ig'is
repacigo	re'pac'ig'o
repacigon	re'pac'ig'o'n
repaciĝi	re'pac'iĝ'i
repaciĝis	re'pac'iĝ'is
repaciĝo	re'pac'iĝ'o
repaciĝon	re'pac'iĝ'o'n
repagas	re'pag'as
repagi	re'pag'i
repagis	re'pag'is
repago	re'pag'o
repagoj	re'pag'o'j
repagon	re'pag'o'n
repagos	re'pag'os
repagu	re'pag'u
repagita	re'pag'it'a
repagitaj	re'pag'it'a'j
reparolis	re'parol'is
reparolos	re'parol'os
repatriigo	re'patri'ig'o
repensi	re'pens'i
repensis	re'pens'is
replantado	re'plant'ad'o
replenigas	re'plen'ig'as
replenigi	re'plen'ig'i
replenigis	re'plen'ig'is
replenigita	re'plen'ig'it'a
replenigitaj	re'plen'ig'it'a'j
reportas	re'port'as
reporti	re'port'i
reportis	re'port'is
reportos	re'port'os
reportu	re'port'u
reprenas	re'pren'as
repreni	re'pren'i
reprenis	re'pren'is
repreno	re'pren'o
reprenos	re'pren'os
reprenu	re'pren'u
reprenado	re'pren'ad'o
reprenante	re'pren'ant'e
reprenita	re'pren'it'a
reprenitaj	re'pren'it'a'j
represi	re'pres'i
represo	re'pres'o
represita	re'pres'it'a
represitaj	re'pres'it'a'j
repripensi	re'pri'pens'i
reprodukta	re'produkt'a
reproduktaj	re'produkt'a'j
reproduktajn	re'produkt'a'j'n
reproduktan	re'produkt'a'n
reproduktas	re'produkt'as
reprodukti	re'produkt'i
reproduktis	re'produkt'is
reprodukto	re'produkt'o
reprodukton	re'produkt'o'n
reproduktado	re'produkt'ad'o
reproduktadon	re'produkt'ad'o'n
reproduktaĵo	re'produkt'aĵ'o
reproduktaĵoj	re'produkt'aĵ'o'j
reproduktaĵojn	re'produkt'aĵ'o'j'n
reproduktanta	re'produkt'ant'a
reproduktantaj	re'produkt'ant'a'j
reproduktante	re'produkt'ant'e
reproduktantoj	re'produkt'ant'o'j
reproduktebla	re'produkt'ebl'a
reprodukteblaj	re'produkt'ebl'a'j
reproduktejaj	re'produkt'ej'a'j
reproduktejo	re'produkt'ej'o
reproduktejoj	re'produkt'ej'o'j
reproduktiĝas	re'produkt'iĝ'as
reproduktiĝi	re'produkt'iĝ'i
reproduktiĝis	re'produkt'iĝ'is
reproduktiĝo	re'produkt'iĝ'o
reproduktiĝado	re'produkt'iĝ'ad'o
reproduktita	re'produkt'it'a
reproduktitaj	re'produkt'it'a'j
reproduktulo	re'produkt'ul'o
reproduktuloj	re'produkt'ul'o'j
reprogramado	re'program'ad'o
reprogramita	re'program'it'a
reproponis	re'propon'is
reprosperigi	re'prosper'ig'i
reprosperigo	re'prosper'ig'o
reprosperiĝo	re'prosper'iĝ'o
reprovi	re'prov'i
reprovis	re'prov'is
reprovos	re'prov'os
reprovizi	re'proviz'i
republikigas	re'publik'ig'as
repuŝas	re'puŝ'as
repuŝi	re'puŝ'i
repuŝis	re'puŝ'is
repuŝo	re'puŝ'o
repuŝatakis	re'puŝ'atak'is
repuŝita	re'puŝ'it'a
repuŝitaj	re'puŝ'it'a'j
rerakontas	re'rakont'as
rerakonti	re'rakont'i
rerakontado	re'rakont'ad'o
rerenkonti	re'renkont'i
rericevas	re'ricev'as
rericevi	re'ricev'i
rericevis	re'ricev'is
rericevos	re'ricev'os
rerigardas	re'rigard'as
rerigardi	re'rigard'i
rerigardis	re'rigard'is
rerigardante	re'rigard'ant'e
resaltas	re'salt'as
resalti	re'salt'i
resaltis	re'salt'is
resalto	re'salt'o
resanigas	re'san'ig'as
resanigi	re'san'ig'i
resanigis	re'san'ig'is
resanigo	re'san'ig'o
resanigon	re'san'ig'o'n
resanigos	re'san'ig'os
resanigado	re'san'ig'ad'o
resaniganto	re'san'ig'ant'o
resanigantoj	re'san'ig'ant'o'j
resanigita	re'san'ig'it'a
resanigitaj	re'san'ig'it'a'j
resaniĝas	re'san'iĝ'as
resaniĝi	re'san'iĝ'i
resaniĝis	re'san'iĝ'is
resanigho	re'san'iĝ'o
resaniĝo	re'san'iĝ'o
resaniĝon	re'san'iĝ'o'n
resaniĝos	re'san'iĝ'os
resaniĝu	re'san'iĝ'u
resaniĝanta	re'san'iĝ'ant'a
resaniĝinta	re'san'iĝ'int'a
resaniĝinte	re'san'iĝ'int'e
resendas	re'send'as
resendi	re'send'i
resendis	re'send'is
resendo	re'send'o
resendos	re'send'os
resendu	re'send'u
resendus	re'send'us
resendado	re'send'ad'o
resendante	re'send'ant'e
resendita	re'send'it'a
resenditaj	re'send'it'a'j
resenditan	re'send'it'a'n
resendite	re'send'it'e
reserĉi	re'serĉ'i
reserĉoj	re'serĉ'o'j
reserĉado	re'serĉ'ad'o
residiĝis	re'sid'iĝ'is
reskribi	re'skrib'i
reskribis	re'skrib'is
reskribita	re'skrib'it'a
resonas	re'son'as
resonis	re'son'is
resono	re'son'o
resonon	re'son'o'n
resonado	re'son'ad'o
resonanta	re'son'ant'a
resonfrekvenco	re'son'frekvenc'o
respegulas	re'spegul'as
respeguli	re'spegul'i
respegulis	re'spegul'is
respegulon	re'spegul'o'n
respeguliĝas	re'spegul'iĝ'as
respeguliĝis	re'spegul'iĝ'is
respegulita	re'spegul'it'a
respurado	re'spur'ad'o
restarigas	re'star'ig'as
restarigi	re'star'ig'i
restarigis	re'star'ig'is
restarigo	re'star'ig'o
restarigon	re'star'ig'o'n
restarigos	re'star'ig'os
restarigado	re'star'ig'ad'o
restarigante	re'star'ig'ant'e
restarigita	re'star'ig'it'a
restarigitaj	re'star'ig'it'a'j
restariĝas	re'star'iĝ'as
restariĝi	re'star'iĝ'i
restariĝis	re'star'iĝ'is
restariĝo	re'star'iĝ'o
restartigi	re'start'ig'i
restartigo	re'start'ig'o
restrukturas	re'struktur'as
restrukturi	re'struktur'i
restrukturis	re'struktur'is
restrukturado	re'struktur'ad'o
restrukturadoj	re'struktur'ad'o'j
restrukturadon	re'struktur'ad'o'n
restrukturante	re'struktur'ant'e
restrukturigo	re'struktur'ig'o
restrukturigon	re'struktur'ig'o'n
restrukturita	re'struktur'it'a
restrukturitaj	re'struktur'it'a'j
resurscenigo	re'sur'scen'ig'o
reŝargas	re'ŝarg'as
reŝargi	re'ŝarg'i
reŝargado	re'ŝarg'ad'o
reŝargita	re'ŝarg'it'a
reŝargitaj	re'ŝarg'it'a'j
retaksi	re'taks'i
retakso	re'taks'o
retaksado	re'taks'ad'o
retelefoni	re'telefon'i
retelefonos	re'telefon'os
retena	re'ten'a
retenas	re'ten'as
reteni	re'ten'i
retenis	re'ten'is
reteno	re'ten'o
retenon	re'ten'o'n
retenos	re'ten'os
retenu	re'ten'u
retenus	re'ten'us
retenadis	re'ten'ad'is
retenado	re'ten'ad'o
retenanta	re'ten'ant'a
retenante	re'ten'ant'e
retenata	re'ten'at'a
reteniloj	re'ten'il'o'j
retenita	re'ten'it'a
retenitaj	re'ten'it'a'j
retiras	re'tir'as
retiri	re'tir'i
retiris	re'tir'is
retiro	re'tir'o
retiron	re'tir'o'n
retiros	re'tir'os
retiru	re'tir'u
retirante	re'tir'ant'e
retirebla	re'tir'ebl'a
retireblaj	re'tir'ebl'a'j
retiriĝas	re'tir'iĝ'as
retiriĝi	re'tir'iĝ'i
retiriĝis	re'tir'iĝ'is
retiriĝo	re'tir'iĝ'o
retiriĝoj	re'tir'iĝ'o'j
retiriĝon	re'tir'iĝ'o'n
retiriĝos	re'tir'iĝ'os
retiriĝu	re'tir'iĝ'u
retiriĝus	re'tir'iĝ'us
retiriĝado	re'tir'iĝ'ad'o
retiriĝanta	re'tir'iĝ'ant'a
retiriĝante	re'tir'iĝ'ant'e
retiriĝejo	re'tir'iĝ'ej'o
retiriĝinte	re'tir'iĝ'int'e
retiriĝita	re'tir'iĝ'it'a
retirita	re'tir'it'a
retiritaj	re'tir'it'a'j
retrankviliĝis	re'trankvil'iĝ'is
retrovas	re'trov'as
retrovi	re'trov'i
retrovis	re'trov'is
retrovo	re'trov'o
retrovos	re'trov'os
retrovu	re'trov'u
retroviĝas	re'trov'iĝ'as
retroviĝi	re'trov'iĝ'i
retroviĝis	re'trov'iĝ'is
retrovita	re'trov'it'a
retrovitaj	re'trov'it'a'j
returna	re'turn'a
returnas	re'turn'as
returne	re'turn'e
returnen	re'turn'e'n
returni	re'turn'i
returnis	re'turn'is
returnos	re'turn'os
returnu	re'turn'u
returniĝis	re'turn'iĝ'is
returninte	re'turn'int'e
returnite	re'turn'it'e
returniten	re'turn'it'e'n
reunuigi	re'unu'ig'i
reunuigo	re'unu'ig'o
reunuigon	re'unu'ig'o'n
reunuigita	re'unu'ig'it'a
reunuigitaj	re'unu'ig'it'a'j
reunuiĝas	re'unu'iĝ'as
reunuiĝi	re'unu'iĝ'i
reunuiĝis	re'unu'iĝ'is
reunuiĝo	re'unu'iĝ'o
reunuiĝon	re'unu'iĝ'o'n
reuzas	re'uz'as
reuzi	re'uz'i
reuzo	re'uz'o
reuzon	re'uz'o'n
reuzado	re'uz'ad'o
reuzataj	re'uz'at'a'j
reuzebla	re'uz'ebl'a
reuzeblaj	re'uz'ebl'a'j
revalorigi	re'valor'ig'i
revalorigo	re'valor'ig'o
revaluto	re'valut'o
revarmigi	re'varm'ig'i
reveki	re'vek'i
revekiĝas	re'vek'iĝ'as
revekiĝis	re'vek'iĝ'is
revena	re'ven'a
revenas	re'ven'as
revene	re'ven'e
reveni	re'ven'i
revenis	re'ven'is
reveno	re'ven'o
revenoj	re'ven'o'j
revenon	re'ven'o'n
revenos	re'ven'os
revenu	re'ven'u
revenus	re'ven'us
revenadis	re'ven'ad'is
revenado	re'ven'ad'o
revenanta	re'ven'ant'a
revenantaj	re'ven'ant'a'j
revenantajn	re'ven'ant'a'j'n
revenantan	re'ven'ant'a'n
revenante	re'ven'ant'e
revenigas	re'ven'ig'as
revenigi	re'ven'ig'i
revenigis	re'ven'ig'is
revenigo	re'ven'ig'o
revenigos	re'ven'ig'os
revenigu	re'ven'ig'u
reveninta	re'ven'int'a
revenintaj	re'ven'int'a'j
revenintan	re'ven'int'a'n
reveninte	re'ven'int'e
revenintoj	re'ven'int'o'j
revenintos	re'ven'int'os
revenonta	re'ven'ont'a
revenonte	re'ven'ont'e
revendi	re'vend'i
revendo	re'vend'o
revendistaj	re'vend'ist'a'j
revendistoj	re'vend'ist'o'j
revenĝo	re'venĝ'o
reverkas	re'verk'as
reverki	re'verk'i
reverkis	re'verk'is
reverkado	re'verk'ad'o
reverkante	re'verk'ant'e
reverkita	re'verk'it'a
reverkitaj	re'verk'it'a'j
revestas	re'vest'as
revestis	re'vest'is
reveturi	re'vetur'i
reveturis	re'vetur'is
reveturo	re'vetur'o
reveturigi	re'vetur'ig'i
revidas	re'vid'as
revidi	re'vid'i
revidis	re'vid'is
revido	re'vid'o
revidos	re'vid'os
revidu	re'vid'u
revigligi	re'vigl'ig'i
revigligis	re'vigl'ig'is
revigligo	re'vigl'ig'o
revigligita	re'vigl'ig'it'a
revigliĝas	re'vigl'iĝ'as
revigliĝi	re'vigl'iĝ'i
revigliĝis	re'vigl'iĝ'is
revigliĝo	re'vigl'iĝ'o
revigliĝon	re'vigl'iĝ'o'n
revivas	re'viv'as
revivi	re'viv'i
revivigas	re'viv'ig'as
revivigi	re'viv'ig'i
revivigis	re'viv'ig'is
revivigo	re'viv'ig'o
revivigon	re'viv'ig'o'n
revivigos	re'viv'ig'os
revivigu	re'viv'ig'u
revivigado	re'viv'ig'ad'o
revivigante	re'viv'ig'ant'e
revivigita	re'viv'ig'it'a
revivigitaj	re'viv'ig'it'a'j
reviviĝas	re'viv'iĝ'as
reviviĝi	re'viv'iĝ'i
reviviĝis	re'viv'iĝ'is
reviviĝo	re'viv'iĝ'o
reviviĝoj	re'viv'iĝ'o'j
reviviĝon	re'viv'iĝ'o'n
reviviĝos	re'viv'iĝ'os
reviviĝinta	re'viv'iĝ'int'a
revizitas	re'vizit'as
reviziti	re'vizit'i
revizitis	re'vizit'is
revojaĝo	re'vojaĝ'o
revokas	re'vok'as
revoki	re'vok'i
revokis	re'vok'is
revoko	re'vok'o
revokon	re'vok'o'n
revokos	re'vok'os
revoku	re'vok'u
revokita	re'vok'it'a
revokitaj	re'vok'it'a'j
revortigo	re'vort'ig'o
rea	rea
reao	rea'o
reakcia	reakci'a
reakciaj	reakci'a'j
reakciajn	reakci'a'j'n
reakcian	reakci'a'n
reakcias	reakci'as
reakcii	reakci'i
reakcio	reakci'o
reakcioj	reakci'o'j
reakciojn	reakci'o'j'n
reakcion	reakci'o'n
reakciaĵo	reakci'aĵ'o
reakcianto	reakci'ant'o
reakciantoj	reakci'ant'o'j
reakciema	reakci'em'a
reakciemo	reakci'em'o
reakciilo	reakci'il'o
reakciiloj	reakci'il'o'j
reakciulo	reakci'ul'o
reakciuloj	reakci'ul'o'j
reaktora	reaktor'a
reaktoro	reaktor'o
reaktoroj	reaktor'o'j
reaktorojn	reaktor'o'j'n
reaktoron	reaktor'o'n
reaktordezajnoj	reaktor'dezajn'o'j
reala	real'a
realaj	real'a'j
realajn	real'a'j'n
realan	real'a'n
realas	real'as
reale	real'e
realo	real'o
realoj	real'o'j
realojn	real'o'j'n
realon	real'o'n
realaĵo	real'aĵ'o
realaĵoj	real'aĵ'o'j
realaĵojn	real'aĵ'o'j'n
realaĵon	real'aĵ'o'n
realbatala	real'batal'a
realbatalaj	real'batal'a'j
realbatalado	real'batal'ad'o
realeca	real'ec'a
realecaj	real'ec'a'j
realeco	real'ec'o
realecon	real'ec'o'n
realigas	real'ig'as
realigi	real'ig'i
realigis	real'ig'is
realigo	real'ig'o
realigoj	real'ig'o'j
realigojn	real'ig'o'j'n
realigon	real'ig'o'n
realigos	real'ig'os
realigu	real'ig'u
realigus	real'ig'us
realigado	real'ig'ad'o
realiganta	real'ig'ant'a
realigantaj	real'ig'ant'a'j
realigante	real'ig'ant'e
realiganto	real'ig'ant'o
realigantoj	real'ig'ant'o'j
realigata	real'ig'at'a
realigataj	real'ig'at'a'j
realigebla	real'ig'ebl'a
realigeblaj	real'ig'ebl'a'j
realigeblajn	real'ig'ebl'a'j'n
realigeblan	real'ig'ebl'a'n
realigeblas	real'ig'ebl'as
realigita	real'ig'it'a
realigitaj	real'ig'it'a'j
realigitajn	real'ig'it'a'j'n
realigitan	real'ig'it'a'n
realigite	real'ig'it'e
realiĝas	real'iĝ'as
realiĝi	real'iĝ'i
realiĝis	real'iĝ'is
realiĝo	real'iĝ'o
realiĝon	real'iĝ'o'n
realiĝos	real'iĝ'os
realiĝu	real'iĝ'u
realiĝus	real'iĝ'us
realisma	real'ism'a
realismaj	real'ism'a'j
realismajn	real'ism'a'j'n
realisman	real'ism'a'n
realisme	real'ism'e
realismo	real'ism'o
realismon	real'ism'o'n
realista	real'ist'a
realisto	real'ist'o
realistoj	real'ist'o'j
realmonda	real'mond'a
realmondaj	real'mond'a'j
realmondajn	real'mond'a'j'n
realmondan	real'mond'a'n
realtempa	real'temp'a
realtempaj	real'temp'a'j
realtempajn	real'temp'a'j'n
realtempan	real'temp'a'n
realviva	real'viv'a
realvivaj	real'viv'a'j
realvivajn	real'viv'a'j'n
realvivan	real'viv'a'n
realvoki	real'vok'i
realvokos	real'vok'os
realvoku	real'vok'u
rebeka	rebeka
rebelo	rebel'o
recenza	recenz'a
recenzas	recenz'as
recenzi	recenz'i
recenzis	recenz'is
recenzo	recenz'o
recenzoj	recenz'o'j
recenzojn	recenz'o'j'n
recenzon	recenz'o'n
recenzado	recenz'ad'o
recenzante	recenz'ant'e
recenzanto	recenz'ant'o
recenzantoj	recenz'ant'o'j
recenzata	recenz'at'a
recenzisto	recenz'ist'o
recenzistoj	recenz'ist'o'j
recenzita	recenz'it'a
recenzitaj	recenz'it'a'j
recepto	recept'o
receptoj	recept'o'j
receptojn	recept'o'j'n
recepton	recept'o'n
receptoro	receptor'o
receptoroj	receptor'o'j
receptorojn	receptor'o'j'n
recesio	recesi'o
recesioj	recesi'o'j
recesion	recesi'o'n
reciproka	reciprok'a
reciprokaj	reciprok'a'j
reciprokajn	reciprok'a'j'n
reciprokan	reciprok'a'n
reciprokas	reciprok'as
reciproke	reciprok'e
reciproki	reciprok'i
reciprokis	reciprok'is
reciprokado	reciprok'ad'o
reciprokeco	reciprok'ec'o
reciprokecon	reciprok'ec'o'n
reciprokistoj	reciprok'ist'o'j
recitas	recit'as
reciti	recit'i
recitis	recit'is
recitado	recit'ad'o
recitata	recit'at'a
recitalo	recital'o
recitaloj	recital'o'j
recitalon	recital'o'n
recitativo	recitativ'o
recitativoj	recitativ'o'j
redakcia	redakci'a
redakciaj	redakci'a'j
redakciajn	redakci'a'j'n
redakcian	redakci'a'n
redakcie	redakci'e
redakcio	redakci'o
redakcioj	redakci'o'j
redakcion	redakci'o'n
redakcianoj	redakci'an'o'j
redakciejo	redakci'ej'o
redakta	redakt'a
redaktaj	redakt'a'j
redaktan	redakt'a'n
redaktas	redakt'as
redakti	redakt'i
redaktis	redakt'is
redakto	redakt'o
redaktoj	redakt'o'j
redaktos	redakt'os
redaktu	redakt'u
redaktado	redakt'ad'o
redaktadon	redakt'ad'o'n
redaktaĵo	redakt'aĵ'o
redaktanta	redakt'ant'a
redaktante	redakt'ant'e
redaktanto	redakt'ant'o
redaktantoj	redakt'ant'o'j
redaktata	redakt'at'a
redaktataj	redakt'at'a'j
redaktejo	redakt'ej'o
redaktilo	redakt'il'o
redaktiloj	redakt'il'o'j
redaktilon	redakt'il'o'n
redaktisto	redakt'ist'o
redaktistoj	redakt'ist'o'j
redaktistojn	redakt'ist'o'j'n
redaktiston	redakt'ist'o'n
redaktistaro	redakt'ist'ar'o
redaktita	redakt'it'a
redaktitaj	redakt'it'a'j
redaktitajn	redakt'it'a'j'n
redaktitan	redakt'it'a'n
redaktite	redakt'it'e
redaktopolitiko	redakt'o'politik'o
redaktora	redaktor'a
redaktoran	redaktor'a'n
redaktoro	redaktor'o
redaktoroj	redaktor'o'j
redaktorojn	redaktor'o'j'n
redaktoron	redaktor'o'n
redaktoreco	redaktor'ec'o
redaktorino	redaktor'in'o
redondo	redond'o
redukcioj	redukci'o'j
reduktaj	redukt'a'j
reduktas	redukt'as
redukti	redukt'i
reduktis	redukt'is
redukto	redukt'o
reduktoj	redukt'o'j
reduktojn	redukt'o'j'n
redukton	redukt'o'n
reduktos	redukt'os
reduktu	redukt'u
reduktus	redukt'us
reduktado	redukt'ad'o
reduktagento	redukt'agent'o
reduktagentoj	redukt'agent'o'j
reduktanta	redukt'ant'a
reduktantaj	redukt'ant'a'j
reduktantajn	redukt'ant'a'j'n
reduktantan	redukt'ant'a'n
reduktante	redukt'ant'e
reduktebla	redukt'ebl'a
reduktiĝas	redukt'iĝ'as
reduktiĝi	redukt'iĝ'i
reduktiĝis	redukt'iĝ'is
reduktiĝo	redukt'iĝ'o
reduktiĝos	redukt'iĝ'os
reduktismo	redukt'ism'o
reduktita	redukt'it'a
reduktitaj	redukt'it'a'j
reduktitajn	redukt'it'a'j'n
reduktitan	redukt'it'a'n
redunda	redund'a
redundaj	redund'a'j
redundajn	redund'a'j'n
redundan	redund'a'n
redundo	redund'o
redundon	redund'o'n
reduto	redut'o
redutoj	redut'o'j
reela	reel'a
reelaj	reel'a'j
reelan	reel'a'n
refaro	ref'ar'o
refektorio	refektori'o
referas	refer'as
referi	refer'i
referaĵo	refer'aĵ'o
referaĵon	refer'aĵ'o'n
referato	refer'at'o
referita	refer'it'a
referitaj	refer'it'a'j
referitajn	refer'it'a'j'n
referitan	refer'it'a'n
referite	refer'it'e
referiten	refer'it'e'n
referato	referat'o
referenca	referenc'a
referencaj	referenc'a'j
referencan	referenc'a'n
referencas	referenc'as
reference	referenc'e
referenci	referenc'i
referencis	referenc'is
referenco	referenc'o
referencoj	referenc'o'j
referencojn	referenc'o'j'n
referencon	referenc'o'n
referencante	referenc'ant'e
referencata	referenc'at'a
referencataj	referenc'at'a'j
referencita	referenc'it'a
referencito	referenc'it'o
referencitoj	referenc'it'o'j
referenckadro	referenc'kadr'o
referenclaboro	referenc'labor'o
referenclaboroj	referenc'labor'o'j
referencpunkto	referenc'punkt'o
referencpunktoj	referenc'punkt'o'j
referenduma	referendum'a
referendumo	referendum'o
referendumoj	referendum'o'j
referendumojn	referendum'o'j'n
referendumon	referendum'o'n
reflekse	refleks'e
reflekso	refleks'o
refleksoj	refleks'o'j
refleksojn	refleks'o'j'n
reflekson	refleks'o'n
refleksiva	refleksiv'a
refleksivaj	refleksiv'a'j
refleksivan	refleksiv'a'n
refleksivo	refleksiv'o
reflekta	reflekt'a
reflektaj	reflekt'a'j
reflektajn	reflekt'a'j'n
reflektan	reflekt'a'n
reflektas	reflekt'as
reflekti	reflekt'i
reflektis	reflekt'is
reflekto	reflekt'o
reflektoj	reflekt'o'j
reflekton	reflekt'o'n
reflektos	reflekt'os
reflektu	reflekt'u
reflektus	reflekt'us
reflektado	reflekt'ad'o
reflektadoj	reflekt'ad'o'j
reflektadojn	reflekt'ad'o'j'n
reflektadon	reflekt'ad'o'n
reflektanta	reflekt'ant'a
reflektantaj	reflekt'ant'a'j
reflektantajn	reflekt'ant'a'j'n
reflektante	reflekt'ant'e
reflektiĝas	reflekt'iĝ'as
reflektiĝis	reflekt'iĝ'is
reflektita	reflekt'it'a
reflektitaj	reflekt'it'a'j
reflektitajn	reflekt'it'a'j'n
reflektitan	reflekt'it'a'n
reflektite	reflekt'it'e
reflektoro	reflektor'o
reflektoroj	reflektor'o'j
reflektorojn	reflektor'o'j'n
reflektoron	reflektor'o'n
reformacia	reformaci'a
reformacio	reformaci'o
reformacion	reformaci'o'n
refrakta	refrakt'a
refraktaj	refrakt'a'j
refraktan	refrakt'a'n
refrakto	refrakt'o
refrakton	refrakt'o'n
refreno	refren'o
refrenon	refren'o'n
refrenkoruso	refren'korus'o
refrenkorusoj	refren'korus'o'j
refrenkoruson	refren'korus'o'n
refutas	refut'as
refuti	refut'i
refutis	refut'is
refuto	refut'o
refuton	refut'o'n
refutante	refut'ant'e
refutebla	refut'ebl'a
refutita	refut'it'a
refuzis	refuz'is
rega	reg'a
regaj	reg'a'j
regan	reg'a'n
regas	reg'as
regi	reg'i
regis	reg'is
rego	reg'o
regoj	reg'o'j
regon	reg'o'n
regos	reg'os
regu	reg'u
regus	reg'us
regada	reg'ad'a
regadan	reg'ad'a'n
regadas	reg'ad'as
regadi	reg'ad'i
regadis	reg'ad'is
regado	reg'ad'o
regadoj	reg'ad'o'j
regadon	reg'ad'o'n
regadosistemo	reg'ad'o'sistem'o
regadosistemon	reg'ad'o'sistem'o'n
reganta	reg'ant'a
regantaj	reg'ant'a'j
regantajn	reg'ant'a'j'n
regantan	reg'ant'a'n
regante	reg'ant'e
reganto	reg'ant'o
regantoj	reg'ant'o'j
regantojn	reg'ant'o'j'n
reganton	reg'ant'o'n
regantaro	reg'ant'ar'o
reganteco	reg'ant'ec'o
regantino	reg'ant'in'o
regata	reg'at'a
regataj	reg'at'a'j
regatan	reg'at'a'n
regato	reg'at'o
regatoj	reg'at'o'j
regatojn	reg'at'o'j'n
regebla	reg'ebl'a
regilo	reg'il'o
regiloj	reg'il'o'j
regilojn	reg'il'o'j'n
regilon	reg'il'o'n
reginta	reg'int'a
registo	reg'ist'o
registoj	reg'ist'o'j
registara	reg'ist'ar'a
registaraj	reg'ist'ar'a'j
registarajn	reg'ist'ar'a'j'n
registaran	reg'ist'ar'a'n
registare	reg'ist'ar'e
registaro	reg'ist'ar'o
registaroj	reg'ist'ar'o'j
registarojn	reg'ist'ar'o'j'n
registaron	reg'ist'ar'o'n
registarago	reg'ist'ar'ag'o
registaragentejo	reg'ist'ar'agent'ej'o
registaragentejoj	reg'ist'ar'agent'ej'o'j
registaranoj	reg'ist'ar'an'o'j
registardokumentoj	reg'ist'ar'dokument'o'j
registarelspezoj	reg'ist'ar'el'spez'o'j
registarenmiksiĝo	reg'ist'ar'en'miks'iĝ'o
registarestro	reg'ist'ar'estr'o
registarestroj	reg'ist'ar'estr'o'j
registarfinancado	reg'ist'ar'financ'ad'o
registariniciatoj	reg'ist'ar'iniciat'o'j
registarinstancoj	reg'ist'ar'instanc'o'j
registarkonstruaĵoj	reg'ist'ar'konstru'aĵ'o'j
registarkontrolitaj	reg'ist'ar'kontrol'it'a'j
registarministerioj	reg'ist'ar'ministeri'o'j
registarobligacioj	reg'ist'ar'obligaci'o'j
registaroficejoj	reg'ist'ar'ofic'ej'o'j
registaroficisto	reg'ist'ar'ofic'ist'o
registaroficistoj	reg'ist'ar'ofic'ist'o'j
registaroficistojn	reg'ist'ar'ofic'ist'o'j'n
registarpolitiko	reg'ist'ar'politik'o
registarpolitikoj	reg'ist'ar'politik'o'j
registarposedataj	reg'ist'ar'posed'at'a'j
registarpostenoj	reg'ist'ar'posten'o'j
registarregulado	reg'ist'ar'regul'ad'o
registarreprezentantoj	reg'ist'ar'reprezent'ant'o'j
registarservo	reg'ist'ar'serv'o
registarservoj	reg'ist'ar'serv'o'j
registarsponsorita	reg'ist'ar'sponsor'it'a
registarŝanĝoj	reg'ist'ar'ŝanĝ'o'j
registartrupoj	reg'ist'ar'trup'o'j
regita	reg'it'a
regitaj	reg'it'a'j
regite	reg'it'e
regopovo	reg'o'pov'o
regopovoj	reg'o'pov'o'j
regopovon	reg'o'pov'o'n
regosimboloj	reg'o'simbol'o'j
regotempo	reg'o'temp'o
regpanelo	reg'panel'o
regpartio	reg'parti'o
regpotenca	reg'potenc'a
regpotenco	reg'potenc'o
regpotencon	reg'potenc'o'n
regpovo	reg'pov'o
regpovon	reg'pov'o'n
regsistemo	reg'sistem'o
regalas	regal'as
regali	regal'i
regalis	regal'is
regalo	regal'o
regaloj	regal'o'j
regalon	regal'o'n
regalos	regal'os
regalu	regal'u
regalado	regal'ad'o
regalataj	regal'at'a'j
regalita	regal'it'a
regalitaj	regal'it'a'j
regeo	rege'o
regensburgo	regensburg'o
regento	regent'o
regentoj	regent'o'j
regentino	regent'in'o
regia	regi'a
regio	regi'o
region	regi'o'n
regimenta	regiment'a
regimento	regiment'o
regimentoj	regiment'o'j
regimentojn	regiment'o'j'n
regimenton	regiment'o'n
regimentestro	regiment'estr'o
regiona	region'a
regionaj	region'a'j
regionajn	region'a'j'n
regionan	region'a'n
regione	region'e
regiono	region'o
regionoj	region'o'j
regionojn	region'o'j'n
regionon	region'o'n
regioneto	region'et'o
regionismo	region'ism'o
registra	registr'a
registraj	registr'a'j
registras	registr'as
registri	registr'i
registris	registr'is
registro	registr'o
registroj	registr'o'j
registrojn	registr'o'j'n
registron	registr'o'n
registros	registr'os
registru	registr'u
registrus	registr'us
registrada	registr'ad'a
registradaj	registr'ad'a'j
registradi	registr'ad'i
registrado	registr'ad'o
registradoj	registr'ad'o'j
registradojn	registr'ad'o'j'n
registradon	registr'ad'o'n
registraditaj	registr'ad'it'a'j
registradstudio	registr'ad'studi'o
registraĵo	registr'aĵ'o
registraĵoj	registr'aĵ'o'j
registraĵojn	registr'aĵ'o'j'n
registraĵon	registr'aĵ'o'n
registranta	registr'ant'a
registrante	registr'ant'e
registranto	registr'ant'o
registraro	registr'ar'o
registrata	registr'at'a
registrataj	registr'at'a'j
registrejo	registr'ej'o
registrigi	registr'ig'i
registrigis	registr'ig'is
registriĝas	registr'iĝ'as
registriĝi	registr'iĝ'i
registriĝis	registr'iĝ'is
registriĝo	registr'iĝ'o
registriĝon	registr'iĝ'o'n
registrilo	registr'il'o
registriloj	registr'il'o'j
registrilon	registr'il'o'n
registristo	registr'ist'o
registrita	registr'it'a
registritaj	registr'it'a'j
registritajn	registr'it'a'j'n
registritan	registr'it'a'n
registrite	registr'it'e
registrujoj	registr'uj'o'j
reglamenti	reglament'i
reglamento	reglament'o
reglamentoj	reglament'o'j
reglamentojn	reglament'o'j'n
regna	regn'a
regnaj	regn'a'j
regnan	regn'a'n
regnas	regn'as
regnis	regn'is
regno	regn'o
regnoj	regn'o'j
regnojn	regn'o'j'n
regnon	regn'o'n
regnanoj	regn'an'o'j
regnestro	regn'estr'o
regnestroj	regn'estr'o'j
regnoestro	regn'o'estr'o
regresa	regres'a
regresaj	regres'a'j
regresan	regres'a'n
regresas	regres'as
regresis	regres'is
regreso	regres'o
regreson	regres'o'n
regresanalizo	regres'analiz'o
regula	regul'a
regulaj	regul'a'j
regulajn	regul'a'j'n
regulan	regul'a'n
regulas	regul'as
regule	regul'e
reguli	regul'i
regulo	regul'o
reguloj	regul'o'j
regulojn	regul'o'j'n
regulon	regul'o'n
regulado	regul'ad'o
reguladon	regul'ad'o'n
regularaj	regul'ar'a'j
regularo	regul'ar'o
regularoj	regul'ar'o'j
regularojn	regul'ar'o'j'n
regularon	regul'ar'o'n
regulata	regul'at'a
regulbazita	regul'baz'it'a
regulbazitaj	regul'baz'it'a'j
reguleco	regul'ec'o
regulecoj	regul'ec'o'j
regulecon	regul'ec'o'n
reguliga	regul'ig'a
reguligaj	regul'ig'a'j
reguligajn	regul'ig'a'j'n
reguligan	regul'ig'a'n
reguligas	regul'ig'as
reguligi	regul'ig'i
reguligis	regul'ig'is
reguligo	regul'ig'o
reguligoj	regul'ig'o'j
reguligon	regul'ig'o'n
reguligu	regul'ig'u
reguligado	regul'ig'ad'o
reguligadon	regul'ig'ad'o'n
reguliganta	regul'ig'ant'a
reguligante	regul'ig'ant'e
reguligata	regul'ig'at'a
reguligisto	regul'ig'ist'o
reguligistoj	regul'ig'ist'o'j
reguligita	regul'ig'it'a
reguligitaj	regul'ig'it'a'j
regulilo	regul'il'o
regulita	regul'it'a
regulitaj	regul'it'a'j
regha	reĝ'a
reĝa	reĝ'a
reĝaj	reĝ'a'j
reĝajn	reĝ'a'j'n
reĝan	reĝ'a'n
reĝas	reĝ'as
reĝe	reĝ'e
reĝi	reĝ'i
reĝis	reĝ'is
regho	reĝ'o
reĝo	reĝ'o
reĝoj	reĝ'o'j
reĝojn	reĝ'o'j'n
reĝon	reĝ'o'n
reĝado	reĝ'ad'o
reĝeco	reĝ'ec'o
reĝecon	reĝ'ec'o'n
reĝfamilianoj	reĝ'famili'an'o'j
reĝido	reĝ'id'o
reĝidon	reĝ'id'o'n
reĝidino	reĝ'id'in'o
reĝidinoj	reĝ'id'in'o'j
reĝidinon	reĝ'id'in'o'n
reĝina	reĝ'in'a
reghino	reĝ'in'o
reĝino	reĝ'in'o
reĝino	reĝ'in'o
reĝinoj	reĝ'in'o'j
reĝinon	reĝ'in'o'n
reĝkonsilio	reĝ'konsili'o
reĝlanda	reĝ'land'a
reĝlando	reĝ'land'o
reĝlandoj	reĝ'land'o'j
reĝlandojn	reĝ'land'o'j'n
reĝlandon	reĝ'land'o'n
reĝolando	reĝ'o'land'o
reĝolandon	reĝ'o'land'o'n
reĝparo	reĝ'par'o
reĝimo	reĝim'o
reĝimoj	reĝim'o'j
reĝimojn	reĝim'o'j'n
reĝimon	reĝim'o'n
reĝisora	reĝisor'a
reĝisoras	reĝisor'as
reĝisori	reĝisor'i
reĝisoris	reĝisor'is
reĝisoro	reĝisor'o
reghisoroj	reĝisor'o'j
reĝisoroj	reĝisor'o'j
reĝisoron	reĝisor'o'n
reĝisorado	reĝisor'ad'o
reĝisorino	reĝisor'in'o
reĝisorita	reĝisor'it'a
reĝisoritaj	reĝisor'it'a'j
reĝistro	reĝistr'o
reĝistroj	reĝistr'o'j
rehabilito	rehabilit'o
rehabilitado	rehabilit'ad'o
rehabilitadon	rehabilit'ad'o'n
rejna	rejn'a
rejno	rejn'o
rejnon	rejn'o'n
rejnlanda	rejn'land'a
rejnlando	rejn'land'o
rejnhardo	rejnhard'o
reklama	reklam'a
reklamaj	reklam'a'j
reklamajn	reklam'a'j'n
reklaman	reklam'a'n
reklamas	reklam'as
reklami	reklam'i
reklamis	reklam'is
reklamo	reklam'o
reklamoj	reklam'o'j
reklamojn	reklam'o'j'n
reklamon	reklam'o'n
reklamado	reklam'ad'o
reklamadon	reklam'ad'o'n
reklamagentejo	reklam'agent'ej'o
reklamanta	reklam'ant'a
reklamantaj	reklam'ant'a'j
reklamante	reklam'ant'e
reklamanto	reklam'ant'o
reklamantoj	reklam'ant'o'j
reklamata	reklam'at'a
reklamilo	reklam'il'o
reklamistoj	reklam'ist'o'j
reklamita	reklam'it'a
reklamitaj	reklam'it'a'j
reklamvideo	reklam'vide'o
reklamvideoj	reklam'vide'o'j
rekluzo	rekluz'o
rekomendas	rekomend'as
rekomendi	rekomend'i
rekomendis	rekomend'is
rekomendo	rekomend'o
rekomendoj	rekomend'o'j
rekomendojn	rekomend'o'j'n
rekomendon	rekomend'o'n
rekomendos	rekomend'os
rekomendu	rekomend'u
rekomendus	rekomend'us
rekomendado	rekomend'ad'o
rekomendanta	rekomend'ant'a
rekomendantaj	rekomend'ant'a'j
rekomendante	rekomend'ant'e
rekomendanto	rekomend'ant'o
rekomendantoj	rekomend'ant'o'j
rekomendata	rekomend'at'a
rekomendataj	rekomend'at'a'j
rekomendinda	rekomend'ind'a
rekomendindaj	rekomend'ind'a'j
rekomendindas	rekomend'ind'as
rekomendinde	rekomend'ind'e
rekomendita	rekomend'it'a
rekomenditaj	rekomend'it'a'j
rekomenditajn	rekomend'it'a'j'n
rekomenditan	rekomend'it'a'n
rekomendite	rekomend'it'e
rekompencas	rekompenc'as
rekompence	rekompenc'e
rekompenci	rekompenc'i
rekompencis	rekompenc'is
rekompenco	rekompenc'o
rekompencoj	rekompenc'o'j
rekompencojn	rekompenc'o'j'n
rekompencon	rekompenc'o'n
rekompencos	rekompenc'os
rekompencu	rekompenc'u
rekompencata	rekompenc'at'a
rekompencita	rekompenc'it'a
rekorda	rekord'a
rekordaj	rekord'a'j
rekordan	rekord'a'n
rekorde	rekord'e
rekordis	rekord'is
rekordo	rekord'o
rekordoj	rekord'o'j
rekordojn	rekord'o'j'n
rekordon	rekord'o'n
rekremento	rekrement'o
rekrutas	rekrut'as
rekruti	rekrut'i
rekrutis	rekrut'is
rekruto	rekrut'o
rekrutoj	rekrut'o'j
rekrutojn	rekrut'o'j'n
rekrutado	rekrut'ad'o
rekrutadon	rekrut'ad'o'n
rekrutante	rekrut'ant'e
rekrutigistoj	rekrut'ig'ist'o'j
rekrutita	rekrut'it'a
rekrutitaj	rekrut'it'a'j
rekta	rekt'a
rektaj	rekt'a'j
rektajn	rekt'a'j'n
rektan	rekt'a'n
rekte	rekt'e
rekten	rekt'e'n
rekto	rekt'o
rektoj	rekt'o'j
rektaĵo	rekt'aĵ'o
rektaĵon	rekt'aĵ'o'n
rektangula	rekt'angul'a
rektangulaj	rekt'angul'a'j
rektangulajn	rekt'angul'a'j'n
rektangulan	rekt'angul'a'n
rektangule	rekt'angul'e
rektangulo	rekt'angul'o
rektanguloj	rekt'angul'o'j
rektangulon	rekt'angul'o'n
rekteco	rekt'ec'o
rektigas	rekt'ig'as
rektigi	rekt'ig'i
rektigis	rekt'ig'is
rektigo	rekt'ig'o
rektigu	rekt'ig'u
rektigita	rekt'ig'it'a
rektiĝas	rekt'iĝ'as
rektiĝis	rekt'iĝ'is
rektlinia	rekt'lini'a
rektliniaj	rekt'lini'a'j
rektlinian	rekt'lini'a'n
rektlinie	rekt'lini'e
rektmetoda	rekt'metod'a
rektoĉena	rekt'o'ĉen'a
rektifi	rektif'i
rektifilo	rektif'il'o
rektifiloj	rektif'il'o'j
rektoro	rektor'o
rektoroj	rektor'o'j
rektorojn	rektor'o'j'n
rektoron	rektor'o'n
rektumo	rektum'o
rekuperi	rekuper'i
rekuperis	rekuper'is
rekupero	rekuper'o
rekuperado	rekuper'ad'o
rekursia	rekursi'a
rekursiaj	rekursi'a'j
rekviemo	rekviem'o
rekvizitoj	rekvizit'o'j
relo	rel'o
reloj	rel'o'j
relojn	rel'o'j'n
relon	rel'o'n
reloĝigo	rel'o'ĝig'o
relservo	rel'serv'o
relajas	relaj'as
relaji	relaj'i
relajis	relaj'is
relajita	relaj'it'a
relajitaj	relaj'it'a'j
relajso	relajs'o
relajsoj	relajs'o'j
relajson	relajs'o'n
relativa	relativ'a
relativaj	relativ'a'j
relativajn	relativ'a'j'n
relativan	relativ'a'n
relative	relativ'e
relativeca	relativ'ec'a
relativeco	relativ'ec'o
relativecon	relativ'ec'o'n
relativigi	relativ'ig'i
relativismo	relativ'ism'o
relativismon	relativ'ism'o'n
relativista	relativ'ist'a
relativistaj	relativ'ist'a'j
relativistan	relativ'ist'a'n
reliefa	relief'a
reliefaj	relief'a'j
reliefas	relief'as
reliefe	relief'e
reliefo	relief'o
reliefoj	relief'o'j
reliefon	relief'o'n
reliefigas	relief'ig'as
reliefigi	relief'ig'i
reliefigis	relief'ig'is
reliefiĝas	relief'iĝ'as
reliefornamita	relief'ornam'it'a
religia	religi'a
religiaj	religi'a'j
religiajn	religi'a'j'n
religian	religi'a'n
religie	religi'e
religio	religi'o
religioj	religi'o'j
religiojn	religi'o'j'n
religion	religi'o'n
religianoj	religi'an'o'j
religieco	religi'ec'o
religiema	religi'em'a
religiemaj	religi'em'a'j
religiemajn	religi'em'a'j'n
religieman	religi'em'a'n
religiemo	religi'em'o
religiestroj	religi'estr'o'j
religiostudoj	religi'o'stud'o'j
religiulo	religi'ul'o
religiuloj	religi'ul'o'j
religiulojn	religi'ul'o'j'n
religiulino	religi'ul'in'o
religiulinoj	religi'ul'in'o'j
relikva	relikv'a
relikvo	relikv'o
relikvoj	relikv'o'j
relikvojn	relikv'o'j'n
relikvujo	relikv'uj'o
remas	rem'as
remi	rem'i
remis	rem'is
remo	rem'o
remu	rem'u
remus	rem'us
remado	rem'ad'o
remante	rem'ant'e
remanto	rem'ant'o
remantoj	rem'ant'o'j
remboaton	rem'boat'o'n
remilo	rem'il'o
remiloj	rem'il'o'j
remilojn	rem'il'o'j'n
remilon	rem'il'o'n
remisto	rem'ist'o
remistoj	rem'ist'o'j
remburaĵo	rembur'aĵ'o
remburita	rembur'it'a
remburitaj	rembur'it'a'j
remburitan	rembur'it'a'n
remizo	remiz'o
remizon	remiz'o'n
remonstrantoj	remonstrant'o'j
remparo	rempar'o
remparoj	rempar'o'j
remparojn	rempar'o'j'n
remparon	rempar'o'n
rena	ren'a
renaj	ren'a'j
renan	ren'a'n
rene	ren'e
reno	ren'o
renoj	ren'o'j
renojn	ren'o'j'n
renon	ren'o'n
renata	renat'a
renato	renat'o
rendevuas	rendevu'as
rendevui	rendevu'i
rendevuis	rendevu'is
rendevuo	rendevu'o
rendevuoj	rendevu'o'j
rendevuojn	rendevu'o'j'n
rendevuon	rendevu'o'n
rendevuos	rendevu'os
rendevuu	rendevu'u
rendevuejo	rendevu'ej'o
rendevuejon	rendevu'ej'o'n
rendimenta	rendiment'a
rendimento	rendiment'o
rendimentoj	rendiment'o'j
rendimentojn	rendiment'o'j'n
rendimenton	rendiment'o'n
renegato	renegat'o
renesanca	renesanc'a
renesancaj	renesanc'a'j
renesancajn	renesanc'a'j'n
renesancan	renesanc'a'n
renesanco	renesanc'o
renesancon	renesanc'o'n
renio	reni'o
renkonta	renkont'a
renkontaj	renkont'a'j
renkontajn	renkont'a'j'n
renkontas	renkont'as
renkonte	renkont'e
renkonti	renkont'i
renkontis	renkont'is
renkonto	renkont'o
renkontoj	renkont'o'j
renkontojn	renkont'o'j'n
renkonton	renkont'o'n
renkontos	renkont'os
renkontu	renkont'u
renkontus	renkont'us
renkontadis	renkont'ad'is
renkontado	renkont'ad'o
renkontanta	renkont'ant'a
renkontantaj	renkont'ant'a'j
renkontante	renkont'ant'e
renkontata	renkont'at'a
renkontataj	renkont'at'a'j
renkonteblas	renkont'ebl'as
renkontejo	renkont'ej'o
renkontiĝas	renkont'iĝ'as
renkontiĝi	renkont'iĝ'i
renkontiĝis	renkont'iĝ'is
renkontigho	renkont'iĝ'o
renkontiĝo	renkont'iĝ'o
renkontiĝoj	renkont'iĝ'o'j
renkontiĝojn	renkont'iĝ'o'j'n
renkontiĝon	renkont'iĝ'o'n
renkontiĝos	renkont'iĝ'os
renkontiĝu	renkont'iĝ'u
renkontiĝus	renkont'iĝ'us
renkontiĝadis	renkont'iĝ'ad'is
renkontiĝante	renkont'iĝ'ant'e
renkontiĝejo	renkont'iĝ'ej'o
renkontiĝloko	renkont'iĝ'lok'o
renkontinta	renkont'int'a
renkontinte	renkont'int'e
renkontita	renkont'it'a
renkontitaj	renkont'it'a'j
renkontitajn	renkont'it'a'j'n
renoma	renom'a
renomaj	renom'a'j
renomi	renom'i
renomis	renom'is
renomo	renom'o
renomon	renom'o'n
renomiĝis	renom'iĝ'is
renomita	renom'it'a
renomitaj	renom'it'a'j
rento	rent'o
rentoj	rent'o'j
renton	rent'o'n
rentumo	rent'um'o
rentgena	rentgen'a
rentgenfota	rentgen'fot'a
rentgenfotaj	rentgen'fot'a'j
rentgenfotan	rentgen'fot'a'n
rentgenradioj	rentgen'radi'o'j
rentgenradiojn	rentgen'radi'o'j'n
renversa	renvers'a
renversas	renvers'as
renverse	renvers'e
renversi	renvers'i
renversis	renvers'is
renverso	renvers'o
renversoj	renvers'o'j
renverson	renvers'o'n
renversos	renvers'os
renversus	renvers'us
renversado	renvers'ad'o
renversante	renvers'ant'e
renversiĝa	renvers'iĝ'a
renversiĝas	renvers'iĝ'as
renversiĝi	renvers'iĝ'i
renversiĝis	renvers'iĝ'is
renversiĝo	renvers'iĝ'o
renversiĝoj	renvers'iĝ'o'j
renversiĝon	renvers'iĝ'o'n
renversiĝos	renvers'iĝ'os
renversiĝado	renvers'iĝ'ad'o
renversinte	renvers'int'e
renversita	renvers'it'a
renversitaj	renvers'it'a'j
renversitan	renvers'it'a'n
renversite	renvers'it'e
repo	rep'o
repon	rep'o'n
repisto	rep'ist'o
repistoj	rep'ist'o'j
repelitaj	repel'it'a'j
repertuaro	repertuar'o
repertuaron	repertuar'o'n
replikas	replik'as
repliki	replik'i
replikis	replik'is
repliko	replik'o
replikoj	replik'o'j
replikojn	replik'o'j'n
reportero	reporter'o
reporteroj	reporter'o'j
reprezalio	reprezali'o
reprezalioj	reprezali'o'j
reprezaliojn	reprezali'o'j'n
reprezalion	reprezali'o'n
reprezenta	reprezent'a
reprezentaj	reprezent'a'j
reprezentajn	reprezent'a'j'n
reprezentan	reprezent'a'n
reprezentas	reprezent'as
reprezenti	reprezent'i
reprezentis	reprezent'is
reprezento	reprezent'o
reprezentoj	reprezent'o'j
reprezenton	reprezent'o'n
reprezentos	reprezent'os
reprezentu	reprezent'u
reprezentus	reprezent'us
reprezentado	reprezent'ad'o
reprezentadoj	reprezent'ad'o'j
reprezentadojn	reprezent'ad'o'j'n
reprezentadon	reprezent'ad'o'n
reprezentaĵo	reprezent'aĵ'o
reprezentaĵoj	reprezent'aĵ'o'j
reprezentanta	reprezent'ant'a
reprezentantaj	reprezent'ant'a'j
reprezentantajn	reprezent'ant'a'j'n
reprezentantan	reprezent'ant'a'n
reprezentante	reprezent'ant'e
reprezentanto	reprezent'ant'o
reprezentantoj	reprezent'ant'o'j
reprezentantojn	reprezent'ant'o'j'n
reprezentanton	reprezent'ant'o'n
reprezentantaro	reprezent'ant'ar'o
reprezentantaroj	reprezent'ant'ar'o'j
reprezentantarojn	reprezent'ant'ar'o'j'n
reprezentantaron	reprezent'ant'ar'o'n
reprezentantĉambro	reprezent'ant'ĉambr'o
reprezentanteco	reprezent'ant'ec'o
reprezentantino	reprezent'ant'in'o
reprezentata	reprezent'at'a
reprezentataj	reprezent'at'a'j
reprezentejo	reprezent'ej'o
reprezentiĝas	reprezent'iĝ'as
reprezentiĝis	reprezent'iĝ'is
reprezentiĝo	reprezent'iĝ'o
reprezentita	reprezent'it'a
reprezentitaj	reprezent'it'a'j
reprezentitan	reprezent'it'a'n
reprezentite	reprezent'it'e
reptilio	reptili'o
reptilioj	reptili'o'j
reptiliojn	reptili'o'j'n
repudias	repudi'as
repudii	repudi'i
repudiis	repudi'is
repudiita	repudi'it'a
repudiitaj	repudi'it'a'j
reputacio	reputaci'o
reputacioj	reputaci'o'j
reputaciojn	reputaci'o'j'n
reputacion	reputaci'o'n
reskripto	reskript'o
resonanca	resonanc'a
resonancaj	resonanc'a'j
resonancan	resonanc'a'n
resonancis	resonanc'is
resonanco	resonanc'o
resonancoj	resonanc'o'j
resonancon	resonanc'o'n
resonancfelo	resonanc'fel'o
resonatoro	resonator'o
resonatoroj	resonator'o'j
respekta	respekt'a
respektan	respekt'a'n
respektas	respekt'as
respekte	respekt'e
respekti	respekt'i
respektis	respekt'is
respekto	respekt'o
respekton	respekt'o'n
respektos	respekt'os
respektu	respekt'u
respektus	respekt'us
respektado	respekt'ad'o
respektanta	respekt'ant'a
respektantaj	respekt'ant'a'j
respektante	respekt'ant'e
respektata	respekt'at'a
respektataj	respekt'at'a'j
respektatan	respekt'at'a'n
respekteco	respekt'ec'o
respektego	respekt'eg'o
respektegon	respekt'eg'o'n
respektema	respekt'em'a
respektemaj	respekt'em'a'j
respekteman	respekt'em'a'n
respekteme	respekt'em'e
respektigi	respekt'ig'i
respektinda	respekt'ind'a
respektindaj	respekt'ind'a'j
respektindan	respekt'ind'a'n
respektita	respekt'it'a
respektitaj	respekt'it'a'j
respektoplena	respekt'o'plen'a
respektoplene	respekt'o'plen'e
respektiva	respektiv'a
respektivaj	respektiv'a'j
respektivajn	respektiv'a'j'n
respektivan	respektiv'a'n
respektivas	respektiv'as
respektive	respektiv'e
responda	respond'a
respondaj	respond'a'j
respondajn	respond'a'j'n
respondan	respond'a'n
respondas	respond'as
responde	respond'e
respondi	respond'i
respondis	respond'is
respondo	respond'o
respondoj	respond'o'j
respondojn	respond'o'j'n
respondon	respond'o'n
respondos	respond'os
respondu	respond'u
respondus	respond'us
respondadis	respond'ad'is
respondado	respond'ad'o
respondadotempo	respond'ad'o'temp'o
respondadotempoj	respond'ad'o'temp'o'j
respondanta	respond'ant'a
respondantaj	respond'ant'a'j
respondante	respond'ant'e
respondanto	respond'ant'o
respondantoj	respond'ant'o'j
respondebla	respond'ebl'a
respondeblas	respond'ebl'as
respondeca	respond'ec'a
respondecaj	respond'ec'a'j
respondecajn	respond'ec'a'j'n
respondecan	respond'ec'a'n
respondecas	respond'ec'as
respondece	respond'ec'e
respondeci	respond'ec'i
respondecis	respond'ec'is
respondeco	respond'ec'o
respondecoj	respond'ec'o'j
respondecojn	respond'ec'o'j'n
respondecon	respond'ec'o'n
respondecos	respond'ec'os
respondecu	respond'ec'u
respondecus	respond'ec'us
respondecado	respond'ec'ad'o
respondecanta	respond'ec'ant'a
respondecante	respond'ec'ant'e
respondecigas	respond'ec'ig'as
respondecigi	respond'ec'ig'i
respondecigis	respond'ec'ig'is
respondecigita	respond'ec'ig'it'a
respondecita	respond'ec'it'a
respondecitaj	respond'ec'it'a'j
respondeculo	respond'ec'ul'o
respondeculoj	respond'ec'ul'o'j
respondeculojn	respond'ec'ul'o'j'n
respondeculon	respond'ec'ul'o'n
respondeculino	respond'ec'ul'in'o
respondema	respond'em'a
respondemaj	respond'em'a'j
respondemeco	respond'em'ec'o
respondigebleco	respond'ig'ebl'ec'o
respondigeblecon	respond'ig'ebl'ec'o'n
respondinta	respond'int'a
respondinte	respond'int'e
respondintoj	respond'int'o'j
respondita	respond'it'a
responditaj	respond'it'a'j
respondkuponoj	respond'kupon'o'j
respondvorto	respond'vort'o
responsa	respons'a
responsaj	respons'a'j
responsas	respons'as
response	respons'e
responsi	respons'i
responsis	respons'is
responso	respons'o
responson	respons'o'n
responsulo	respons'ul'o
responsuloj	respons'ul'o'j
respublika	respublik'a
respublikaj	respublik'a'j
respublikan	respublik'a'n
respubliko	respublik'o
respublikoj	respublik'o'j
respublikojn	respublik'o'j'n
respublikon	respublik'o'n
respublikana	respublik'an'a
respublikanaj	respublik'an'a'j
respublikanajn	respublik'an'a'j'n
respublikanan	respublik'an'a'n
respublikano	respublik'an'o
respublikanoj	respublik'an'o'j
respublikanojn	respublik'an'o'j'n
respublikanismo	respublik'an'ism'o
respublikisto	respublik'ist'o
respublikistoj	respublik'ist'o'j
resta	rest'a
restaj	rest'a'j
restajn	rest'a'j'n
restan	rest'a'n
restas	rest'as
resti	rest'i
restis	rest'is
resto	rest'o
restoj	rest'o'j
restojn	rest'o'j'n
reston	rest'o'n
restos	rest'os
restu	rest'u
restus	rest'us
restadas	rest'ad'as
restadi	rest'ad'i
restadis	rest'ad'is
restado	rest'ad'o
restadoj	rest'ad'o'j
restadojn	rest'ad'o'j'n
restadon	rest'ad'o'n
restados	rest'ad'os
restadu	rest'ad'u
restadejo	rest'ad'ej'o
restadejoj	rest'ad'ej'o'j
restadejon	rest'ad'ej'o'n
restajho	rest'aĵ'o
restaĵo	rest'aĵ'o
restaĵoj	rest'aĵ'o'j
restaĵojn	rest'aĵ'o'j'n
restaĵon	rest'aĵ'o'n
restanta	rest'ant'a
restantaj	rest'ant'a'j
restantajn	rest'ant'a'j'n
restantan	rest'ant'a'n
restante	rest'ant'e
restejo	rest'ej'o
restejon	rest'ej'o'n
restigas	rest'ig'as
restigi	rest'ig'i
restigis	rest'ig'is
restigos	rest'ig'os
restigu	rest'ig'u
restinta	rest'int'a
restintaj	rest'int'a'j
restintajn	rest'int'a'j'n
restintan	rest'int'a'n
restinte	rest'int'e
restintoj	rest'int'o'j
restintus	rest'int'us
restita	rest'it'a
restaŭri	restaŭr'i
restaŭris	restaŭr'is
restaŭro	restaŭr'o
restaŭrado	restaŭr'ad'o
restaŭradon	restaŭr'ad'o'n
restaŭristo	restaŭr'ist'o
restaŭrita	restaŭr'it'a
restaŭritaj	restaŭr'it'a'j
restitui	restitu'i
restituo	restitu'o
restoracia	restoraci'a
restoracio	restoraci'o
restoracioj	restoraci'o'j
restoraciojn	restoraci'o'j'n
restoracion	restoraci'o'n
restoraciestro	restoraci'estr'o
restoracieto	restoraci'et'o
restoraciisto	restoraci'ist'o
restrikta	restrikt'a
restriktaj	restrikt'a'j
restriktajn	restrikt'a'j'n
restriktan	restrikt'a'n
restriktas	restrikt'as
restrikti	restrikt'i
restrikto	restrikt'o
restriktoj	restrikt'o'j
restriktojn	restrikt'o'j'n
restrikton	restrikt'o'n
restriktita	restrikt'it'a
resuma	resum'a
resumaj	resum'a'j
resuman	resum'a'n
resumas	resum'as
resume	resum'e
resumi	resum'i
resumis	resum'is
resumo	resum'o
resumoj	resum'o'j
resumojn	resum'o'j'n
resumon	resum'o'n
resumos	resum'os
resumu	resum'u
resumante	resum'ant'e
resumigo	resum'ig'o
resumiĝas	resum'iĝ'as
resumita	resum'it'a
resumitaj	resum'it'a'j
resurekti	resurekt'i
resurektinta	resurekt'int'a
resurektinto	resurekt'int'o
reta	ret'a
retaj	ret'a'j
retajn	ret'a'j'n
retan	ret'a'n
rete	ret'e
reto	ret'o
retoj	ret'o'j
retojn	ret'o'j'n
reton	ret'o'n
retadreso	ret'adres'o
retadresoj	ret'adres'o'j
retadresojn	ret'adres'o'j'n
retadreson	ret'adres'o'n
retagentejo	ret'agent'ej'o
retaĵo	ret'aĵ'o
retaliro	ret'al'ir'o
retaliron	ret'al'ir'o'n
retano	ret'an'o
retanoj	ret'an'o'j
retaro	ret'ar'o
retbabilo	ret'babil'o
retbabilejoj	ret'babil'ej'o'j
retbazita	ret'baz'it'a
retbazitaj	ret'baz'it'a'j
retbutiko	ret'butik'o
reteja	ret'ej'a
retejaj	ret'ej'a'j
retejo	ret'ej'o
retejoj	ret'ej'o'j
retejojn	ret'ej'o'j'n
retejon	ret'ej'o'n
retestro	ret'estr'o
retfiŝkaptado	ret'fiŝ'kapt'ad'o
retforumo	ret'forum'o
retforumoj	ret'forum'o'j
retforumon	ret'forum'o'n
retgazeto	ret'gazet'o
retgazetoj	ret'gazet'o'j
retigado	ret'ig'ad'o
retigadon	ret'ig'ad'o'n
retkamerao	ret'kamera'o
retkonekto	ret'konekt'o
retkonektoj	ret'konekt'o'j
retlegantoj	ret'leg'ant'o'j
retletero	ret'leter'o
retleteroj	ret'leter'o'j
retleteron	ret'leter'o'n
retlibroj	ret'libr'o'j
retligo	ret'lig'o
retligoj	ret'lig'o'j
retlisto	ret'list'o
retlistoj	ret'list'o'j
retloko	ret'lok'o
retmajstroj	ret'majstr'o'j
retmesaĝo	ret'mesaĝ'o
retmesaĝoj	ret'mesaĝ'o'j
retmesaĝojn	ret'mesaĝ'o'j'n
retmesaĝon	ret'mesaĝ'o'n
retnodoj	ret'nod'o'j
retolisto	ret'o'list'o
retoprogramo	ret'o'program'o
retoprogramoj	ret'o'program'o'j
retpagho	ret'paĝ'o
retpaĝo	ret'paĝ'o
retpaĝoj	ret'paĝ'o'j
retpaĝojn	ret'paĝ'o'j'n
retpaĝon	ret'paĝ'o'n
retpagharo	ret'paĝ'ar'o
retpaĝaro	ret'paĝ'ar'o
retpaĝaroj	ret'paĝ'ar'o'j
retpaĝaron	ret'paĝ'ar'o'n
retpirato	ret'pirat'o
retpiratoj	ret'pirat'o'j
retpoŝta	ret'poŝt'a
retpoŝtaj	ret'poŝt'a'j
retpoŝtajn	ret'poŝt'a'j'n
retpoŝtan	ret'poŝt'a'n
retpoŝte	ret'poŝt'e
retpoŝto	ret'poŝt'o
retpoŝtoj	ret'poŝt'o'j
retpoŝtojn	ret'poŝt'o'j'n
retpoŝton	ret'poŝt'o'n
retpoŝtadreso	ret'poŝt'adres'o
retpoŝtadreson	ret'poŝt'adres'o'n
retpoŝtaĵo	ret'poŝt'aĵ'o
retpoŝtaĵoj	ret'poŝt'aĵ'o'j
retpoŝtaĵon	ret'poŝt'aĵ'o'n
retpunkto	ret'punkt'o
retpunktoj	ret'punkt'o'j
retradio	ret'radi'o
retradion	ret'radi'o'n
retsendado	ret'send'ad'o
retservo	ret'serv'o
retservoj	ret'serv'o'j
retservojn	ret'serv'o'j'n
retservilo	ret'serv'il'o
retserviloj	ret'serv'il'o'j
retstacioj	ret'staci'o'j
retujo	ret'uj'o
retujoj	ret'uj'o'j
retujon	ret'uj'o'n
retuloj	ret'ul'o'j
retumas	ret'um'as
retumi	ret'um'i
retumado	ret'um'ad'o
retumadon	ret'um'ad'o'n
retumantoj	ret'um'ant'o'j
retumilo	ret'um'il'o
retumiloj	ret'um'il'o'j
retumilon	ret'um'il'o'n
retuzantoj	ret'uz'ant'o'j
retablo	retabl'o
retabloj	retabl'o'j
retikulo	retikul'o
retina	retin'a
retinaj	retin'a'j
retino	retin'o
retinon	retin'o'n
retoro	retor'o
retorika	retor'ik'a
retorikaj	retor'ik'a'j
retorikajn	retor'ik'a'j'n
retorikan	retor'ik'a'n
retorike	retor'ik'e
retoriko	retor'ik'o
retorikon	retor'ik'o'n
retreti	retret'i
retreto	retret'o
retro	retro
retroaktive	retro'aktiv'e
retrofleksa	retro'fleks'a
retrofleksaj	retro'fleks'a'j
retroira	retro'ir'a
retroiran	retro'ir'a'n
retroiri	retro'ir'i
retroiris	retro'ir'is
retroiro	retro'ir'o
retropaŝas	retro'paŝ'as
retropaŝi	retro'paŝ'i
retropaŝis	retro'paŝ'is
retrorigardi	retro'rigard'i
retrorigardis	retro'rigard'is
retrorigardo	retro'rigard'o
retrorigardante	retro'rigard'ant'e
retrospegulo	retro'spegul'o
retrospektiva	retrospektiv'a
retrospektive	retrospektiv'e
retrospektivo	retrospektiv'o
retuŝado	retuŝ'ad'o
reunio	reuni'o
reunion	reuni'o'n
reŭmatismo	reŭmat'ism'o
reva	rev'a
revas	rev'as
reve	rev'e
revi	rev'i
revis	rev'is
revo	rev'o
revoj	rev'o'j
revojn	rev'o'j'n
revon	rev'o'n
revu	rev'u
revadis	rev'ad'is
revado	rev'ad'o
revanta	rev'ant'a
revantaj	rev'ant'a'j
revante	rev'ant'e
revanto	rev'ant'o
revema	rev'em'a
revemaj	rev'em'a'j
reveme	rev'em'e
revpensado	rev'pens'ad'o
revulo	rev'ul'o
revuloj	rev'ul'o'j
revelaciaj	revelaci'a'j
revelacias	revelaci'as
revelaciis	revelaci'is
revelacio	revelaci'o
revelacioj	revelaci'o'j
revelaciojn	revelaci'o'j'n
revelacion	revelaci'o'n
revelaciita	revelaci'it'a
revelaciitaj	revelaci'it'a'j
reversa	revers'a
reverse	revers'e
reverso	revers'o
reversoj	revers'o'j
reverson	revers'o'n
revizia	revizi'a
revizias	revizi'as
revizii	revizi'i
reviziis	revizi'is
revizio	revizi'o
revizioj	revizi'o'j
reviziojn	revizi'o'j'n
revizion	revizi'o'n
revizios	revizi'os
reviziu	revizi'u
reviziado	revizi'ad'o
reviziadon	revizi'ad'o'n
revizianta	revizi'ant'a
reviziante	revizi'ant'e
revizianto	revizi'ant'o
reviziantoj	revizi'ant'o'j
reviziata	revizi'at'a
reviziisma	revizi'ism'a
reviziismaj	revizi'ism'a'j
reviziismo	revizi'ism'o
reviziita	revizi'it'a
reviziitaj	revizi'it'a'j
reviziitajn	revizi'it'a'j'n
reviziitan	revizi'it'a'n
revizora	revizor'a
revizoro	revizor'o
revizoroj	revizor'o'j
revolucia	revoluci'a
revoluciaj	revoluci'a'j
revoluciajn	revoluci'a'j'n
revolucian	revoluci'a'n
revolucie	revoluci'e
revolucii	revoluci'i
revoluciis	revoluci'is
revolucio	revoluci'o
revolucioj	revoluci'o'j
revoluciojn	revoluci'o'j'n
revolucion	revoluci'o'n
revoluciema	revoluci'em'a
revoluciemaj	revoluci'em'a'j
revolucieman	revoluci'em'a'n
revoluciigi	revoluci'ig'i
revoluciigis	revoluci'ig'is
revoluciulo	revoluci'ul'o
revoluciuloj	revoluci'ul'o'j
revoluciulojn	revoluci'ul'o'j'n
revolvero	revolver'o
revolveroj	revolver'o'j
revolverojn	revolver'o'j'n
revolveron	revolver'o'n
revua	revu'a
revuaj	revu'a'j
revuo	revu'o
revuoj	revu'o'j
revuojn	revu'o'j'n
revuon	revu'o'n
revueto	revu'et'o
revueton	revu'et'o'n
rezende	rezende
rezerva	rezerv'a
rezervaj	rezerv'a'j
rezervajn	rezerv'a'j'n
rezervan	rezerv'a'n
rezervas	rezerv'as
rezervi	rezerv'i
rezervis	rezerv'is
rezervo	rezerv'o
rezervoj	rezerv'o'j
rezervojn	rezerv'o'j'n
rezervon	rezerv'o'n
rezervos	rezerv'os
rezervu	rezerv'u
rezervado	rezerv'ad'o
rezervadoj	rezerv'ad'o'j
rezervadojn	rezerv'ad'o'j'n
rezervadon	rezerv'ad'o'n
rezervante	rezerv'ant'e
rezervata	rezerv'at'a
rezervataj	rezerv'at'a'j
rezervejo	rezerv'ej'o
rezervejoj	rezerv'ej'o'j
rezervejojn	rezerv'ej'o'j'n
rezervejon	rezerv'ej'o'n
rezervistoj	rezerv'ist'o'j
rezervita	rezerv'it'a
rezervitaj	rezerv'it'a'j
rezervitajn	rezerv'it'a'j'n
rezervitan	rezerv'it'a'n
rezervite	rezerv'it'e
rezervitaĵo	rezerv'it'aĵ'o
rezervokvanto	rezerv'o'kvant'o
rezervujo	rezerv'uj'o
rezervujoj	rezerv'uj'o'j
rezervujojn	rezerv'uj'o'j'n
rezervujon	rezerv'uj'o'n
rezidas	rezid'as
rezidis	rezid'is
rezidantoj	rezid'ant'o'j
rezideja	rezid'ej'a
rezidejo	rezid'ej'o
rezidejoj	rezid'ej'o'j
rezidejon	rezid'ej'o'n
reziduaj	rezidu'a'j
rezigna	rezign'a
rezignas	rezign'as
rezigne	rezign'e
rezigni	rezign'i
rezignis	rezign'is
rezigno	rezign'o
rezignon	rezign'o'n
rezignos	rezign'os
rezignu	rezign'u
rezignus	rezign'us
rezignado	rezign'ad'o
rezignadon	rezign'ad'o'n
rezignante	rezign'ant'e
rezigninte	rezign'int'e
rezignita	rezign'it'a
rezignitaj	rezign'it'a'j
rezignacia	rezignaci'a
rezignacie	rezignaci'e
rezignacii	rezignaci'i
rezignaciis	rezignaci'is
rezignacio	rezignaci'o
rezina	rezin'a
rezino	rezin'o
rezinoj	rezin'o'j
rezinon	rezin'o'n
rezista	rezist'a
rezistaj	rezist'a'j
rezistan	rezist'a'n
rezistas	rezist'as
rezisti	rezist'i
rezistis	rezist'is
rezisto	rezist'o
rezistoj	rezist'o'j
rezistojn	rezist'o'j'n
reziston	rezist'o'n
rezistos	rezist'os
rezistu	rezist'u
rezistus	rezist'us
rezistado	rezist'ad'o
rezistadon	rezist'ad'o'n
rezistanco	rezist'anc'o
rezistancon	rezist'anc'o'n
rezistanta	rezist'ant'a
rezistantaj	rezist'ant'a'j
rezistante	rezist'ant'e
rezistantoj	rezist'ant'o'j
rezisteco	rezist'ec'o
rezistecon	rezist'ec'o'n
rezistema	rezist'em'a
rezistemaj	rezist'em'a'j
rezistemajn	rezist'em'a'j'n
rezisteman	rezist'em'a'n
rezistemo	rezist'em'o
rezistilo	rezist'il'o
rezistiloj	rezist'il'o'j
rezistilojn	rezist'il'o'j'n
rezistita	rezist'it'a
rezistitaj	rezist'it'a'j
rezistkapablo	rezist'kapabl'o
rezistmilito	rezist'milit'o
rezistmovado	rezist'mov'ad'o
rezistomovado	rezist'o'mov'ad'o
rezolucia	rezoluci'a
rezoluciaj	rezoluci'a'j
rezoluciis	rezoluci'is
rezolucio	rezoluci'o
rezolucioj	rezoluci'o'j
rezoluciojn	rezoluci'o'j'n
rezolucion	rezoluci'o'n
rezoluta	rezolut'a
rezolute	rezolut'e
rezonas	rezon'as
rezoni	rezon'i
rezonis	rezon'is
rezono	rezon'o
rezonoj	rezon'o'j
rezonojn	rezon'o'j'n
rezonon	rezon'o'n
rezonadi	rezon'ad'i
rezonadis	rezon'ad'is
rezonado	rezon'ad'o
rezonadoj	rezon'ad'o'j
rezonadon	rezon'ad'o'n
rezonante	rezon'ant'e
rezulta	rezult'a
rezultaj	rezult'a'j
rezultajn	rezult'a'j'n
rezultan	rezult'a'n
rezultas	rezult'as
rezulte	rezult'e
rezulti	rezult'i
rezultis	rezult'is
rezulto	rezult'o
rezultoj	rezult'o'j
rezultojn	rezult'o'j'n
rezulton	rezult'o'n
rezultos	rezult'os
rezultus	rezult'us
rezultado	rezult'ad'o
rezultanta	rezult'ant'a
rezultantaj	rezult'ant'a'j
rezultantan	rezult'ant'a'n
rezultante	rezult'ant'e
rezultanto	rezult'ant'o
rezultigas	rezult'ig'as
rezultigi	rezult'ig'i
rezultigis	rezult'ig'is
rezultigos	rezult'ig'os
rezultigus	rezult'ig'us
rezultiganta	rezult'ig'ant'a
rezultigantaj	rezult'ig'ant'a'j
rezultigantajn	rezult'ig'ant'a'j'n
rezultigantan	rezult'ig'ant'a'n
rezultigante	rezult'ig'ant'e
rezultigintus	rezult'ig'int'us
rezultigita	rezult'ig'it'a
rezultigitaj	rezult'ig'it'a'j
rezultiĝas	rezult'iĝ'as
rezultiĝi	rezult'iĝ'i
rezultiĝis	rezult'iĝ'is
rezultiĝos	rezult'iĝ'os
rezultiĝus	rezult'iĝ'us
rezultiĝanta	rezult'iĝ'ant'a
rezultiĝantaj	rezult'iĝ'ant'a'j
rezultiĝantajn	rezult'iĝ'ant'a'j'n
rezultiĝantan	rezult'iĝ'ant'a'n
rezultiĝante	rezult'iĝ'ant'e
rezultinta	rezult'int'a
rezultintaj	rezult'int'a'j
rezultintan	rezult'int'a'n
rezultita	rezult'it'a
rezultato	rezultat'o
rezultatoj	rezultat'o'j
rezultatojn	rezultat'o'j'n
rezultaton	rezultat'o'n
riba	rib'a
ribo	rib'o
riboj	rib'o'j
ribosomo	rib'o'som'o
ribosomoj	rib'o'som'o'j
ribeiro	ribeir'o
ribela	ribel'a
ribelaj	ribel'a'j
ribelajn	ribel'a'j'n
ribelas	ribel'as
ribeli	ribel'i
ribelis	ribel'is
ribelo	ribel'o
ribeloj	ribel'o'j
ribelojn	ribel'o'j'n
ribelon	ribel'o'n
ribelus	ribel'us
ribelado	ribel'ad'o
ribelanta	ribel'ant'a
ribelantaj	ribel'ant'a'j
ribelanto	ribel'ant'o
ribelantoj	ribel'ant'o'j
ribelantojn	ribel'ant'o'j'n
ribelarmeoj	ribel'arme'o'j
ribelema	ribel'em'a
ribelemaj	ribel'em'a'j
ribelemajn	ribel'em'a'j'n
ribeleman	ribel'em'a'n
ribelemo	ribel'em'o
ribelemon	ribel'em'o'n
ribeligi	ribel'ig'i
ribeliĝis	ribel'iĝ'is
ribelintoj	ribel'int'o'j
ribelula	ribel'ul'a
ribelulo	ribel'ul'o
ribeluloj	ribel'ul'o'j
ribelulojn	ribel'ul'o'j'n
riceva	ricev'a
ricevas	ricev'as
ricevi	ricev'i
ricevis	ricev'is
ricevo	ricev'o
ricevoj	ricev'o'j
ricevon	ricev'o'n
ricevos	ricev'os
ricevu	ricev'u
ricevus	ricev'us
ricevadas	ricev'ad'as
ricevadi	ricev'ad'i
ricevadis	ricev'ad'is
ricevado	ricev'ad'o
ricevadon	ricev'ad'o'n
ricevaĵo	ricev'aĵ'o
ricevaĵoj	ricev'aĵ'o'j
ricevaĵojn	ricev'aĵ'o'j'n
ricevanta	ricev'ant'a
ricevantaj	ricev'ant'a'j
ricevante	ricev'ant'e
ricevanto	ricev'ant'o
ricevantoj	ricev'ant'o'j
ricevantojn	ricev'ant'o'j'n
ricevanton	ricev'ant'o'n
ricevata	ricev'at'a
ricevataj	ricev'at'a'j
ricevebla	ricev'ebl'a
riceveblas	ricev'ebl'as
ricevebloj	ricev'ebl'o'j
ricevilo	ricev'il'o
riceviloj	ricev'il'o'j
ricevilojn	ricev'il'o'j'n
ricevilon	ricev'il'o'n
ricevinta	ricev'int'a
ricevintaj	ricev'int'a'j
ricevinte	ricev'int'e
ricevinto	ricev'int'o
ricevintoj	ricev'int'o'j
ricevisto	ricev'ist'o
ricevita	ricev'it'a
ricevitaj	ricev'it'a'j
ricevitajn	ricev'it'a'j'n
ricevitan	ricev'it'a'n
ricevite	ricev'it'e
ricevonta	ricev'ont'a
ricevonto	ricev'ont'o
ricevota	ricev'ot'a
ricino	ricin'o
ricinoleo	ricin'ole'o
riĉa	riĉ'a
riĉaj	riĉ'a'j
riĉajn	riĉ'a'j'n
riĉan	riĉ'a'n
riĉas	riĉ'as
riĉe	riĉ'e
riĉi	riĉ'i
riĉis	riĉ'is
riĉo	riĉ'o
riĉoj	riĉ'o'j
riĉon	riĉ'o'n
riĉaĵo	riĉ'aĵ'o
riĉaĵoj	riĉ'aĵ'o'j
riĉaĵojn	riĉ'aĵ'o'j'n
riĉaĵon	riĉ'aĵ'o'n
riĉeco	riĉ'ec'o
riĉecoj	riĉ'ec'o'j
riĉecon	riĉ'ec'o'n
riĉega	riĉ'eg'a
riĉegaj	riĉ'eg'a'j
riĉegan	riĉ'eg'a'n
riĉeguloj	riĉ'eg'ul'o'j
riĉenhava	riĉ'en'hav'a
riĉetaj	riĉ'et'a'j
riĉfonta	riĉ'font'a
riĉfonto	riĉ'font'o
riĉfontoj	riĉ'font'o'j
riĉfontojn	riĉ'font'o'j'n
riĉfonton	riĉ'font'o'n
riĉiga	riĉ'ig'a
riĉigas	riĉ'ig'as
riĉigi	riĉ'ig'i
riĉigis	riĉ'ig'is
riĉigo	riĉ'ig'o
riĉigon	riĉ'ig'o'n
riĉigos	riĉ'ig'os
riĉigado	riĉ'ig'ad'o
riĉigante	riĉ'ig'ant'e
riĉigita	riĉ'ig'it'a
riĉigitaj	riĉ'ig'it'a'j
riĉigitan	riĉ'ig'it'a'n
riĉiĝas	riĉ'iĝ'as
riĉiĝi	riĉ'iĝ'i
riĉiĝis	riĉ'iĝ'is
riĉiĝo	riĉ'iĝ'o
riĉiĝon	riĉ'iĝ'o'n
riĉiĝos	riĉ'iĝ'os
riĉulo	riĉ'ul'o
riĉuloj	riĉ'ul'o'j
riĉulojn	riĉ'ul'o'j'n
riĉulon	riĉ'ul'o'n
riĉularo	riĉ'ul'ar'o
riĉulino	riĉ'ul'in'o
rida	rid'a
ridas	rid'as
ride	rid'e
ridi	rid'i
ridis	rid'is
rido	rid'o
ridoj	rid'o'j
ridojn	rid'o'j'n
ridon	rid'o'n
ridos	rid'os
ridu	rid'u
ridus	rid'us
ridaĉis	rid'aĉ'is
ridadis	rid'ad'is
ridado	rid'ad'o
ridadon	rid'ad'o'n
ridanta	rid'ant'a
ridantaj	rid'ant'a'j
ridantan	rid'ant'a'n
ridante	rid'ant'e
ridegas	rid'eg'as
ridegi	rid'eg'i
ridegis	rid'eg'is
ridego	rid'eg'o
ridegon	rid'eg'o'n
ridegante	rid'eg'ant'e
ridema	rid'em'a
ridemaj	rid'em'a'j
ridemon	rid'em'o'n
ridetas	rid'et'as
ridete	rid'et'e
rideti	rid'et'i
ridetis	rid'et'is
rideto	rid'et'o
ridetoj	rid'et'o'j
ridetojn	rid'et'o'j'n
rideton	rid'et'o'n
ridetos	rid'et'os
ridetu	rid'et'u
ridetadis	rid'et'ad'is
ridetado	rid'et'ad'o
ridetanta	rid'et'ant'a
ridetantaj	rid'et'ant'a'j
ridetantan	rid'et'ant'a'n
ridetante	rid'et'ant'e
ridetigas	rid'et'ig'as
ridgaso	rid'gas'o
ridiga	rid'ig'a
ridigaj	rid'ig'a'j
ridigan	rid'ig'a'n
ridigas	rid'ig'as
ridige	rid'ig'e
ridigi	rid'ig'i
ridigis	rid'ig'is
ridinda	rid'ind'a
ridindaj	rid'ind'a'j
ridindajn	rid'ind'a'j'n
ridindan	rid'ind'a'n
ridindas	rid'ind'as
ridinde	rid'ind'e
ridindaĵo	rid'ind'aĵ'o
ridindeco	rid'ind'ec'o
ridindigas	rid'ind'ig'as
ridindigi	rid'ind'ig'i
ridindigis	rid'ind'ig'is
ridindigo	rid'ind'ig'o
ridindigon	rid'ind'ig'o'n
ridindigu	rid'ind'ig'u
ridindigita	rid'ind'ig'it'a
rifo	rif'o
rifoj	rif'o'j
rifojn	rif'o'j'n
rifon	rif'o'n
rifuĝas	rifuĝ'as
rifuĝi	rifuĝ'i
rifuĝis	rifuĝ'is
rifuĝo	rifuĝ'o
rifuĝoj	rifuĝ'o'j
rifuĝon	rifuĝ'o'n
rifuĝado	rifuĝ'ad'o
rifuĝantoj	rifuĝ'ant'o'j
rifuĝejo	rifuĝ'ej'o
rifuĝejoj	rifuĝ'ej'o'j
rifuĝejojn	rifuĝ'ej'o'j'n
rifuĝejon	rifuĝ'ej'o'n
rifuĝiĝis	rifuĝ'iĝ'is
rifuĝinta	rifuĝ'int'a
rifuĝintaj	rifuĝ'int'a'j
rifuĝinto	rifuĝ'int'o
rifuĝintoj	rifuĝ'int'o'j
rifuĝintojn	rifuĝ'int'o'j'n
rifuzas	rifuz'as
rifuze	rifuz'e
rifuzi	rifuz'i
rifuzis	rifuz'is
rifuzo	rifuz'o
rifuzoj	rifuz'o'j
rifuzon	rifuz'o'n
rifuzos	rifuz'os
rifuzu	rifuz'u
rifuzus	rifuz'us
rifuzadis	rifuz'ad'is
rifuzado	rifuz'ad'o
rifuzanta	rifuz'ant'a
rifuzantaj	rifuz'ant'a'j
rifuzante	rifuz'ant'e
rifuzata	rifuz'at'a
rifuzataj	rifuz'at'a'j
rifuzinta	rifuz'int'a
rifuzinte	rifuz'int'e
rifuzita	rifuz'it'a
rifuzitaj	rifuz'it'a'j
rigarda	rigard'a
rigardaj	rigard'a'j
rigardajn	rigard'a'j'n
rigardan	rigard'a'n
rigardas	rigard'as
rigarde	rigard'e
rigardi	rigard'i
rigardis	rigard'is
rigardo	rigard'o
rigardoj	rigard'o'j
rigardojn	rigard'o'j'n
rigardon	rigard'o'n
rigardos	rigard'os
rigardu	rigard'u
rigardus	rigard'us
rigardadas	rigard'ad'as
rigardadi	rigard'ad'i
rigardadis	rigard'ad'is
rigardado	rigard'ad'o
rigardadon	rigard'ad'o'n
rigardanta	rigard'ant'a
rigardantaj	rigard'ant'a'j
rigardantajn	rigard'ant'a'j'n
rigardantan	rigard'ant'a'n
rigardante	rigard'ant'e
rigardanto	rigard'ant'o
rigardantoj	rigard'ant'o'j
rigardantojn	rigard'ant'o'j'n
rigardata	rigard'at'a
rigardataj	rigard'at'a'j
rigardate	rigard'at'e
rigardebla	rigard'ebl'a
rigardeblaj	rigard'ebl'a'j
rigardeblas	rigard'ebl'as
rigardegas	rigard'eg'as
rigardegis	rigard'eg'is
rigardejo	rigard'ej'o
rigardetis	rigard'et'is
rigardeto	rigard'et'o
rigardeton	rigard'et'o'n
rigardinta	rigard'int'a
rigardinte	rigard'int'e
rigardita	rigard'it'a
rigarditaj	rigard'it'a'j
rigarditan	rigard'it'a'n
rigardite	rigard'it'e
rigida	rigid'a
rigidaj	rigid'a'j
rigidajn	rigid'a'j'n
rigidan	rigid'a'n
rigidas	rigid'as
rigide	rigid'e
rigideco	rigid'ec'o
rigidecon	rigid'ec'o'n
rigidigis	rigid'ig'is
rigidiĝas	rigid'iĝ'as
rigidiĝis	rigid'iĝ'is
rigidiĝo	rigid'iĝ'o
rigidiĝinta	rigid'iĝ'int'a
rigidiĝintaj	rigid'iĝ'int'a'j
riglis	rigl'is
riglilo	rigl'il'o
rigliloj	rigl'il'o'j
riglilojn	rigl'il'o'j'n
riglilon	rigl'il'o'n
riglita	rigl'it'a
rigora	rigor'a
rigoraj	rigor'a'j
rigorajn	rigor'a'j'n
rigoran	rigor'a'n
rigore	rigor'e
rigoro	rigor'o
rigoron	rigor'o'n
rigoreco	rigor'ec'o
rikanas	rikan'as
rikane	rikan'e
rikanis	rikan'is
rikano	rikan'o
rikardo	rikard'o
rikardon	rikard'o'n
rikiŝoj	rikiŝ'o'j
rikolta	rikolt'a
rikoltaj	rikolt'a'j
rikoltas	rikolt'as
rikolti	rikolt'i
rikoltis	rikolt'is
rikolto	rikolt'o
rikoltoj	rikolt'o'j
rikoltojn	rikolt'o'j'n
rikolton	rikolt'o'n
rikoltos	rikolt'os
rikoltu	rikolt'u
rikoltado	rikolt'ad'o
rikoltanta	rikolt'ant'a
rikoltante	rikolt'ant'e
rikoltata	rikolt'at'a
rikoltataj	rikolt'at'a'j
rikoltfesto	rikolt'fest'o
rikoltilo	rikolt'il'o
rikoltistoj	rikolt'ist'o'j
rikoltita	rikolt'it'a
rikoltitaj	rikolt'it'a'j
rikoltlaboro	rikolt'labor'o
rikolttempo	rikolt'temp'o
rikordo	rikord'o
rikordoj	rikord'o'j
rilakso	rilaks'o
rilakson	rilaks'o'n
rilaksita	rilaks'it'a
rilaksitaj	rilaks'it'a'j
rilata	rilat'a
rilataj	rilat'a'j
rilatajn	rilat'a'j'n
rilatan	rilat'a'n
rilatas	rilat'as
rilate	rilat'e
rilati	rilat'i
rilatis	rilat'is
rilato	rilat'o
rilatoj	rilat'o'j
rilatojn	rilat'o'j'n
rilaton	rilat'o'n
rilatos	rilat'os
rilatu	rilat'u
rilatus	rilat'us
rilatado	rilat'ad'o
rilatadon	rilat'ad'o'n
rilatanta	rilat'ant'a
rilatantaj	rilat'ant'a'j
rilatantajn	rilat'ant'a'j'n
rilatantan	rilat'ant'a'n
rilatante	rilat'ant'e
rilataro	rilat'ar'o
rilateco	rilat'ec'o
rilatigas	rilat'ig'as
rilatigi	rilat'ig'i
rilatigis	rilat'ig'is
rilatigo	rilat'ig'o
rilatigado	rilat'ig'ad'o
rilatiganta	rilat'ig'ant'a
rilatigantaj	rilat'ig'ant'a'j
rilatigantajn	rilat'ig'ant'a'j'n
rilatigantan	rilat'ig'ant'a'n
rilatigante	rilat'ig'ant'e
rilatigita	rilat'ig'it'a
rilatigitaj	rilat'ig'it'a'j
rilatiĝas	rilat'iĝ'as
rilatiĝi	rilat'iĝ'i
rilatita	rilat'it'a
rilatitaj	rilat'it'a'j
rilatite	rilat'it'e
rilatumo	rilat'um'o
rilatumoj	rilat'um'o'j
rilatumojn	rilat'um'o'j'n
rilatumon	rilat'um'o'n
rilativa	rilativ'a
rilative	rilativ'e
rilativo	rilativ'o
rima	rim'a
rimas	rim'as
rime	rim'e
rimo	rim'o
rimoj	rim'o'j
rimojn	rim'o'j'n
rimon	rim'o'n
rimado	rim'ad'o
rimaĵoj	rim'aĵ'o'j
rimiĝas	rim'iĝ'as
rimitaj	rim'it'a'j
rimskemo	rim'skem'o
rimana	riman'a
rimarkas	rimark'as
rimarki	rimark'i
rimarkis	rimark'is
rimarko	rimark'o
rimarkoj	rimark'o'j
rimarkojn	rimark'o'j'n
rimarkon	rimark'o'n
rimarkos	rimark'os
rimarku	rimark'u
rimarkus	rimark'us
rimarkadis	rimark'ad'is
rimarkado	rimark'ad'o
rimarkante	rimark'ant'e
rimarkata	rimark'at'a
rimarkataj	rimark'at'a'j
rimarkebla	rimark'ebl'a
rimarkeblaj	rimark'ebl'a'j
rimarkeblajn	rimark'ebl'a'j'n
rimarkeblan	rimark'ebl'a'n
rimarkeblas	rimark'ebl'as
rimarkeble	rimark'ebl'e
rimarkeblis	rimark'ebl'is
rimarkigas	rimark'ig'as
rimarkigi	rimark'ig'i
rimarkigis	rimark'ig'is
rimarkigo	rimark'ig'o
rimarkigoj	rimark'ig'o'j
rimarkiĝas	rimark'iĝ'as
rimarkiĝis	rimark'iĝ'is
rimarkinda	rimark'ind'a
rimarkindaj	rimark'ind'a'j
rimarkindajn	rimark'ind'a'j'n
rimarkindan	rimark'ind'a'n
rimarkindas	rimark'ind'as
rimarkinde	rimark'ind'e
rimarkinta	rimark'int'a
rimarkinte	rimark'int'e
rimarkita	rimark'it'a
rimarkitaj	rimark'it'a'j
rimarkite	rimark'it'e
rimedo	rimed'o
rimedoj	rimed'o'j
rimedojn	rimed'o'j'n
rimedon	rimed'o'n
rimeno	rimen'o
rimenoj	rimen'o'j
rimenojn	rimen'o'j'n
rimenon	rimen'o'n
rimesi	rimes'i
rimeso	rimes'o
rimorson	rimors'o'n
ringa	ring'a
ringaj	ring'a'j
ringan	ring'a'n
ringe	ring'e
ringo	ring'o
ringoj	ring'o'j
ringojn	ring'o'j'n
ringon	ring'o'n
ringeto	ring'et'o
ringforma	ring'form'a
ringmuro	ring'mur'o
ringofingro	ring'o'fingr'o
ringoforma	ring'o'form'a
ringoformaj	ring'o'form'a'j
rinocero	rinocer'o
rinoceroj	rinocer'o'j
rinocerojn	rinocer'o'j'n
rinoceron	rinocer'o'n
ripa	rip'a
ripo	rip'o
ripoj	rip'o'j
ripojn	rip'o'j'n
ripon	rip'o'n
ripara	ripar'a
riparas	ripar'as
ripari	ripar'i
riparis	ripar'is
riparo	ripar'o
riparoj	ripar'o'j
riparojn	ripar'o'j'n
riparon	ripar'o'n
riparos	ripar'os
riparu	ripar'u
riparado	ripar'ad'o
riparadon	ripar'ad'o'n
riparanta	ripar'ant'a
riparante	ripar'ant'e
riparata	ripar'at'a
riparataj	ripar'at'a'j
riparebla	ripar'ebl'a
riparejo	ripar'ej'o
riparenda	ripar'end'a
riparendas	ripar'end'as
riparigi	ripar'ig'i
riparigis	ripar'ig'is
riparisto	ripar'ist'o
riparita	ripar'it'a
riparitaj	ripar'it'a'j
ripeta	ripet'a
ripetaj	ripet'a'j
ripetajn	ripet'a'j'n
ripetan	ripet'a'n
ripetas	ripet'as
ripete	ripet'e
ripeti	ripet'i
ripetis	ripet'is
ripeto	ripet'o
ripetoj	ripet'o'j
ripetojn	ripet'o'j'n
ripeton	ripet'o'n
ripetos	ripet'os
ripetu	ripet'u
ripetus	ripet'us
ripetadas	ripet'ad'as
ripetade	ripet'ad'e
ripetadi	ripet'ad'i
ripetadis	ripet'ad'is
ripetado	ripet'ad'o
ripetadon	ripet'ad'o'n
ripetadu	ripet'ad'u
ripetanta	ripet'ant'a
ripetantaj	ripet'ant'a'j
ripetante	ripet'ant'e
ripetata	ripet'at'a
ripetataj	ripet'at'a'j
ripetebla	ripet'ebl'a
ripeteblaj	ripet'ebl'a'j
ripeteblo	ripet'ebl'o
ripeteca	ripet'ec'a
ripetema	ripet'em'a
ripetemaj	ripet'em'a'j
ripetemajn	ripet'em'a'j'n
ripeteman	ripet'em'a'n
ripeteme	ripet'em'e
ripetfoje	ripet'foj'e
ripetiĝas	ripet'iĝ'as
ripetiĝi	ripet'iĝ'i
ripetiĝis	ripet'iĝ'is
ripetiĝo	ripet'iĝ'o
ripetiĝon	ripet'iĝ'o'n
ripetiĝos	ripet'iĝ'os
ripetiĝadis	ripet'iĝ'ad'is
ripetiĝanta	ripet'iĝ'ant'a
ripetiĝantaj	ripet'iĝ'ant'a'j
ripetiĝantajn	ripet'iĝ'ant'a'j'n
ripetiĝantan	ripet'iĝ'ant'a'n
ripetilo	ripet'il'o
ripetiloj	ripet'il'o'j
ripetita	ripet'it'a
ripetitaj	ripet'it'a'j
ripetitajn	ripet'it'a'j'n
ripetitan	ripet'it'a'n
ripetite	ripet'it'e
ripetota	ripet'ot'a
ripoza	ripoz'a
ripozaj	ripoz'a'j
ripozas	ripoz'as
ripoze	ripoz'e
ripozi	ripoz'i
ripozis	ripoz'is
ripozo	ripoz'o
ripozoj	ripoz'o'j
ripozon	ripoz'o'n
ripozos	ripoz'os
ripozu	ripoz'u
ripozus	ripoz'us
ripozado	ripoz'ad'o
ripozanta	ripoz'ant'a
ripozantaj	ripoz'ant'a'j
ripozante	ripoz'ant'e
ripozejo	ripoz'ej'o
ripozejoj	ripoz'ej'o'j
ripozejojn	ripoz'ej'o'j'n
ripozejon	ripoz'ej'o'n
ripoziga	ripoz'ig'a
ripozigas	ripoz'ig'as
ripozigi	ripoz'ig'i
ripozigis	ripoz'ig'is
ripozinta	ripoz'int'a
ripozinte	ripoz'int'e
ripozloko	ripoz'lok'o
ripoztago	ripoz'tag'o
ripoztagoj	ripoz'tag'o'j
ripoztagon	ripoz'tag'o'n
riproĉa	riproĉ'a
riproĉas	riproĉ'as
riproĉe	riproĉ'e
riproĉi	riproĉ'i
riproĉis	riproĉ'is
riproĉo	riproĉ'o
riproĉoj	riproĉ'o'j
riproĉojn	riproĉ'o'j'n
riproĉon	riproĉ'o'n
riproĉos	riproĉ'os
riproĉu	riproĉ'u
riproĉus	riproĉ'us
riproĉante	riproĉ'ant'e
riproĉata	riproĉ'at'a
riproĉinda	riproĉ'ind'a
riproĉindan	riproĉ'ind'a'n
riproĉita	riproĉ'it'a
riproĉitaj	riproĉ'it'a'j
riska	risk'a
riskaj	risk'a'j
riskajn	risk'a'j'n
riskan	risk'a'n
riskas	risk'as
riske	risk'e
riski	risk'i
riskis	risk'is
risko	risk'o
riskoj	risk'o'j
riskojn	risk'o'j'n
riskon	risk'o'n
riskos	risk'os
risku	risk'u
riskus	risk'us
riskado	risk'ad'o
riskagaĵoj	risk'ag'aĵ'o'j
riskante	risk'ant'e
riskema	risk'em'a
riskemulo	risk'em'ul'o
riskfaktoro	risk'faktor'o
riskfaktoroj	risk'faktor'o'j
riskkapitalo	risk'kapital'o
riskofaktoroj	risk'o'faktor'o'j
riskoplena	risk'o'plen'a
riskopreno	risk'o'pren'o
riskotakso	risk'o'taks'o
risktraktado	risk'trakt'ad'o
risorta	risort'a
risortaj	risort'a'j
risorte	risort'e
risorto	risort'o
risortoj	risort'o'j
risortojn	risort'o'j'n
risorton	risort'o'n
rita	rit'a
ritaj	rit'a'j
ritajn	rit'a'j'n
ritan	rit'a'n
rite	rit'e
rito	rit'o
ritoj	rit'o'j
ritojn	rit'o'j'n
riton	rit'o'n
ritaro	rit'ar'o
ritaroj	rit'ar'o'j
ritaron	rit'ar'o'n
riteca	rit'ec'a
ritigita	rit'ig'it'a
ritma	ritm'a
ritmaj	ritm'a'j
ritmajn	ritm'a'j'n
ritman	ritm'a'n
ritme	ritm'e
ritmo	ritm'o
ritmoj	ritm'o'j
ritmojn	ritm'o'j'n
ritmon	ritm'o'n
ritmosekcio	ritm'o'sekci'o
ritmenbluso	ritmenblus'o
ritualo	ritual'o
ritualoj	ritual'o'j
rivala	rival'a
rivalaj	rival'a'j
rivalajn	rival'a'j'n
rivalan	rival'a'n
rivalas	rival'as
rivali	rival'i
rivalis	rival'is
rivalo	rival'o
rivaloj	rival'o'j
rivalojn	rival'o'j'n
rivalon	rival'o'n
rivalado	rival'ad'o
rivaleco	rival'ec'o
rivalecoj	rival'ec'o'j
rivalecojn	rival'ec'o'j'n
rivalecon	rival'ec'o'n
rivelas	rivel'as
riveli	rivel'i
rivelis	rivel'is
rivelo	rivel'o
riveloj	rivel'o'j
rivelon	rivel'o'n
rivelos	rivel'os
rivelus	rivel'us
rivelado	rivel'ad'o
rivelante	rivel'ant'e
riveliĝas	rivel'iĝ'as
riveliĝis	rivel'iĝ'is
rivelita	rivel'it'a
rivelitaj	rivel'it'a'j
rivelite	rivel'it'e
rivera	river'a
riveraj	river'a'j
riverajn	river'a'j'n
riveran	river'a'n
riveren	river'e'n
rivero	river'o
riveroj	river'o'j
riverojn	river'o'j'n
riveron	river'o'n
riverakvo	river'akv'o
riverborda	river'bord'a
riverbordaj	river'bord'a'j
riverbordo	river'bord'o
riverbordoj	river'bord'o'j
riverbordon	river'bord'o'n
riverbuŝo	river'buŝ'o
riverdelto	river'delt'o
riverdio	river'di'o
riverego	river'eg'o
riveregon	river'eg'o'n
rivereta	river'et'a
rivereto	river'et'o
riveretoj	river'et'o'j
riveretojn	river'et'o'j'n
rivereton	river'et'o'n
riverfluo	river'flu'o
riverhaveno	river'haven'o
riverlutro	river'lutr'o
riverlutroj	river'lutr'o'j
riversistemo	river'sistem'o
riversistemoj	river'sistem'o'j
riverujo	river'uj'o
rivervalo	river'val'o
rivervaloj	river'val'o'j
riverencas	riverenc'as
riverenci	riverenc'i
riverencis	riverenc'is
riverenco	riverenc'o
riverencon	riverenc'o'n
riverencado	riverenc'ad'o
riverencante	riverenc'ant'e
rivoluas	rivolu'as
rivoluo	rivolu'o
riza	riz'a
rizaj	riz'a'j
rizan	riz'a'n
rizo	riz'o
rizoj	riz'o'j
rizojn	riz'o'j'n
rizon	riz'o'n
rizaĵo	riz'aĵ'o
rizaĵon	riz'aĵ'o'n
rizejoj	riz'ej'o'j
rizfaruno	riz'farun'o
rizkampoj	riz'kamp'o'j
rizvino	riz'vin'o
rizvinon	riz'vin'o'n
rizomo	rizom'o
rizomoj	rizom'o'j
rizomojn	rizom'o'j'n
robo	rob'o
roboj	rob'o'j
robojn	rob'o'j'n
robon	rob'o'n
roberta	robert'a
roberto	robert'o
roberton	robert'o'n
robinsono	robinson'o
robota	robot'a
robotaj	robot'a'j
robotajn	robot'a'j'n
robotan	robot'a'n
roboto	robot'o
robotoj	robot'o'j
robotojn	robot'o'j'n
roboton	robot'o'n
robotiko	robot'ik'o
robotprogramo	robot'program'o
robotprogramoj	robot'program'o'j
roda	rod'a
rodas	rod'as
rodis	rod'is
rodo	rod'o
rodon	rod'o'n
roduloj	rod'ul'o'j
rodano	rodan'o
rodinsulo	rodinsul'o
rodiso	rodis'o
rodison	rodis'o'n
rododendroj	rododendr'o'j
rodoso	rodos'o
rodrigo	rodrig'o
roĝero	roĝer'o
roja	roj'a
rojo	roj'o
rojoj	roj'o'j
rojon	roj'o'n
rojalista	rojalist'a
rojalistaj	rojalist'a'j
rojalistoj	rojalist'o'j
roka	rok'a
rokaj	rok'a'j
rokajn	rok'a'j'n
rokan	rok'a'n
roko	rok'o
rokoj	rok'o'j
rokojn	rok'o'j'n
rokon	rok'o'n
rokaĵo	rok'aĵ'o
rokaĵoj	rok'aĵ'o'j
rokaro	rok'ar'o
rokbando	rok'band'o
rokburgo	rok'burg'o
rokego	rok'eg'o
rokegoj	rok'eg'o'j
rokfendoj	rok'fend'o'j
rokgrupo	rok'grup'o
rokmontaro	rok'mont'ar'o
rokmuro	rok'mur'o
rokmuzika	rok'muzik'a
rokmuzikaj	rok'muzik'a'j
rokmuziko	rok'muzik'o
rokmuzikon	rok'muzik'o'n
rokogrimpado	rok'o'grimp'ad'o
rokpentraĵoj	rok'pentr'aĵ'o'j
roktranĉita	rok'tranĉ'it'a
rokenrolo	rokenrol'o
rokoka	rokok'a
rokoko	rokok'o
rola	rol'a
rolas	rol'as
roli	rol'i
rolis	rol'is
rolo	rol'o
roloj	rol'o'j
rolojn	rol'o'j'n
rolon	rol'o'n
rolos	rol'os
rolado	rol'ad'o
rolanta	rol'ant'a
rolanto	rol'ant'o
rolantoj	rol'ant'o'j
rolantaro	rol'ant'ar'o
rolantaron	rol'ant'ar'o'n
rolantaranoj	rol'ant'ar'an'o'j
rolfinaĵo	rol'fin'aĵ'o
rolludo	rol'lud'o
rolludoj	rol'lud'o'j
rolmodelo	rol'model'o
rolmontrilo	rol'montr'il'o
rolmontriloj	rol'montr'il'o'j
rolmontrilojn	rol'montr'il'o'j'n
rolmontrilon	rol'montr'il'o'n
rolulo	rol'ul'o
roluloj	rol'ul'o'j
rolulojn	rol'ul'o'j'n
rolulon	rol'ul'o'n
rolulino	rol'ul'in'o
rolulinoj	rol'ul'in'o'j
rolvortaĵoj	rol'vort'aĵ'o'j
rolvorteto	rol'vort'et'o
rolvortetoj	rol'vort'et'o'j
rolvortetojn	rol'vort'et'o'j'n
rolvorteton	rol'vort'et'o'n
rolando	roland'o
roma	rom'a
romaj	rom'a'j
roman	rom'a'n
rome	rom'e
romo	rom'o
romon	rom'o'n
romana	rom'an'a
romanaj	rom'an'a'j
romanan	rom'an'a'n
romano	rom'an'o
romanoj	rom'an'o'j
romanojn	rom'an'o'j'n
romanon	rom'an'o'n
romanigo	rom'an'ig'o
romanigoj	rom'an'ig'o'j
romanigon	rom'an'ig'o'n
romia	rom'i'a
romiaj	rom'i'a'j
romiajn	rom'i'a'j'n
romian	rom'i'a'n
romio	rom'i'o
romiana	rom'i'an'a
romiano	rom'i'an'o
romianoj	rom'i'an'o'j
romianojn	rom'i'an'o'j'n
romkatolika	rom'katolik'a
romkatolikaj	rom'katolik'a'j
romkatolikan	rom'katolik'a'n
romkatoliko	rom'katolik'o
romkatolikoj	rom'katolik'o'j
romkatolikismo	rom'katolik'ism'o
romaa	roma'a
romaaj	roma'a'j
romao	roma'o
romaoj	roma'o'j
romana	roman'a
romanaj	roman'a'j
romanan	roman'a'n
romano	roman'o
romanoj	roman'o'j
romanojn	roman'o'j'n
romanon	roman'o'n
romaneca	roman'ec'a
romaneto	roman'et'o
romanisto	roman'ist'o
romanistoj	roman'ist'o'j
romanverkisto	roman'verk'ist'o
romanverkistoj	roman'verk'ist'o'j
romanco	romanc'o
romancoj	romanc'o'j
romancon	romanc'o'n
romanĉa	romanĉ'a
romanika	romanik'a
romanikaj	romanik'a'j
romanikan	romanik'a'n
romaniko	romanik'o
romantika	romantik'a
romantikaj	romantik'a'j
romantikajn	romantik'a'j'n
romantikan	romantik'a'n
romantike	romantik'e
romantiko	romantik'o
romantikeco	romantik'ec'o
romantikisma	romantik'ism'a
romantikismo	romantik'ism'o
romantikulo	romantik'ul'o
romantikuloj	romantik'ul'o'j
romantisma	romantism'a
romantismaj	romantism'a'j
romantismo	romantism'o
romba	romb'a
rombaj	romb'a'j
rombo	romb'o
romeo	rome'o
rompas	romp'as
rompe	romp'e
rompi	romp'i
rompis	romp'is
rompo	romp'o
rompoj	romp'o'j
rompojn	romp'o'j'n
rompon	romp'o'n
rompos	romp'os
rompu	romp'u
rompus	romp'us
rompadis	romp'ad'is
rompado	romp'ad'o
rompaĵoj	romp'aĵ'o'j
rompanta	romp'ant'a
rompante	romp'ant'e
rompata	romp'at'a
rompdancado	romp'danc'ad'o
rompebla	romp'ebl'a
rompeblaj	romp'ebl'a'j
rompeblas	romp'ebl'as
rompiĝas	romp'iĝ'as
rompiĝi	romp'iĝ'i
rompiĝis	romp'iĝ'is
rompiĝo	romp'iĝ'o
rompiĝos	romp'iĝ'os
rompiĝu	romp'iĝ'u
rompiĝus	romp'iĝ'us
rompiĝanta	romp'iĝ'ant'a
rompiĝema	romp'iĝ'em'a
rompiĝemaj	romp'iĝ'em'a'j
rompiĝemo	romp'iĝ'em'o
rompiĝintan	romp'iĝ'int'a'n
rompinta	romp'int'a
rompinte	romp'int'e
rompita	romp'it'a
rompitaj	romp'it'a'j
rompitajn	romp'it'a'j'n
rompitan	romp'it'a'n
rompite	romp'it'e
rompitaĵoj	romp'it'aĵ'o'j
rompopecoj	romp'o'pec'o'j
rompopunkto	romp'o'punkt'o
rompŝtelisto	romp'ŝtel'ist'o
rompŝteliston	romp'ŝtel'ist'o'n
romulo	romul'o
romulon	romul'o'n
romulanoj	romul'an'o'j
ronda	rond'a
rondaj	rond'a'j
rondajn	rond'a'j'n
rondan	rond'a'n
rondas	rond'as
ronde	rond'e
rondo	rond'o
rondoj	rond'o'j
rondojn	rond'o'j'n
rondon	rond'o'n
rondaĵo	rond'aĵ'o
rondaĵon	rond'aĵ'o'n
rondanoj	rond'an'o'j
rondeco	rond'ec'o
rondeta	rond'et'a
rondetaj	rond'et'a'j
rondetajn	rond'et'a'j'n
rondetan	rond'et'a'n
rondeto	rond'et'o
rondetoj	rond'et'o'j
rondetojn	rond'et'o'j'n
rondeton	rond'et'o'n
rondforma	rond'form'a
rondformaj	rond'form'a'j
rondgvidadoj	rond'gvid'ad'o'j
rondigis	rond'ig'is
rondigo	rond'ig'o
rondigita	rond'ig'it'a
rondigitaj	rond'ig'it'a'j
rondigitan	rond'ig'it'a'n
rondiĝis	rond'iĝ'is
rondiras	rond'ir'as
rondiri	rond'ir'i
rondiris	rond'ir'is
rondiro	rond'ir'o
rondiroj	rond'ir'o'j
rondiron	rond'ir'o'n
rondirado	rond'ir'ad'o
rondirantaj	rond'ir'ant'a'j
rondirante	rond'ir'ant'e
rondodanco	rond'o'danc'o
rondoforma	rond'o'form'a
rondoformaj	rond'o'form'a'j
rondoformajn	rond'o'form'a'j'n
rondveturo	rond'vetur'o
rondvojaĝo	rond'vojaĝ'o
rondelo	rondel'o
ronĝas	ronĝ'as
ronĝi	ronĝ'i
ronĝis	ronĝ'is
ronĝulo	ronĝ'ul'o
ronĝuloj	ronĝ'ul'o'j
ronĝulojn	ronĝ'ul'o'j'n
ronkas	ronk'as
ronki	ronk'i
ronkis	ronk'is
ronkado	ronk'ad'o
ronronas	ronron'as
rosa	ros'a
rosas	ros'as
rose	ros'e
roso	ros'o
roson	ros'o'n
rosopunkto	ros'o'punkt'o
rosmaro	rosmar'o
rosmaroj	rosmar'o'j
rosmareno	rosmaren'o
rostas	rost'as
rosti	rost'i
rostis	rost'is
rosto	rost'o
rostado	rost'ad'o
rostaĵo	rost'aĵ'o
rostaĵon	rost'aĵ'o'n
rostita	rost'it'a
rostitaj	rost'it'a'j
rostitajn	rost'it'a'j'n
rostitan	rost'it'a'n
rostpano	rost'pan'o
rostpanon	rost'pan'o'n
rostro	rostr'o
rostron	rostr'o'n
rota	rot'a
rote	rot'e
roto	rot'o
rotoj	rot'o'j
rotojn	rot'o'j'n
roton	rot'o'n
rotestro	rot'estr'o
rota	rota
rotacia	rotaci'a
rotaciaj	rotaci'a'j
rotaciajn	rotaci'a'j'n
rotacian	rotaci'a'n
rotacias	rotaci'as
rotacie	rotaci'e
rotacii	rotaci'i
rotaciis	rotaci'is
rotacio	rotaci'o
rotacioj	rotaci'o'j
rotaciojn	rotaci'o'j'n
rotacion	rotaci'o'n
rotaciado	rotaci'ad'o
rotaciakso	rotaci'aks'o
rotacianta	rotaci'ant'a
rotaciantaj	rotaci'ant'a'j
rotaciantajn	rotaci'ant'a'j'n
rotaciantan	rotaci'ant'a'n
rotaciante	rotaci'ant'e
rotaciita	rotaci'it'a
rotaciitaj	rotaci'it'a'j
rotaria	rotari'a
rotarian	rotari'a'n
rotario	rotari'o
rotarianoj	rotari'an'o'j
roterdama	roterdam'a
roterdamo	roterdam'o
roterdamon	roterdam'o'n
rotondo	rotond'o
rotoro	rotor'o
rotoroj	rotor'o'j
rotorojn	rotor'o'j'n
rotoron	rotor'o'n
roza	roz'a
rozaj	roz'a'j
rozajn	roz'a'j'n
rozan	roz'a'n
rozo	roz'o
rozoj	roz'o'j
rozojn	roz'o'j'n
rozon	roz'o'n
rozacoj	roz'ac'o'j
rozarbo	roz'arb'o
rozeca	roz'ec'a
rozeta	roz'et'a
rozeto	roz'et'o
rozetoj	roz'et'o'j
rozĝardeno	roz'ĝarden'o
rozkolora	roz'kolor'a
rozkoloraj	roz'kolor'a'j
rozkolorajn	roz'kolor'a'j'n
rozkoloran	roz'kolor'a'n
rozkolore	roz'kolor'e
rozkoloreca	roz'kolor'ec'a
rozkolorecaj	roz'kolor'ec'a'j
rozoleo	roz'ole'o
rozpetaloj	roz'petal'o'j
rozujo	roz'uj'o
rozulino	roz'ul'in'o
roza	roza
rozaria	rozari'a
rozarian	rozari'a'n
rozario	rozari'o
rozariojn	rozari'o'j'n
rozarion	rozari'o'n
ruanda	ruand'a
ruando	ruand'o
ruba	rub'a
rubaj	rub'a'j
rubo	rub'o
ruboj	rub'o'j
rubojn	rub'o'j'n
rubon	rub'o'n
rubaĵo	rub'aĵ'o
rubaĵoj	rub'aĵ'o'j
rubaĵojn	rub'aĵ'o'j'n
rubaĵon	rub'aĵ'o'n
rubejo	rub'ej'o
rubejoj	rub'ej'o'j
rubejon	rub'ej'o'n
rubforigo	rub'for'ig'o
rubgasoj	rub'gas'o'j
rubkolekto	rub'kolekt'o
rubmastrumado	rub'mastr'um'ad'o
rubmaterialo	rub'material'o
rubodeponejo	rub'o'depon'ej'o
rubodeponejoj	rub'o'depon'ej'o'j
rubofosado	rub'o'fos'ad'o
rubujo	rub'uj'o
rubujoj	rub'uj'o'j
rubujojn	rub'uj'o'j'n
rubujon	rub'uj'o'n
rubando	ruband'o
rubandoj	ruband'o'j
rubandojn	ruband'o'j'n
rubandon	ruband'o'n
rubekolo	rubekol'o
rubeno	ruben'o
rubenoj	ruben'o'j
rubenkolora	ruben'kolor'a
rubenkoloraj	ruben'kolor'a'j
rubeolo	rubeol'o
rubio	rubi'o
rubidio	rubidi'o
rublo	rubl'o
rubloj	rubl'o'j
rublojn	rubl'o'j'n
rublon	rubl'o'n
rubriko	rubrik'o
rubrikoj	rubrik'o'j
rubrikojn	rubrik'o'j'n
rubrikon	rubrik'o'n
rubuso	rubus'o
rubusoj	rubus'o'j
rudimenta	rudiment'a
rudimentaj	rudiment'a'j
rudimentajn	rudiment'a'j'n
rudimentan	rudiment'a'n
rudolfo	rudolf'o
rudra	rudr'a
rudro	rudr'o
rudroj	rudr'o'j
rudron	rudr'o'n
rufa	ruf'a
rufaj	ruf'a'j
rufajn	ruf'a'j'n
rufan	ruf'a'n
rugbea	rugbe'a
rugbeo	rugbe'o
rugbeon	rugbe'o'n
ruĝa	ruĝ'a
ruĝaj	ruĝ'a'j
ruĝajn	ruĝ'a'j'n
ruĝan	ruĝ'a'n
ruĝas	ruĝ'as
ruĝe	ruĝ'e
ruĝis	ruĝ'is
ruĝo	ruĝ'o
ruĝon	ruĝ'o'n
ruĝbeka	ruĝ'bek'a
ruĝbruna	ruĝ'brun'a
ruĝbrunaj	ruĝ'brun'a'j
ruĝdoma	ruĝ'dom'a
ruĝeca	ruĝ'ec'a
ruĝecaj	ruĝ'ec'a'j
ruĝecajn	ruĝ'ec'a'j'n
ruĝecan	ruĝ'ec'a'n
ruĝece	ruĝ'ec'e
ruĝeco	ruĝ'ec'o
ruĝecoj	ruĝ'ec'o'j
ruĝecon	ruĝ'ec'o'n
ruĝecbruna	ruĝ'ec'brun'a
ruĝecbrunaj	ruĝ'ec'brun'a'j
ruĝecbrunajn	ruĝ'ec'brun'a'j'n
ruĝecbrunan	ruĝ'ec'brun'a'n
ruĝenŝoviĝo	ruĝ'en'ŝov'iĝ'o
ruĝeta	ruĝ'et'a
ruĝetaj	ruĝ'et'a'j
ruĝetan	ruĝ'et'a'n
ruĝete	ruĝ'et'e
ruĝgorĝa	ruĝ'gorĝ'a
ruĝhara	ruĝ'har'a
ruĝigas	ruĝ'ig'as
ruĝigi	ruĝ'ig'i
ruĝigis	ruĝ'ig'is
ruĝiĝas	ruĝ'iĝ'as
ruĝiĝi	ruĝ'iĝ'i
ruĝiĝis	ruĝ'iĝ'is
ruĝiĝo	ruĝ'iĝ'o
ruĝiĝante	ruĝ'iĝ'ant'e
ruĝiĝinte	ruĝ'iĝ'int'e
ruĝkolora	ruĝ'kolor'a
ruĝkoloraj	ruĝ'kolor'a'j
ruĝkrura	ruĝ'krur'a
ruĝkufulineto	ruĝ'kuf'ul'in'et'o
ruĝokula	ruĝ'okul'a
ruĝokulaj	ruĝ'okul'a'j
ruĝoranĝa	ruĝ'oranĝ'a
ruĝuloj	ruĝ'ul'o'j
ruĝvanga	ruĝ'vang'a
ruĝvulpoj	ruĝ'vulp'o'j
ruina	ruin'a
ruino	ruin'o
ruinoj	ruin'o'j
ruinojn	ruin'o'j'n
ruinon	ruin'o'n
ruinaĵo	ruin'aĵ'o
ruinaĵoj	ruin'aĵ'o'j
ruinaĵojn	ruin'aĵ'o'j'n
ruinaĵon	ruin'aĵ'o'n
ruiniga	ruin'ig'a
ruinigas	ruin'ig'as
ruinigi	ruin'ig'i
ruinigis	ruin'ig'is
ruinigo	ruin'ig'o
ruinigon	ruin'ig'o'n
ruinigos	ruin'ig'os
ruinigu	ruin'ig'u
ruinigus	ruin'ig'us
ruinigita	ruin'ig'it'a
ruinigitaj	ruin'ig'it'a'j
ruiniĝas	ruin'iĝ'as
ruiniĝis	ruin'iĝ'is
ruiniĝo	ruin'iĝ'o
ruiniĝon	ruin'iĝ'o'n
ruiniĝinta	ruin'iĝ'int'a
ruiniĝintaj	ruin'iĝ'int'a'j
ruinita	ruin'it'a
ruinitaj	ruin'it'a'j
ruĵo	ruĵ'o
ruktis	rukt'is
rulas	rul'as
rule	rul'e
ruli	rul'i
rulis	rul'is
rulo	rul'o
ruloj	rul'o'j
rulojn	rul'o'j'n
rulon	rul'o'n
rulado	rul'ad'o
rulaĵo	rul'aĵ'o
rulaĵoj	rul'aĵ'o'j
rulaĵon	rul'aĵ'o'n
rulanta	rul'ant'a
ruldomo	rul'dom'o
ruldomoj	rul'dom'o'j
rulebla	rul'ebl'a
ruleblaj	rul'ebl'a'j
rulfalis	rul'fal'is
rulglobetoj	rul'glob'et'o'j
ruliĝas	rul'iĝ'as
ruliĝi	rul'iĝ'i
ruliĝis	rul'iĝ'is
ruliĝos	rul'iĝ'os
ruliĝadis	rul'iĝ'ad'is
ruliĝado	rul'iĝ'ad'o
ruliĝanta	rul'iĝ'ant'a
ruliĝantaj	rul'iĝ'ant'a'j
ruliĝantan	rul'iĝ'ant'a'n
ruliĝante	rul'iĝ'ant'e
rulita	rul'it'a
rulitaj	rul'it'a'j
rulkreskaĵoj	rul'kresk'aĵ'o'j
rulpremilo	rul'prem'il'o
rulpremiloj	rul'prem'il'o'j
rulpremilojn	rul'prem'il'o'j'n
rulseĝo	rul'seĝ'o
rulseĝoj	rul'seĝ'o'j
rulseĝon	rul'seĝ'o'n
rulŝtonetoj	rul'ŝton'et'o'j
rulŝtuparo	rul'ŝtup'ar'o
rulŝtuparoj	rul'ŝtup'ar'o'j
rulŝtuparon	rul'ŝtup'ar'o'n
rultabulo	rul'tabul'o
rultempa	rul'temp'a
rultempaj	rul'temp'a'j
rultempan	rul'temp'a'n
rultempe	rul'temp'e
rultempo	rul'temp'o
ruleto	rulet'o
rumo	rum'o
rumon	rum'o'n
rumana	ruman'a
rumanaj	ruman'a'j
rumanajn	ruman'a'j'n
rumanan	ruman'a'n
rumane	ruman'e
rumano	ruman'o
rumanoj	ruman'o'j
rumanojn	ruman'o'j'n
rumania	ruman'i'a
rumanio	ruman'i'o
rumanion	ruman'i'o'n
rumanuja	ruman'uj'a
rumanujo	ruman'uj'o
rumeno	rumen'o
rumoro	rumor'o
runa	run'a
runaj	run'a'j
runo	run'o
runoj	run'o'j
runojn	run'o'j'n
runon	run'o'n
runda	rund'a
rupio	rupi'o
rupioj	rupi'o'j
rusa	rus'a
rusaj	rus'a'j
rusajn	rus'a'j'n
rusan	rus'a'n
ruse	rus'e
ruso	rus'o
rusoj	rus'o'j
rusojn	rus'o'j'n
ruson	rus'o'n
rusajapana	rus'a'japan'a
rusia	rus'i'a
rusiaj	rus'i'a'j
rusiajn	rus'i'a'j'n
rusian	rus'i'a'n
rusio	rus'i'o
rusion	rus'i'o'n
rusianoj	rus'i'an'o'j
rusigo	rus'ig'o
rusino	rus'in'o
rusismoj	rus'ism'o'j
ruslanda	rus'land'a
ruslandaj	rus'land'a'j
ruslandan	rus'land'a'n
ruslando	rus'land'o
ruslandon	rus'land'o'n
ruslandanoj	rus'land'an'o'j
ruslingva	rus'lingv'a
ruslingvaj	rus'lingv'a'j
ruslingvajn	rus'lingv'a'j'n
ruslingvan	rus'lingv'a'n
ruslingve	rus'lingv'e
ruslingvanoj	rus'lingv'an'o'j
rusortodoksa	rus'ortodoks'a
rusparolantaj	rus'parol'ant'a'j
rusujo	rus'uj'o
rusujon	rus'uj'o'n
rusta	rust'a
rustaj	rust'a'j
rustis	rust'is
rusto	rust'o
ruston	rust'o'n
rustiĝas	rust'iĝ'as
rustiĝis	rust'iĝ'is
rustimuna	rust'imun'a
rustorezista	rust'o'rezist'a
rustorezistaj	rust'o'rezist'a'j
rustorezistaŝtala	rust'o'rezist'a'ŝtal'a
rustorezistaŝtalaj	rust'o'rezist'a'ŝtal'a'j
rustika	rustik'a
rustikaj	rustik'a'j
ruta	rut'a
ruto	rut'o
ruton	rut'o'n
rutena	ruten'a
rutenoj	ruten'o'j
rutenio	ruten'i'o
rutina	rutin'a
rutinaj	rutin'a'j
rutinajn	rutin'a'j'n
rutinan	rutin'a'n
rutine	rutin'e
rutino	rutin'o
rutinoj	rutin'o'j
rutinojn	rutin'o'j'n
rutinon	rutin'o'n
ruza	ruz'a
ruzaj	ruz'a'j
ruzajn	ruz'a'j'n
ruzan	ruz'a'n
ruzas	ruz'as
ruze	ruz'e
ruzo	ruz'o
ruzon	ruz'o'n
ruzaĵo	ruz'aĵ'o
ruzaĵoj	ruz'aĵ'o'j
ruzaĵon	ruz'aĵ'o'n
ruzeco	ruz'ec'o
ruzega	ruz'eg'a
ruzulo	ruz'ul'o
ruzuloj	ruz'ul'o'j