sabata	sabat'a
sabataj	sabat'a'j
sabatajn	sabat'a'j'n
sabatan	sabat'a'n
sabate	sabat'e
sabato	sabat'o
sabatoj	sabat'o'j
sabatojn	sabat'o'j'n
sabaton	sabat'o'n
sabatdimanĉa	sabat'dimanĉ'a
sabatleĝoj	sabat'leĝ'o'j
sabatmatena	sabat'maten'a
sabatmatene	sabat'maten'e
sabatmateno	sabat'maten'o
sabatmatenoj	sabat'maten'o'j
sabatmatenbildstrioj	sabat'maten'bild'stri'o'j
sabatnokto	sabat'nokt'o
sabatnoktoj	sabat'nokt'o'j
sabatorgio	sabat'orgi'o
sabatorgioj	sabat'orgi'o'j
sabatorgion	sabat'orgi'o'n
sabatposttagmezo	sabat'post'tag'mez'o
sabatvespera	sabat'vesper'a
sabatvespere	sabat'vesper'e
sabatvesperon	sabat'vesper'o'n
sabeliko	sabelik'o
sabla	sabl'a
sablaj	sabl'a'j
sablajn	sabl'a'j'n
sablan	sabl'a'n
sablas	sabl'as
sable	sabl'e
sablis	sabl'is
sablo	sabl'o
sabloj	sabl'o'j
sablojn	sabl'o'j'n
sablon	sabl'o'n
sablado	sabl'ad'o
sabladkapoj	sabl'ad'kap'o'j
sablaĵo	sabl'aĵ'o
sablaĵoj	sabl'aĵ'o'j
sablaĵojn	sabl'aĵ'o'j'n
sablaĵon	sabl'aĵ'o'n
sablaro	sabl'ar'o
sableca	sabl'ec'a
sablecaj	sabl'ec'a'j
sablejo	sabl'ej'o
sablejoj	sabl'ej'o'j
sablejojn	sabl'ej'o'j'n
sablejon	sabl'ej'o'n
sablero	sabl'er'o
sableroj	sabl'er'o'j
sablerojn	sabl'er'o'j'n
sableron	sabl'er'o'n
sabliĝo	sabl'iĝ'o
sablita	sabl'it'a
sablobano	sabl'o'ban'o
sablobara	sabl'o'bar'a
sablobenko	sabl'o'benk'o
sablobenkoj	sabl'o'benk'o'j
sabloblovumado	sabl'o'blov'um'ad'o
sabloboato	sabl'o'boat'o
sabloboaton	sabl'o'boat'o'n
sablobordo	sabl'o'bord'o
sablobrikoj	sabl'o'brik'o'j
sablobruna	sabl'o'brun'a
sablobrunaj	sabl'o'brun'a'j
sabloburgon	sabl'o'burg'o'n
sablocementa	sabl'o'cement'a
sablodorso	sabl'o'dors'o
sablodorsoj	sabl'o'dors'o'j
sabloduno	sabl'o'dun'o
sablodunoj	sabl'o'dun'o'j
sablodunojn	sabl'o'dun'o'j'n
sablofiltriloj	sabl'o'filtr'il'o'j
sablogisado	sabl'o'gis'ad'o
sablograjnoj	sabl'o'grajn'o'j
sablograjnojn	sabl'o'grajn'o'j'n
sablogrundaj	sabl'o'grund'a'j
sablogrundoj	sabl'o'grund'o'j
sablohorloĝo	sabl'o'horloĝ'o
sablohorloĝoj	sabl'o'horloĝ'o'j
sablohorloĝon	sabl'o'horloĝ'o'n
sablohorloĝoforman	sabl'o'horloĝ'o'form'a'n
sablokasteloj	sabl'o'kastel'o'j
sablokastelojn	sabl'o'kastel'o'j'n
sablokastelon	sabl'o'kastel'o'n
sablokato	sabl'o'kat'o
sablokatoj	sabl'o'kat'o'j
sablokesto	sabl'o'kest'o
sablokestoj	sabl'o'kest'o'j
sablokeston	sabl'o'kest'o'n
sablokestludo	sabl'o'kest'lud'o
sablokolora	sabl'o'kolor'a
sablokoloraj	sabl'o'kolor'a'j
sablokolorajn	sabl'o'kolor'a'j'n
sablokoloran	sabl'o'kolor'a'n
sablokolore	sabl'o'kolor'e
sablokoloro	sabl'o'kolor'o
sablokovrita	sabl'o'kovr'it'a
sablokovritajn	sabl'o'kovr'it'a'j'n
sablokuko	sabl'o'kuk'o
sablomaroj	sabl'o'mar'o'j
sablomonto	sabl'o'mont'o
sablomontoj	sabl'o'mont'o'j
sablomonton	sabl'o'mont'o'n
sablomontetoj	sabl'o'mont'et'o'j
sablopalpanto	sabl'o'palp'ant'o
sablopapero	sabl'o'paper'o
sablopipio	sabl'o'pipi'o
sabloplena	sabl'o'plen'a
sabloplenaj	sabl'o'plen'a'j
sablopleniĝo	sabl'o'plen'iĝ'o
sablopolvo	sabl'o'polv'o
sablopreventan	sabl'o'prevent'a'n
sabloriĉa	sabl'o'riĉ'a
sablosako	sabl'o'sak'o
sablosakoj	sabl'o'sak'o'j
sablosakojn	sabl'o'sak'o'j'n
sablostrando	sabl'o'strand'o
sablostrandoj	sabl'o'strand'o'j
sabloŝtona	sabl'o'ŝton'a
sabloŝtonaj	sabl'o'ŝton'a'j
sabloŝtono	sabl'o'ŝton'o
sabloŝtonoj	sabl'o'ŝton'o'j
sabloŝtonojn	sabl'o'ŝton'o'j'n
sabloŝtonon	sabl'o'ŝton'o'n
sabloŝtormo	sabl'o'ŝtorm'o
sabloŝtormoj	sabl'o'ŝtorm'o'j
sabloŝtormojn	sabl'o'ŝtorm'o'j'n
sabloŝtormon	sabl'o'ŝtorm'o'n
sablotabulado	sabl'o'tabul'ad'o
sablotajdoj	sabl'o'tajd'o'j
sablotero	sabl'o'ter'o
sablovado	sabl'o'vad'o
sabloventa	sabl'o'vent'a
sablovento	sabl'o'vent'o
sabloventoj	sabl'o'vent'o'j
sabloventon	sabl'o'vent'o'n
sablovermo	sabl'o'verm'o
sabloviro	sabl'o'vir'o
sabloza	sabl'oz'a
sablozaj	sabl'oz'a'j
sablujo	sabl'uj'o
sabloneto	sablonet'o
sabotajn	sabot'a'j'n
sabotas	sabot'as
saboti	sabot'i
sabotis	sabot'is
saboto	sabot'o
sabotus	sabot'us
sabotado	sabot'ad'o
sabotadoj	sabot'ad'o'j
sabotadon	sabot'ad'o'n
sabotago	sabot'ag'o
sabotagoj	sabot'ag'o'j
sabotagojn	sabot'ag'o'j'n
sabotaĵo	sabot'aĵ'o
sabotaĵojn	sabot'aĵ'o'j'n
sabotante	sabot'ant'e
sabotanto	sabot'ant'o
sabotantoj	sabot'ant'o'j
sabotantojn	sabot'ant'o'j'n
sabotisto	sabot'ist'o
sabotistoj	sabot'ist'o'j
sabotita	sabot'it'a
sabotitaj	sabot'it'a'j
sabra	sabr'a
sabre	sabr'e
sabri	sabr'i
sabro	sabr'o
sabroj	sabr'o'j
sabrojn	sabr'o'j'n
sabron	sabr'o'n
sabrado	sabr'ad'o
sabringo	sabr'ing'o
sabrodenta	sabr'o'dent'a
sabrodentaj	sabr'o'dent'a'j
sabrofiŝo	sabr'o'fiŝ'o
sabrokarpo	sabr'o'karp'o
sabropinto	sabr'o'pint'o
sabrosegilo	sabr'o'seg'il'o
sacerdota	sacerdot'a
sacerdotaj	sacerdot'a'j
sacerdotajn	sacerdot'a'j'n
sacerdotan	sacerdot'a'n
sacerdoto	sacerdot'o
sacerdotoj	sacerdot'o'j
sacerdotojn	sacerdot'o'j'n
sacerdoton	sacerdot'o'n
sacerdotaro	sacerdot'ar'o
sacerdoteco	sacerdot'ec'o
sacerdotecon	sacerdot'ec'o'n
sacerdotejo	sacerdot'ej'o
sacerdotiĝi	sacerdot'iĝ'i
sacerdotiĝo	sacerdot'iĝ'o
sacerdotiĝoj	sacerdot'iĝ'o'j
sacerdotiĝos	sacerdot'iĝ'os
sacerdotino	sacerdot'in'o
sacerdotinoj	sacerdot'in'o'j
sacerdotista	sacerdot'ist'a
sacerdotistaj	sacerdot'ist'a'j
sadisto	sad'ist'o
sadistoj	sad'ist'o'j
sadistojn	sad'ist'o'j'n
sadukea	saduke'a
sadukeoj	saduke'o'j
sadukeojn	saduke'o'j'n
safira	safir'a
safire	safir'e
safiro	safir'o
safiroj	safir'o'j
safiron	safir'o'n
safrano	safran'o
safranoj	safran'o'j
safranon	safran'o'n
safranflava	safran'flav'a
saga	sag'a
sagaj	sag'a'j
sagan	sag'a'n
sagas	sag'as
sage	sag'e
sagis	sag'is
sago	sag'o
sagoj	sag'o'j
sagojn	sag'o'j'n
sagon	sag'o'n
sageca	sag'ec'a
sageto	sag'et'o
sagetoj	sag'et'o'j
sagetojn	sag'et'o'j'n
sageton	sag'et'o'n
sagobirdo	sag'o'bird'o
sagobirdoj	sag'o'bird'o'j
sagoformaj	sag'o'form'a'j
sagoĵetado	sag'o'ĵet'ad'o
sagokalmaro	sag'o'kalmar'o
sagoklavoj	sag'o'klav'o'j
sagoklavojn	sag'o'klav'o'j'n
sagopintoj	sag'o'pint'o'j
sagopintojn	sag'o'pint'o'j'n
sagopluvo	sag'o'pluv'o
sagoveneno	sag'o'venen'o
sagpafo	sag'paf'o
sagpafado	sag'paf'ad'o
sagpafadon	sag'paf'ad'o'n
sagpafiloj	sag'paf'il'o'j
sagpinto	sag'pint'o
sagpintoj	sag'pint'o'j
sagpintojn	sag'pint'o'j'n
sagpinton	sag'pint'o'n
sagplumoj	sag'plum'o'j
sagplumojn	sag'plum'o'j'n
sagpunktoj	sag'punkt'o'j
sagpunkton	sag'punkt'o'n
sagrapide	sag'rapid'e
sagsimila	sag'simil'a
saguja	sag'uj'a
sagujo	sag'uj'o
sagujon	sag'uj'o'n
sagao	saga'o
sagaoj	saga'o'j
sagaojn	saga'o'j'n
sagaon	saga'o'n
sagaetoj	saga'et'o'j
sagaca	sagac'a
sagacaj	sagac'a'j
sagacajn	sagac'a'j'n
sagacan	sagac'a'n
sagacas	sagac'as
sagace	sagac'e
sagacis	sagac'is
sagaco	sagac'o
sagacon	sagac'o'n
sagaceco	sagac'ec'o
sagacecon	sagac'ec'o'n
sagaculo	sagac'ul'o
sagitala	sagital'a
sagitalaj	sagital'a'j
sagitalebeno	sagital'eben'o
sagitario	sagitari'o
sagua	sagu'a
saguo	sagu'o
saguaro	sagu'ar'o
sagupalmoj	sagu'palm'o'j
sagha	saĝ'a
saĝa	saĝ'a
saĝaj	saĝ'a'j
saĝajn	saĝ'a'j'n
saĝan	saĝ'a'n
saĝas	saĝ'as
saghe	saĝ'e
saĝe	saĝ'e
sagho	saĝ'o
saĝo	saĝ'o
saĝon	saĝ'o'n
saĝeco	saĝ'ec'o
saĝecon	saĝ'ec'o'n
saĝejo	saĝ'ej'o
saghulo	saĝ'ul'o
saĝulo	saĝ'ul'o
saghuloj	saĝ'ul'o'j
saĝuloj	saĝ'ul'o'j
saĝulojn	saĝ'ul'o'j'n
saghulon	saĝ'ul'o'n
saĝulon	saĝ'ul'o'n
sahara	sahar'a
saharaj	sahar'a'j
saharajn	sahar'a'j'n
saharan	sahar'a'n
saharo	sahar'o
saharon	sahar'o'n
saharanoj	sahar'an'o'j
saharodezerto	sahar'o'dezert'o
sajanoj	sajan'o'j
saka	sak'a
sake	sak'e
saki	sak'i
sakis	sak'is
sako	sak'o
sakoj	sak'o'j
sakojn	sak'o'j'n
sakon	sak'o'n
sakeca	sak'ec'a
sakecaj	sak'ec'a'j
sakegoj	sak'eg'o'j
saketo	sak'et'o
saketoj	sak'et'o'j
saketojn	sak'et'o'j'n
saketon	sak'et'o'n
sakfajfilo	sak'fajf'il'o
sakfluto	sak'flut'o
sakforma	sak'form'a
saknestulo	sak'nest'ul'o
sakostrato	sak'o'strat'o
sakplenon	sak'plen'o'n
sakstrata	sak'strat'a
sakstrato	sak'strat'o
sakstratoj	sak'strat'o'j
sakstratojn	sak'strat'o'j'n
sakstraton	sak'strat'o'n
sakstrateto	sak'strat'et'o
sakŝalma	sak'ŝalm'a
sakŝalmo	sak'ŝalm'o
sakŝalmoj	sak'ŝalm'o'j
sakŝalmon	sak'ŝalm'o'n
sakŝalmisto	sak'ŝalm'ist'o
sakŝalmludanto	sak'ŝalm'lud'ant'o
sakŝalmludantoj	sak'ŝalm'lud'ant'o'j
sakŝalmludantreprezentanto	sak'ŝalm'lud'ant'reprezent'ant'o
sakŝtofo	sak'ŝtof'o
saktendo	sak'tend'o
saktolo	sak'tol'o
saktolon	sak'tol'o'n
sakvoja	sak'voj'a
sakvojo	sak'voj'o
sakvojon	sak'voj'o'n
sakamoto	sakamot'o
sakari	sakar'i
sakarigaj	sakar'ig'a'j
sakarigo	sakar'ig'o
sakaridoj	sakarid'o'j
sakarino	sakarin'o
sakarinon	sakarin'o'n
sakarozo	sakaroz'o
sakarozon	sakaroz'o'n
sakeo	sake'o
sakeon	sake'o'n
sakra	sakr'a
sakraj	sakr'a'j
sakrajn	sakr'a'j'n
sakran	sakr'a'n
sakras	sakr'as
sakre	sakr'e
sakri	sakr'i
sakris	sakr'is
sakro	sakr'o
sakroj	sakr'o'j
sakrojn	sakr'o'j'n
sakron	sakr'o'n
sakru	sakr'u
sakradis	sakr'ad'is
sakrado	sakr'ad'o
sakradon	sakr'ad'o'n
sakraĵo	sakr'aĵ'o
sakraĵoj	sakr'aĵ'o'j
sakraĵojn	sakr'aĵ'o'j'n
sakranta	sakr'ant'a
sakrantan	sakr'ant'a'n
sakrante	sakr'ant'e
sakrario	sakr'ari'o
sakrigo	sakr'ig'o
sakropopmuziko	sakr'o'pop'muzik'o
sakrosanktaj	sakr'o'sankt'a'j
sakrosankteco	sakr'o'sankt'ec'o
sakrovorto	sakr'o'vort'o
sakrala	sakral'a
sakralaj	sakral'a'j
sakralajn	sakral'a'j'n
sakralan	sakral'a'n
sakrale	sakral'e
sakramenta	sakrament'a
sakramentaj	sakrament'a'j
sakramentajn	sakrament'a'j'n
sakramentan	sakrament'a'n
sakramente	sakrament'e
sakramento	sakrament'o
sakramentoj	sakrament'o'j
sakramentojn	sakrament'o'j'n
sakramenton	sakrament'o'n
sakramentalo	sakramental'o
sakramentaloj	sakramental'o'j
sakramentario	sakramentari'o
sakramentarioj	sakramentari'o'j
sakrilega	sakrileg'a
sakrilegia	sakrilegi'a
sakrilegiaj	sakrilegi'a'j
sakrilegian	sakrilegi'a'n
sakrilegie	sakrilegi'e
sakrilegio	sakrilegi'o
sakrilegioj	sakrilegi'o'j
sakrilegion	sakrilegi'o'n
sakrilegiaĵoj	sakrilegi'aĵ'o'j
sakrilegiulo	sakrilegi'ul'o
sakristian	sakristi'a'n
sakristio	sakristi'o
sakristioj	sakristi'o'j
sakristion	sakristi'o'n
sakristiano	sakristi'an'o
sakristianoj	sakristi'an'o'j
sakristianon	sakristi'an'o'n
sakristianedzino	sakristi'an'edz'in'o
sakristiisto	sakristi'ist'o
saksa	saks'a
saksaj	saks'a'j
saksajn	saks'a'j'n
saksan	saks'a'n
sakso	saks'o
saksoj	saks'o'j
saksojn	saks'o'j'n
saksia	saks'i'a
saksiaj	saks'i'a'j
saksian	saks'i'a'n
saksio	saks'i'o
saksion	saks'i'o'n
saksioanhalto	saks'i'o'anhalt'o
saksioanhaltio	saks'i'o'anhalt'i'o
saksujo	saks'uj'o
saksujoanhalto	saks'uj'o'anhalt'o
saksujoanhaltano	saks'uj'o'anhalt'an'o
saksaula	saksaul'a
saksaulo	saksaul'o
saksifrago	saksifrag'o
saksifragacoj	saksifrag'ac'o'j
saksikolo	saksikol'o
saksofona	saksofon'a
saksofonaj	saksofon'a'j
saksofono	saksofon'o
saksofonoj	saksofon'o'j
saksofonojn	saksofon'o'j'n
saksofonon	saksofon'o'n
saksofonbuŝpeco	saksofon'buŝ'pec'o
saksofonisto	saksofon'ist'o
saksofonistoj	saksofon'ist'o'j
saksofoniston	saksofon'ist'o'n
saksofonludanto	saksofon'lud'ant'o
sakura	sakur'a
sakuraj	sakur'a'j
sakurajn	sakur'a'j'n
sakuro	sakur'o
sakuroj	sakur'o'j
sakurojn	sakur'o'j'n
sakurfloroj	sakur'flor'o'j
sakuroaprecado	sakur'o'aprec'ad'o
sakurofloroj	sakur'o'flor'o'j
sala	sal'a
salaj	sal'a'j
salajn	sal'a'j'n
salan	sal'a'n
salas	sal'as
sale	sal'e
sali	sal'i
salis	sal'is
salo	sal'o
saloj	sal'o'j
salojn	sal'o'j'n
salon	sal'o'n
salaakva	sal'a'akv'a
salaakvaj	sal'a'akv'a'j
salaakvan	sal'a'akv'a'n
saladolĉan	sal'a'dolĉ'a'n
salado	sal'ad'o
saladon	sal'ad'o'n
saladministracio	sal'administraci'o
salakva	sal'akv'a
salakvaj	sal'akv'a'j
salakvan	sal'akv'a'n
salakvo	sal'akv'o
salakvon	sal'akv'o'n
saleca	sal'ec'a
saleco	sal'ec'o
salecon	sal'ec'o'n
salejo	sal'ej'o
salejoj	sal'ej'o'j
saleta	sal'et'a
saletaj	sal'et'a'j
salglandon	sal'gland'o'n
salita	sal'it'a
salitaj	sal'it'a'j
salitan	sal'it'a'n
sallagurbo	sal'lag'urb'o
salmarĉoj	sal'marĉ'o'j
saloza	sal'oz'a
salozaj	sal'oz'a'j
salujo	sal'uj'o
saladino	saladin'o
saladinon	saladin'o'n
salajra	salajr'a
salajraj	salajr'a'j
salajran	salajr'a'n
salajras	salajr'as
salajre	salajr'e
salajri	salajr'i
salajris	salajr'is
salajro	salajr'o
salajroj	salajr'o'j
salajrojn	salajr'o'j'n
salajron	salajr'o'n
salajrado	salajr'ad'o
salajraĵo	salajr'aĵ'o
salajraltigo	salajr'alt'ig'o
salajraltigoj	salajr'alt'ig'o'j
salajraltigojn	salajr'alt'ig'o'j'n
salajraltigon	salajr'alt'ig'o'n
salajraltigmono	salajr'alt'ig'mon'o
salajraltigmonon	salajr'alt'ig'mon'o'n
salajraltigomono	salajr'alt'ig'o'mon'o
salajraltiĝon	salajr'alt'iĝ'o'n
salajrata	salajr'at'a
salajrataj	salajr'at'a'j
salajratajn	salajr'at'a'j'n
salajratan	salajr'at'a'n
salajrato	salajr'at'o
salajratoj	salajr'at'o'j
salajraton	salajr'at'o'n
salajreco	salajr'ec'o
salajrecon	salajr'ec'o'n
salajrecreto	salajr'ec'ret'o
salajrekonomio	salajr'ekonomi'o
salajreton	salajr'et'o'n
salajrigita	salajr'ig'it'a
salajrigitaj	salajr'ig'it'a'j
salajrigitajn	salajr'ig'it'a'j'n
salajrinformojn	salajr'inform'o'j'n
salajrinterkonsento	salajr'inter'konsent'o
salajrinterspaco	salajr'inter'spac'o
salajrita	salajr'it'a
salajritaj	salajr'it'a'j
salajritan	salajr'it'a'n
salajroaltigo	salajr'o'al'tig'o
salajroaltigoj	salajr'o'al'tig'o'j
salajroaltigon	salajr'o'al'tig'o'n
salajroĉekoj	salajr'o'ĉek'o'j
salajrodiferenco	salajr'o'diferenc'o
salajrodoktrino	salajr'o'doktrin'o
salajroetato	salajr'o'etat'o
salajroetaton	salajr'o'etat'o'n
salajroetatkontroloj	salajr'o'etat'kontrol'o'j
salajrofleksebleco	salajr'o'fleks'ebl'ec'o
salajrogrupo	salajr'o'grup'o
salajrogrupoj	salajr'o'grup'o'j
salajrohonorario	salajr'o'honorari'o
salajroimpostoj	salajr'o'impost'o'j
salajrokosto	salajr'o'kost'o
salajrokostoj	salajr'o'kost'o'j
salajrolaboro	salajr'o'labor'o
salajrolaboristo	salajr'o'labor'ist'o
salajrolaboristoj	salajr'o'labor'ist'o'j
salajrolaborlokoj	salajr'o'labor'lok'o'j
salajrolimo	salajr'o'lim'o
salajrolimoj	salajr'o'lim'o'j
salajrolimon	salajr'o'lim'o'n
salajrolistoj	salajr'o'list'o'j
salajromalegaleco	salajr'o'mal'egal'ec'o
salajromalegalecoj	salajr'o'mal'egal'ec'o'j
salajromalegalecon	salajr'o'mal'egal'ec'o'n
salajromuro	salajr'o'mur'o
salajromuroj	salajr'o'mur'o'j
salajromuron	salajr'o'mur'o'n
salajronivelo	salajr'o'nivel'o
salajroniveloj	salajr'o'nivel'o'j
salajropaga	salajr'o'pag'a
salajropago	salajr'o'pag'o
salajropagon	salajr'o'pag'o'n
salajroplialtigon	salajr'o'pli'al'tig'o'n
salajropliiĝoj	salajr'o'pli'iĝ'o'j
salajropostulojn	salajr'o'postul'o'j'n
salajroredukto	salajr'o'redukt'o
salajroreduktoj	salajr'o'redukt'o'j
salajroreduktojn	salajr'o'redukt'o'j'n
salajroredukton	salajr'o'redukt'o'n
salajrosistemo	salajr'o'sistem'o
salajrosistemon	salajr'o'sistem'o'n
salajrosklavo	salajr'o'sklav'o
salajrosklavoj	salajr'o'sklav'o'j
salajrosklaveco	salajr'o'sklav'ec'o
salajrosubvencio	salajr'o'subvenci'o
salajrotarifo	salajr'o'tarif'o
salajrotarifoj	salajr'o'tarif'o'j
salajrotarifojn	salajr'o'tarif'o'j'n
salajrovaro	salajr'o'var'o
salajrulo	salajr'ul'o
salajruloj	salajr'ul'o'j
salajrulojn	salajr'ul'o'j'n
salamo	salam'o
salamon	salam'o'n
salamandro	salamandr'o
salamandroj	salamandr'o'j
salamandrojn	salamandr'o'j'n
salato	salat'o
salatoj	salat'o'j
salaton	salat'o'n
saldo	sald'o
saldon	sald'o'n
salikaj	salik'a'j
saliko	salik'o
salikoj	salik'o'j
salikon	salik'o'n
salikata	salik'at'a
salikato	salik'at'o
salikoko	salikok'o
salikokoj	salikok'o'j
salikokojn	salikok'o'j'n
salikokon	salikok'o'n
salivo	saliv'o
salivon	saliv'o'n
salma	salm'a
salman	salm'a'n
salmo	salm'o
salmoj	salm'o'j
salmojn	salm'o'j'n
salmon	salm'o'n
salmoneo	salmone'o
salomona	salomon'a
salomono	salomon'o
salomonoj	salomon'o'j
salona	salon'a
salonaj	salon'a'j
salono	salon'o
salonoj	salon'o'j
salonojn	salon'o'j'n
salonon	salon'o'n
salonego	salon'eg'o
salonegon	salon'eg'o'n
saloneto	salon'et'o
salpetro	salpetr'o
salta	salt'a
saltas	salt'as
salte	salt'e
salti	salt'i
saltis	salt'is
salto	salt'o
saltoj	salt'o'j
saltojn	salt'o'j'n
salton	salt'o'n
saltos	salt'os
saltu	salt'u
saltus	salt'us
saltadas	salt'ad'as
saltadi	salt'ad'i
saltadis	salt'ad'is
saltado	salt'ad'o
saltadon	salt'ad'o'n
saltanta	salt'ant'a
saltantaj	salt'ant'a'j
saltantan	salt'ant'a'n
saltante	salt'ant'e
saltegis	salt'eg'is
saltego	salt'eg'o
saltegoj	salt'eg'o'j
saltegojn	salt'eg'o'j'n
saltetas	salt'et'as
salteti	salt'et'i
saltetis	salt'et'is
salteto	salt'et'o
saltetoj	salt'et'o'j
saltetado	salt'et'ad'o
saltetanta	salt'et'ant'a
saltetante	salt'et'ant'e
saltinte	salt'int'e
saltita	salt'it'a
saltitaj	salt'it'a'j
saltleviĝis	salt'lev'iĝ'is
saltotabulo	salt'o'tabul'o
saltulo	salt'ul'o
saltuloj	salt'ul'o'j
salubra	salubr'a
salubrigo	salubr'ig'o
saluta	salut'a
salutan	salut'a'n
salutas	salut'as
salute	salut'e
saluti	salut'i
salutis	salut'is
saluto	salut'o
salutoj	salut'o'j
salutojn	salut'o'j'n
saluton	salut'o'n
salutos	salut'os
salutu	salut'u
salutus	salut'us
salutado	salut'ad'o
salutantaj	salut'ant'a'j
salutante	salut'ant'e
salutata	salut'at'a
salutinda	salut'ind'a
salutinte	salut'int'e
salutita	salut'it'a
salutitaj	salut'it'a'j
salutkartoj	salut'kart'o'j
salutmesaĝo	salut'mesaĝ'o
salutmesaĝojn	salut'mesaĝ'o'j'n
salutmesaĝon	salut'mesaĝ'o'n
salutnomo	salut'nom'o
salutnomon	salut'nom'o'n
salutvorto	salut'vort'o
salutvortoj	salut'vort'o'j
salutvortojn	salut'vort'o'j'n
salvo	salv'o
salvon	salv'o'n
salvadoro	salvador'o
salvio	salvi'o
sama	sam'a
samaj	sam'a'j
samajn	sam'a'j'n
saman	sam'a'n
samas	sam'as
same	sam'e
sami	sam'i
samkiel	sam'kiel
samo	sam'o
samoj	sam'o'j
samon	sam'o'n
samtiel	sam'tiel
samtiom	sam'tiom
samus	sam'us
samaspeca	sam'a'spec'a
samaĝa	sam'aĝ'a
samaĝaj	sam'aĝ'a'j
samaĝas	sam'aĝ'as
samaĝulo	sam'aĝ'ul'o
samaghuloj	sam'aĝ'ul'o'j
samaĝuloj	sam'aĝ'ul'o'j
samaĝulojn	sam'aĝ'ul'o'j'n
samaksa	sam'aks'a
samaksaj	sam'aks'a'j
samalta	sam'alt'a
samaltas	sam'alt'as
samcelaj	sam'cel'a'j
samcele	sam'cel'e
samcelanoj	sam'cel'an'o'j
samcentra	sam'centr'a
samcentraj	sam'centr'a'j
samcentrajn	sam'centr'a'j'n
samcivitanoj	sam'civit'an'o'j
samĉambrano	sam'ĉambr'an'o
samĉambranoj	sam'ĉambr'an'o'j
samdirekte	sam'direkt'e
sameco	sam'ec'o
samecon	sam'ec'o'n
samepokaj	sam'epok'a'j
samepoke	sam'epok'e
samfakuloj	sam'fak'ul'o'j
samfamilianoj	sam'famili'an'o'j
samfoje	sam'foj'e
samforma	sam'form'a
samformaj	sam'form'a'j
samgenra	sam'genr'a
samgenraj	sam'genr'a'j
samgenranoj	sam'genr'an'o'j
samgentanoj	sam'gent'an'o'j
samgrade	sam'grad'e
samgranda	sam'grand'a
samgrandaj	sam'grand'a'j
samideana	sam'ide'an'a
samideane	sam'ide'an'e
samideano	sam'ide'an'o
samideanoj	sam'ide'an'o'j
samideanojn	sam'ide'an'o'j'n
samideanon	sam'ide'an'o'n
samideanaro	sam'ide'an'ar'o
samideanaroj	sam'ide'an'ar'o'j
samideanaron	sam'ide'an'ar'o'n
samideanino	sam'ide'an'in'o
samjare	sam'jar'e
samklasano	sam'klas'an'o
samklasanoj	sam'klas'an'o'j
samklasanojn	sam'klas'an'o'j'n
samkolora	sam'kolor'a
samkoloraj	sam'kolor'a'j
samkoloran	sam'kolor'a'n
samkredanoj	sam'kred'an'o'j
samlandano	sam'land'an'o
samlandanoj	sam'land'an'o'j
samlandanojn	sam'land'an'o'j'n
samlarĝaj	sam'larĝ'a'j
samlernejanoj	sam'lern'ej'an'o'j
samlimaj	sam'lim'a'j
samlingvanoj	sam'lingv'an'o'j
samlokaj	sam'lok'a'j
samloke	sam'lok'e
sammaniere	sam'manier'e
sammomente	sam'moment'e
samnacianoj	sam'naci'an'o'j
samnivela	sam'nivel'a
samnivelaj	sam'nivel'a'j
samnivele	sam'nivel'e
samnoma	sam'nom'a
samnomaj	sam'nom'a'j
samnoman	sam'nom'a'n
samnomulo	sam'nom'ul'o
samopinias	sam'opini'as
samopinii	sam'opini'i
samopiniis	sam'opini'is
sampartianoj	sam'parti'an'o'j
sampaŝe	sam'paŝ'e
sampatrujanoj	sam'patr'uj'an'o'j
samprofesiuloj	sam'profesi'ul'o'j
samrajtaj	sam'rajt'a'j
samrajte	sam'rajt'e
samrajteco	sam'rajt'ec'o
samrajtecon	sam'rajt'ec'o'n
samranga	sam'rang'a
samrangaj	sam'rang'a'j
samrange	sam'rang'e
samranguloj	sam'rang'ul'o'j
samrapide	sam'rapid'e
samrapidi	sam'rapid'i
samreligianoj	sam'religi'an'o'j
samreligiuloj	sam'religi'ul'o'j
samsangaj	sam'sang'a'j
samseksa	sam'seks'a
samseksaj	sam'seks'a'j
samseksajn	sam'seks'a'j'n
samseksan	sam'seks'a'n
samseksama	sam'seks'am'a
samseksamaj	sam'seks'am'a'j
samseksamo	sam'seks'am'o
samseksema	sam'seks'em'a
samseksemaj	sam'seks'em'a'j
samseksemajn	sam'seks'em'a'j'n
samsekseman	sam'seks'em'a'n
samseksemo	sam'seks'em'o
samseksemon	sam'seks'em'o'n
samseksemeco	sam'seks'em'ec'o
samseksemulo	sam'seks'em'ul'o
samseksemuloj	sam'seks'em'ul'o'j
samseksemulojn	sam'seks'em'ul'o'j'n
samseksuloj	sam'seks'ul'o'j
samsencaj	sam'senc'a'j
samsence	sam'senc'e
samsignifa	sam'signif'a
samsignifaj	sam'signif'a'j
samsignifas	sam'signif'as
samsignife	sam'signif'e
samsortanoj	sam'sort'an'o'j
samspeca	sam'spec'a
samspecaj	sam'spec'a'j
samspecajn	sam'spec'a'j'n
samspecan	sam'spec'a'n
samspeculoj	sam'spec'ul'o'j
samspecianoj	sam'speci'an'o'j
samspeciuloj	sam'speci'ul'o'j
samspecifa	sam'specif'a
samtaga	sam'tag'a
samtage	sam'tag'e
samtakte	sam'takt'e
samteamano	sam'team'an'o
samteamanoj	sam'team'an'o'j
samtema	sam'tem'a
samtemaj	sam'tem'a'j
samtempa	sam'temp'a
samtempaj	sam'temp'a'j
samtempajn	sam'temp'a'j'n
samtempan	sam'temp'a'n
samtempe	sam'temp'e
samtempeco	sam'temp'ec'o
samtempulo	sam'temp'ul'o
samtempuloj	sam'temp'ul'o'j
samtempulojn	sam'temp'ul'o'j'n
samtipa	sam'tip'a
samtipaj	sam'tip'a'j
samtitola	sam'titol'a
samuloj	sam'ul'o'j
samurbano	sam'urb'an'o
samurbanoj	sam'urb'an'o'j
samvalora	sam'valor'a
samvaloraj	sam'valor'a'j
samvaloras	sam'valor'as
samvilaĝanoj	sam'vilaĝ'an'o'j
samara	samar'a
samaro	samar'o
samaria	samari'a
samario	samari'o
samariano	samari'an'o
samarianoj	samari'an'o'j
samarkando	samarkand'o
samba	samb'a
sambo	samb'o
sambuko	sambuk'o
samea	same'a
sameaj	same'a'j
samean	same'a'n
sameoj	same'o'j
samizdato	samizdat'o
samnite	samnit'e
samnitoj	samnit'o'j
samoa	samo'a
samoo	samo'o
samoso	samos'o
samovaro	samovar'o
samovaroj	samovar'o'j
samovaron	samovar'o'n
samuelo	samuel'o
samurajo	samuraj'o
samurajoj	samuraj'o'j
sana	san'a
sanaj	san'a'j
sanajn	san'a'j'n
sanan	san'a'n
sanas	san'as
sane	san'e
sano	san'o
sanoj	san'o'j
sanon	san'o'n
sanaferoj	san'afer'o'j
sanasekuro	san'asekur'o
sanasekuron	san'asekur'o'n
sanblogoj	san'blog'o'j
sancirkonstancoj	san'cirkonstanc'o'j
sandanĝeroj	san'danĝer'o'j
sanecaj	san'ec'a'j
saneco	san'ec'o
sanecon	san'ec'o'n
sanefektoj	san'efekt'o'j
sanefektojn	san'efekt'o'j'n
sanefikoj	san'efik'o'j
sanfavora	san'favor'a
saniga	san'ig'a
sanigaj	san'ig'a'j
sanigajn	san'ig'a'j'n
sanigan	san'ig'a'n
sanigas	san'ig'as
sanige	san'ig'e
sanigi	san'ig'i
sanigis	san'ig'is
sanigo	san'ig'o
sanigon	san'ig'o'n
sanigos	san'ig'os
sanigado	san'ig'ad'o
sanigilo	san'ig'il'o
sanigilojn	san'ig'il'o'j'n
sanigilon	san'ig'il'o'n
sanigisto	san'ig'ist'o
saniĝas	san'iĝ'as
saniĝi	san'iĝ'i
saniĝis	san'iĝ'is
saniĝo	san'iĝ'o
saniĝon	san'iĝ'o'n
saniĝos	san'iĝ'os
sanindustrio	san'industri'o
saninstalaĵoj	san'instal'aĵ'o'j
sankondiĉoj	san'kondiĉ'o'j
sanlaboristoj	san'labor'ist'o'j
sanministerio	san'ministeri'o
sanorganizo	san'organiz'o
sanpagoj	san'pag'o'j
sanpagojn	san'pag'o'j'n
sanprizorga	san'pri'zorg'a
sanproblemo	san'problem'o
sanproblemoj	san'problem'o'j
sanproblemojn	san'problem'o'j'n
sanprotekta	san'protekt'a
sanprotekto	san'protekt'o
sanprotektado	san'protekt'ad'o
sanprovizanto	san'proviz'ant'o
sanprovizantoj	san'proviz'ant'o'j
sanrezultoj	san'rezult'o'j
sanriskoj	san'risk'o'j
sanriskojn	san'risk'o'j'n
sanriskon	san'risk'o'n
sansciencoj	san'scienc'o'j
sanservo	san'serv'o
sanservoj	san'serv'o'j
sanservojn	san'serv'o'j'n
sanservon	san'serv'o'n
sanservoprofesiuloj	san'serv'o'profesi'ul'o'j
sansistemo	san'sistem'o
sansistemoj	san'sistem'o'j
sansistemon	san'sistem'o'n
sanstato	san'stat'o
sanstaton	san'stat'o'n
santemoj	san'tem'o'j
sanulo	san'ul'o
sanuloj	san'ul'o'j
sanzorgo	san'zorg'o
sanzorgoj	san'zorg'o'j
sanzorgado	san'zorg'ad'o
sanaa	sana'a
sanao	sana'o
sanatorio	sanatori'o
sanatorioj	sanatori'o'j
sanatorion	sanatori'o'n
sandaloj	sandal'o'j
sandalojn	sandal'o'j'n
sandra	sandr'a
sandro	sandr'o
sandviĉa	sandviĉ'a
sandviĉo	sandviĉ'o
sandviĉoj	sandviĉ'o'j
sandviĉojn	sandviĉ'o'j'n
sandviĉon	sandviĉ'o'n
sanfrancisko	sanfrancisk'o
sanfranciskon	sanfrancisk'o'n
sanga	sang'a
sangaj	sang'a'j
sangajn	sang'a'j'n
sangan	sang'a'n
sangas	sang'as
sange	sang'e
sangi	sang'i
sangis	sang'is
sango	sang'o
sangoj	sang'o'j
sangon	sang'o'n
sangos	sang'os
sangado	sang'ad'o
sangadon	sang'ad'o'n
sanganta	sang'ant'a
sangantaj	sang'ant'a'j
sangantajn	sang'ant'a'j'n
sangantan	sang'ant'a'n
sangante	sang'ant'e
sangavida	sang'avid'a
sangavidaj	sang'avid'a'j
sangmakulita	sang'makul'it'a
sangobankan	sang'o'bank'a'n
sangobanko	sang'o'bank'o
sangocirkulado	sang'o'cirkul'ad'o
sangocirkuladon	sang'o'cirkul'ad'o'n
sangoĉeloj	sang'o'ĉel'o'j
sangofluo	sang'o'flu'o
sangofluon	sang'o'flu'o'n
sangogrupo	sang'o'grup'o
sangogrupon	sang'o'grup'o'n
sangoguto	sang'o'gut'o
sangokolbaso	sang'o'kolbas'o
sangokovrita	sang'o'kovr'it'a
sangoperdo	sang'o'perd'o
sangoplasmo	sang'o'plasm'o
sangoplena	sang'o'plen'a
sangopremo	sang'o'prem'o
sangopremon	sang'o'prem'o'n
sangoprovizo	sang'o'proviz'o
sangoprovizon	sang'o'proviz'o'n
sangotransfuzo	sang'o'transfuz'o
sangotransfuzoj	sang'o'transfuz'o'j
sangoverŝo	sang'o'verŝ'o
sangoverŝado	sang'o'verŝ'ad'o
sangoverŝadon	sang'o'verŝ'ad'o'n
sangproduktoj	sang'produkt'o'j
sangtorento	sang'torent'o
sangtorenton	sang'torent'o'n
sangho	sanĝ'o
sanitara	sanitar'a
sanitaraj	sanitar'a'j
sanitarajn	sanitar'a'j'n
sanitaran	sanitar'a'n
sanjuano	sanjuan'o
sankcias	sankci'as
sankcii	sankci'i
sankciis	sankci'is
sankcio	sankci'o
sankcioj	sankci'o'j
sankciojn	sankci'o'j'n
sankcion	sankci'o'n
sankciita	sankci'it'a
sankciitaj	sankci'it'a'j
sankta	sankt'a
sanktaj	sankt'a'j
sanktajn	sankt'a'j'n
sanktan	sankt'a'n
sankte	sankt'e
sanktaĵo	sankt'aĵ'o
sanktaĵoj	sankt'aĵ'o'j
sankteco	sankt'ec'o
sanktecon	sankt'ec'o'n
sanktega	sankt'eg'a
sanktejo	sankt'ej'o
sanktejoj	sankt'ej'o'j
sanktejojn	sankt'ej'o'j'n
sanktejon	sankt'ej'o'n
sanktigas	sankt'ig'as
sanktigi	sankt'ig'i
sanktigis	sankt'ig'is
sanktigo	sankt'ig'o
sanktigu	sankt'ig'u
sanktigita	sankt'ig'it'a
sanktigitaj	sankt'ig'it'a'j
sanktigitan	sankt'ig'it'a'n
sanktiĝo	sankt'iĝ'o
sanktjohano	sankt'johan'o
sanktlaŭrenco	sankt'laŭrenc'o
sanktoleado	sankt'ole'ad'o
sanktoleita	sankt'ole'it'a
sanktpeterburga	sankt'peterburg'a
sanktpeterburgo	sankt'peterburg'o
sanktulaj	sankt'ul'a'j
sanktulo	sankt'ul'o
sanktuloj	sankt'ul'o'j
sanktulojn	sankt'ul'o'j'n
sanktulon	sankt'ul'o'n
sanktulino	sankt'ul'in'o
sanktulinoj	sankt'ul'in'o'j
sanmarino	sanmarin'o
sanpaŭlo	sanpaŭl'o
sanpaŭlio	sanpaŭli'o
sansaro	sansar'o
sanskrita	sanskrit'a
sanskritaj	sanskrit'a'j
sanskritajn	sanskrit'a'j'n
sanskritan	sanskrit'a'n
sanskrite	sanskrit'e
sanskrito	sanskrit'o
sanskriton	sanskrit'o'n
sanskritvorto	sanskrit'vort'o
sanskritvortoj	sanskrit'vort'o'j
santalo	santal'o
santorino	santorin'o
sanusio	sanusi'o
sapa	sap'a
sapo	sap'o
sapoj	sap'o'j
sapon	sap'o'n
sapoperoj	sap'oper'o'j
sapveziko	sap'vezik'o
sapvezikojn	sap'vezik'o'j'n
saponinoj	saponin'o'j
sarlando	sar'land'o
sardino	sardin'o
sardinoj	sardin'o'j
sardinio	sardini'o
sardona	sardon'a
sario	sari'o
sarino	sarin'o
sarki	sark'i
sarkis	sark'is
sarkilo	sark'il'o
sarkasma	sarkasm'a
sarkasmaj	sarkasm'a'j
sarkasman	sarkasm'a'n
sarkasme	sarkasm'e
sarkasmo	sarkasm'o
sarkasmon	sarkasm'o'n
sarkofago	sarkofag'o
sarkofagoj	sarkofag'o'j
sarkofagon	sarkofag'o'n
sarkopterigoj	sarkopterig'o'j
sarkozino	sarkozin'o
sarkozinato	sarkozin'at'o
sata	sat'a
sataj	sat'a'j
satan	sat'a'n
satas	sat'as
sate	sat'e
sati	sat'i
sato	sat'o
saton	sat'o'n
satamikaro	sat'amik'ar'o
satdormis	sat'dorm'is
satigas	sat'ig'as
satigi	sat'ig'i
satigis	sat'ig'is
satigos	sat'ig'os
satigita	sat'ig'it'a
satiĝas	sat'iĝ'as
satiĝi	sat'iĝ'i
satiĝis	sat'iĝ'is
satiĝos	sat'iĝ'os
satkongreso	sat'kongres'o
satkongresoj	sat'kongres'o'j
satmanĝi	sat'manĝ'i
satmanĝis	sat'manĝ'is
satmembroj	sat'membr'o'j
sattrinkis	sat'trink'is
satana	satan'a
satanaj	satan'a'j
satanan	satan'a'n
satano	satan'o
satanoj	satan'o'j
satanon	satan'o'n
satanismo	satan'ism'o
satanistoj	satan'ist'o'j
satelita	satelit'a
satelitaj	satelit'a'j
satelitajn	satelit'a'j'n
satelitan	satelit'a'n
satelito	satelit'o
satelitoj	satelit'o'j
satelitojn	satelit'o'j'n
sateliton	satelit'o'n
sateno	saten'o
satira	satir'a
satiraj	satir'a'j
satirajn	satir'a'j'n
satiran	satir'a'n
satire	satir'e
satiro	satir'o
satiroj	satir'o'j
satirojn	satir'o'j'n
satiron	satir'o'n
satiristo	satir'ist'o
satrapo	satrap'o
satrapio	satrap'i'o
saturas	satur'as
saturi	satur'i
saturis	satur'is
saturiĝo	satur'iĝ'o
saturita	satur'it'a
saturitaj	satur'it'a'j
saturitan	satur'it'a'n
saturna	saturn'a
saturno	saturn'o
saturnon	saturn'o'n
saŭcas	saŭc'as
saŭco	saŭc'o
saŭcoj	saŭc'o'j
saŭcojn	saŭc'o'j'n
saŭcon	saŭc'o'n
saŭno	saŭn'o
saŭnoj	saŭn'o'j
saŭnon	saŭn'o'n
sava	sav'a
savajn	sav'a'j'n
savan	sav'a'n
savas	sav'as
save	sav'e
savi	sav'i
savis	sav'is
savo	sav'o
savon	sav'o'n
savos	sav'os
savu	sav'u
savus	sav'us
savado	sav'ad'o
savadon	sav'ad'o'n
savanta	sav'ant'a
savante	sav'ant'e
savanto	sav'ant'o
savantoj	sav'ant'o'j
savanton	sav'ant'o'n
savarmeo	sav'arme'o
savata	sav'at'a
savboato	sav'boat'o
savboatoj	sav'boat'o'j
savboatojn	sav'boat'o'j'n
savboaton	sav'boat'o'n
savebla	sav'ebl'a
savhistorio	sav'histori'o
saviĝas	sav'iĝ'as
saviĝi	sav'iĝ'i
saviĝis	sav'iĝ'is
saviĝo	sav'iĝ'o
saviĝon	sav'iĝ'o'n
saviĝos	sav'iĝ'os
savilo	sav'il'o
savinta	sav'int'a
savinto	sav'int'o
savintoj	sav'int'o'j
savinton	sav'int'o'n
savistoj	sav'ist'o'j
savita	sav'it'a
savitaj	sav'it'a'j
savitoj	sav'it'o'j
savoplano	sav'o'plan'o
savonto	sav'ont'o
savplano	sav'plan'o
savsistemoj	sav'sistem'o'j
savtaĉmento	sav'taĉment'o
savana	savan'a
savano	savan'o
savanoj	savan'o'j
savanojn	savan'o'j'n
savanon	savan'o'n
savoja	savoj'a
savojo	savoj'o
scena	scen'a
scenaj	scen'a'j
sceno	scen'o
scenoj	scen'o'j
scenojn	scen'o'j'n
scenon	scen'o'n
scenaro	scen'ar'o
scenaroj	scen'ar'o'j
scenarojn	scen'ar'o'j'n
scenaron	scen'ar'o'n
scenaristo	scen'ar'ist'o
sceneja	scen'ej'a
scenejaj	scen'ej'a'j
scenejan	scen'ej'a'n
sceneje	scen'ej'e
scenejo	scen'ej'o
scenejoj	scen'ej'o'j
scenejojn	scen'ej'o'j'n
scenejon	scen'ej'o'n
sceptro	sceptr'o
sceptron	sceptr'o'n
scia	sci'a
scias	sci'as
scii	sci'i
sciis	sci'is
scio	sci'o
scioj	sci'o'j
sciojn	sci'o'j'n
scion	sci'o'n
scios	sci'os
sciu	sci'u
scius	sci'us
sciado	sci'ad'o
sciadon	sci'ad'o'n
sciaĵoj	sci'aĵ'o'j
scianta	sci'ant'a
sciantaj	sci'ant'a'j
sciante	sci'ant'e
scianto	sci'ant'o
sciantoj	sci'ant'o'j
sciaro	sci'ar'o
sciaron	sci'ar'o'n
sciata	sci'at'a
sciataj	sci'at'a'j
sciate	sci'at'e
sciavida	sci'avid'a
sciavido	sci'avid'o
sciebla	sci'ebl'a
sciema	sci'em'a
sciemo	sci'em'o
sciigas	sci'ig'as
sciigi	sci'ig'i
sciigis	sci'ig'is
sciigo	sci'ig'o
sciigoj	sci'ig'o'j
sciigojn	sci'ig'o'j'n
sciigon	sci'ig'o'n
sciigos	sci'ig'os
sciigu	sci'ig'u
sciigado	sci'ig'ad'o
sciiganta	sci'ig'ant'a
sciigante	sci'ig'ant'e
sciiginta	sci'ig'int'a
sciigita	sci'ig'it'a
sciigitaj	sci'ig'it'a'j
sciigite	sci'ig'it'e
sciiĝas	sci'iĝ'as
sciiĝi	sci'iĝ'i
sciiĝis	sci'iĝ'is
sciiĝos	sci'iĝ'os
sciiĝu	sci'iĝ'u
sciiĝinte	sci'iĝ'int'e
sciinta	sci'int'a
sciinte	sci'int'e
sciintus	sci'int'us
sciita	sci'it'a
sciobazo	sci'o'baz'o
sciobazon	sci'o'baz'o'n
sciobazitaj	sci'o'baz'it'a'j
sciolaboristoj	sci'o'labor'ist'o'j
scipova	sci'pov'a
scipovaj	sci'pov'a'j
scipovas	sci'pov'as
scipovi	sci'pov'i
scipovis	sci'pov'is
scipovo	sci'pov'o
scipovojn	sci'pov'o'j'n
scipovon	sci'pov'o'n
scipovos	sci'pov'os
scipovu	sci'pov'u
scipovus	sci'pov'us
scipovanta	sci'pov'ant'a
scipovantaj	sci'pov'ant'a'j
sciteorio	sci'teori'o
scivola	sci'vol'a
scivolaj	sci'vol'a'j
scivolas	sci'vol'as
scivole	sci'vol'e
scivoli	sci'vol'i
scivolis	sci'vol'is
scivolo	sci'vol'o
scivolon	sci'vol'o'n
scivolante	sci'vol'ant'e
scivolema	sci'vol'em'a
scivolemaj	sci'vol'em'a'j
scivolemajn	sci'vol'em'a'j'n
scivoleman	sci'vol'em'a'n
scivolemas	sci'vol'em'as
scivoleme	sci'vol'em'e
scivolemis	sci'vol'em'is
scivolemo	sci'vol'em'o
scivolemon	sci'vol'em'o'n
scivolemuloj	sci'vol'em'ul'o'j
scienca	scienc'a
sciencaj	scienc'a'j
sciencajn	scienc'a'j'n
sciencan	scienc'a'n
science	scienc'e
scienco	scienc'o
sciencoj	scienc'o'j
sciencojn	scienc'o'j'n
sciencon	scienc'o'n
sciencbazita	scienc'baz'it'a
sciencbazitaj	scienc'baz'it'a'j
sciencesplora	scienc'esplor'a
sciencesploraj	scienc'esplor'a'j
sciencfikcia	scienc'fikci'a
sciencfikciaj	scienc'fikci'a'j
sciencfikciajn	scienc'fikci'a'j'n
sciencfikcian	scienc'fikci'a'n
sciencfikcio	scienc'fikci'o
sciencfikcion	scienc'fikci'o'n
sciencfikciaĵoj	scienc'fikci'aĵ'o'j
sciencfikciaŭtoroj	scienc'fikci'aŭtor'o'j
sciencista	scienc'ist'a
sciencisto	scienc'ist'o
sciencistoj	scienc'ist'o'j
sciencistojn	scienc'ist'o'j'n
scienciston	scienc'ist'o'n
sciencistino	scienc'ist'in'o
sciencteknika	scienc'teknik'a
sciencteknikaj	scienc'teknik'a'j
sciencteknikajn	scienc'teknik'a'j'n
sciencteknikan	scienc'teknik'a'n
scienctekniko	scienc'teknik'o
scienculo	scienc'ul'o
scienculoj	scienc'ul'o'j
scienculojn	scienc'ul'o'j'n
scienculon	scienc'ul'o'n
scientisto	scientist'o
scientistoj	scientist'o'j
scientologio	scientologi'o
scintilis	scintil'is
scintilanta	scintil'ant'a
scintilantaj	scintil'ant'a'j
sciuro	sciur'o
sciuroj	sciur'o'j
sciurojn	sciur'o'j'n
sciuron	sciur'o'n
se	se
sefrazo	se'fraz'o
sefrazoj	se'fraz'o'j
seanco	seanc'o
seancoj	seanc'o'j
seancojn	seanc'o'j'n
seancon	seanc'o'n
sebo	seb'o
sebastiano	sebastian'o
sebastopolo	sebastopol'o
secesia	secesi'a
secesii	secesi'i
secesio	secesi'o
secesion	secesi'o'n
secesiistoj	secesi'ist'o'j
sed	sed
sedativa	sedativ'a
sedimenta	sediment'a
sedimentaj	sediment'a'j
sedimento	sediment'o
sedimentoj	sediment'o'j
sedimentojn	sediment'o'j'n
sedimenton	sediment'o'n
sedimentado	sediment'ad'o
sedimentadon	sediment'ad'o'n
sedimentaĵoj	sediment'aĵ'o'j
sefarda	sefard'a
sefardaj	sefard'a'j
sefardoj	sefard'o'j
sega	seg'a
segas	seg'as
segi	seg'i
segis	seg'is
segado	seg'ad'o
segĉevalo	seg'ĉeval'o
segĉevalon	seg'ĉeval'o'n
segejo	seg'ej'o
segejoj	seg'ej'o'j
segilo	seg'il'o
segiloj	seg'il'o'j
segilon	seg'il'o'n
segildenta	seg'il'dent'a
segildentaj	seg'il'dent'a'j
segita	seg'it'a
segpolvo	seg'polv'o
segpolvon	seg'polv'o'n
segmenta	segment'a
segmentaj	segment'a'j
segmentas	segment'as
segmento	segment'o
segmentoj	segment'o'j
segmentojn	segment'o'j'n
segmenton	segment'o'n
segmentigo	segment'ig'o
segovio	segovi'o
segregacio	segregaci'o
segho	seĝ'o
seĝo	seĝ'o
seĝoj	seĝ'o'j
seĝojn	seĝ'o'j'n
seĝon	seĝ'o'n
seĝeto	seĝ'et'o
seĝodorso	seĝ'o'dors'o
sejno	sejn'o
sejŝeloj	sejŝel'o'j
seka	sek'a
sekaj	sek'a'j
sekajn	sek'a'j'n
sekan	sek'a'n
sekas	sek'as
seke	sek'e
seki	sek'i
seko	sek'o
sekado	sek'ad'o
sekaĵo	sek'aĵ'o
sekdoko	sek'dok'o
sekeca	sek'ec'a
sekeco	sek'ec'o
sekecon	sek'ec'o'n
sekega	sek'eg'a
sekegaj	sek'eg'a'j
sekego	sek'eg'o
sekigas	sek'ig'as
sekigi	sek'ig'i
sekigis	sek'ig'is
sekigo	sek'ig'o
sekigos	sek'ig'os
sekigu	sek'ig'u
sekigado	sek'ig'ad'o
sekigadon	sek'ig'ad'o'n
sekigante	sek'ig'ant'e
sekigataj	sek'ig'at'a'j
sekigilo	sek'ig'il'o
sekigiloj	sek'ig'il'o'j
sekigita	sek'ig'it'a
sekigitaj	sek'ig'it'a'j
sekigitajn	sek'ig'it'a'j'n
sekigitan	sek'ig'it'a'n
sekiĝas	sek'iĝ'as
sekiĝi	sek'iĝ'i
sekiĝis	sek'iĝ'is
sekiĝo	sek'iĝ'o
sekiĝos	sek'iĝ'os
sekiĝu	sek'iĝ'u
sekiĝado	sek'iĝ'ad'o
sekiĝinta	sek'iĝ'int'a
sekiĝintaj	sek'iĝ'int'a'j
sekvinbero	sek'vin'ber'o
sekvinberoj	sek'vin'ber'o'j
sekvinberojn	sek'vin'ber'o'j'n
sekala	sekal'a
sekalan	sekal'a'n
sekalo	sekal'o
sekalon	sekal'o'n
sekca	sekc'a
sekcaj	sekc'a'j
sekcas	sekc'as
sekco	sekc'o
sekcoj	sekc'o'j
sekcon	sekc'o'n
sekcado	sekc'ad'o
sekcaĵo	sekc'aĵ'o
sekcia	sekci'a
sekciaj	sekci'a'j
sekcian	sekci'a'n
sekcio	sekci'o
sekcioj	sekci'o'j
sekciojn	sekci'o'j'n
sekcion	sekci'o'n
sekcianoj	sekci'an'o'j
sekciestro	sekci'estr'o
sekciestroj	sekci'estr'o'j
sekrecia	sekreci'a
sekreciaj	sekreci'a'j
sekrecias	sekreci'as
sekrecii	sekreci'i
sekrecio	sekreci'o
sekrecioj	sekreci'o'j
sekreciojn	sekreci'o'j'n
sekrecion	sekreci'o'n
sekreciado	sekreci'ad'o
sekreciaĵo	sekreci'aĵ'o
sekreciita	sekreci'it'a
sekreciitaj	sekreci'it'a'j
sekreta	sekret'a
sekretaj	sekret'a'j
sekretajn	sekret'a'j'n
sekretan	sekret'a'n
sekretas	sekret'as
sekrete	sekret'e
sekreti	sekret'i
sekreto	sekret'o
sekretoj	sekret'o'j
sekretojn	sekret'o'j'n
sekreton	sekret'o'n
sekreteco	sekret'ec'o
sekretecon	sekret'ec'o'n
sekretema	sekret'em'a
sekretemaj	sekret'em'a'j
sekretemo	sekret'em'o
sekretigas	sekret'ig'as
sekretigi	sekret'ig'i
sekretaria	sekretari'a
sekretario	sekretari'o
sekretarioj	sekretari'o'j
sekretariojn	sekretari'o'j'n
sekretarion	sekretari'o'n
sekretariaro	sekretari'ar'o
sekretarieco	sekretari'ec'o
sekretariejo	sekretari'ej'o
sekretariejon	sekretari'ej'o'n
sekretariino	sekretari'in'o
sekretariinoj	sekretari'in'o'j
sekretariinon	sekretari'in'o'n
sekretariato	sekretariat'o
seksa	seks'a
seksaj	seks'a'j
seksajn	seks'a'j'n
seksan	seks'a'n
sekse	seks'e
sekso	seks'o
seksoj	seks'o'j
seksojn	seks'o'j'n
sekson	seks'o'n
seksalloga	seks'al'log'a
seksallogo	seks'al'log'o
seksatenco	seks'atenc'o
seksĉikanado	seks'ĉikan'ad'o
seksĉikanadon	seks'ĉikan'ad'o'n
seksdiferenco	seks'diferenc'o
seksdiferencoj	seks'diferenc'o'j
sekseca	seks'ec'a
sekseco	seks'ec'o
seksecon	seks'ec'o'n
seksegaleco	seks'egal'ec'o
seksegalecon	seks'egal'ec'o'n
seksindustrio	seks'industri'o
seksisma	seks'ism'a
seksismaj	seks'ism'a'j
seksismo	seks'ism'o
seksismon	seks'ism'o'n
sekskuniĝo	seks'kun'iĝ'o
sekskuniĝon	seks'kun'iĝ'o'n
sekslaboristoj	seks'labor'ist'o'j
seksmisuzo	seks'mis'uz'o
seksneŭtrala	seks'neŭtral'a
seksneŭtralaj	seks'neŭtral'a'j
seksorganoj	seks'organ'o'j
seksorganojn	seks'organ'o'j'n
sekspariĝa	seks'par'iĝ'a
sekspariĝo	seks'par'iĝ'o
seksperfortas	seks'per'fort'as
seksperforti	seks'per'fort'i
seksperfortis	seks'per'fort'is
seksperforto	seks'per'fort'o
seksperfortoj	seks'per'fort'o'j
seksperforton	seks'per'fort'o'n
seksperfortado	seks'per'fort'ad'o
seksperfortita	seks'per'fort'it'a
seksperfortitaj	seks'per'fort'it'a'j
seksproporcio	seks'proporci'o
seksrilatoj	seks'rilat'o'j
seksrilatojn	seks'rilat'o'j'n
seksuma	seks'um'a
seksumaj	seks'um'a'j
seksumajn	seks'um'a'j'n
seksumas	seks'um'as
seksume	seks'um'e
seksumi	seks'um'i
seksumis	seks'um'is
seksumo	seks'um'o
seksumado	seks'um'ad'o
seksumadon	seks'um'ad'o'n
seksto	sekst'o
sekta	sekt'a
sektaj	sekt'a'j
sekto	sekt'o
sektoj	sekt'o'j
sektojn	sekt'o'j'n
sekton	sekt'o'n
sektanoj	sekt'an'o'j
sekteca	sekt'ec'a
sektecan	sekt'ec'a'n
sektismo	sekt'ism'o
sektora	sektor'a
sektoro	sektor'o
sektoroj	sektor'o'j
sektorojn	sektor'o'j'n
sektoron	sektor'o'n
sekulara	sekular'a
sekularaj	sekular'a'j
sekularajn	sekular'a'j'n
sekularan	sekular'a'n
sekulareco	sekular'ec'o
sekularigo	sekular'ig'o
sekularigado	sekular'ig'ad'o
sekularismo	sekular'ism'o
sekunda	sekund'a
sekunde	sekund'e
sekundo	sekund'o
sekundoj	sekund'o'j
sekundojn	sekund'o'j'n
sekundon	sekund'o'n
sekundara	sekundar'a
sekundaraj	sekundar'a'j
sekundarajn	sekundar'a'j'n
sekundaran	sekundar'a'n
sekundare	sekundar'e
sekura	sekur'a
sekuraj	sekur'a'j
sekurajn	sekur'a'j'n
sekuran	sekur'a'n
sekuras	sekur'as
sekure	sekur'e
sekuro	sekur'o
sekuron	sekur'o'n
sekureca	sekur'ec'a
sekurecaj	sekur'ec'a'j
sekurecajn	sekur'ec'a'j'n
sekurecan	sekur'ec'a'n
sekureco	sekur'ec'o
sekurecon	sekur'ec'o'n
sekurecceloj	sekur'ec'cel'o'j
sekurecdemandoj	sekur'ec'demand'o'j
sekurecfortoj	sekur'ec'fort'o'j
sekureckialoj	sekur'ec'kial'o'j
sekureckonsilio	sekur'ec'konsili'o
sekureckonzernoj	sekur'ec'konzern'o'j
sekureckopio	sekur'ec'kopi'o
sekurecnormoj	sekur'ec'norm'o'j
sekurecnormojn	sekur'ec'norm'o'j'n
sekurecofortoj	sekur'ec'o'fort'o'j
sekurecpolitiko	sekur'ec'politik'o
sekurecpostuloj	sekur'ec'postul'o'j
sekurecproblemoj	sekur'ec'problem'o'j
sekurecrimedoj	sekur'ec'rimed'o'j
sekurectrajtoj	sekur'ec'trajt'o'j
sekureczorgoj	sekur'ec'zorg'o'j
sekurgardistoj	sekur'gard'ist'o'j
sekuriga	sekur'ig'a
sekurigaj	sekur'ig'a'j
sekurigajn	sekur'ig'a'j'n
sekurigan	sekur'ig'a'n
sekurigas	sekur'ig'as
sekurigi	sekur'ig'i
sekurigis	sekur'ig'is
sekurigo	sekur'ig'o
sekurigu	sekur'ig'u
sekurigado	sekur'ig'ad'o
sekurigante	sekur'ig'ant'e
sekurigilo	sekur'ig'il'o
sekurigiloj	sekur'ig'il'o'j
sekurigilojn	sekur'ig'il'o'j'n
sekurigita	sekur'ig'it'a
sekurigitaj	sekur'ig'it'a'j
sekurkopio	sekur'kopi'o
sekurkopioj	sekur'kopi'o'j
sekurkopiojn	sekur'kopi'o'j'n
sekursistemo	sekur'sistem'o
sekursistemoj	sekur'sistem'o'j
sekurzonon	sekur'zon'o'n
sekva	sekv'a
sekvaj	sekv'a'j
sekvajn	sekv'a'j'n
sekvan	sekv'a'n
sekvas	sekv'as
sekve	sekv'e
sekvi	sekv'i
sekvis	sekv'is
sekvo	sekv'o
sekvoj	sekv'o'j
sekvojn	sekv'o'j'n
sekvon	sekv'o'n
sekvos	sekv'os
sekvu	sekv'u
sekvus	sekv'us
sekvafoje	sekv'a'foj'e
sekvajare	sekv'a'jar'e
sekvamatene	sekv'a'maten'e
sekvatage	sekv'a'tag'e
sekvadis	sekv'ad'is
sekvado	sekv'ad'o
sekvadon	sekv'ad'o'n
sekvaĵo	sekv'aĵ'o
sekvaĵoj	sekv'aĵ'o'j
sekvaĵon	sekv'aĵ'o'n
sekvanta	sekv'ant'a
sekvantaj	sekv'ant'a'j
sekvantajn	sekv'ant'a'j'n
sekvantan	sekv'ant'a'n
sekvante	sekv'ant'e
sekvanto	sekv'ant'o
sekvantoj	sekv'ant'o'j
sekvantojn	sekv'ant'o'j'n
sekvanton	sekv'ant'o'n
sekvantaro	sekv'ant'ar'o
sekvantaroj	sekv'ant'ar'o'j
sekvantaron	sekv'ant'ar'o'n
sekvata	sekv'at'a
sekvataj	sekv'at'a'j
sekvate	sekv'at'e
sekvenda	sekv'end'a
sekvigas	sekv'ig'as
sekvigis	sekv'ig'is
sekvinda	sekv'ind'a
sekvinta	sekv'int'a
sekvintaj	sekv'int'a'j
sekvintan	sekv'int'a'n
sekvinte	sekv'int'e
sekvismo	sekv'ism'o
sekvita	sekv'it'a
sekvitaj	sekv'it'a'j
sekvitajn	sekv'it'a'j'n
sekvitan	sekv'it'a'n
sekvite	sekv'it'e
sekvoriĉa	sekv'o'riĉ'a
sekvoriĉaj	sekv'o'riĉ'a'j
sekvoriĉajn	sekv'o'riĉ'a'j'n
sekvonta	sekv'ont'a
sekvontaj	sekv'ont'a'j
sekvontajn	sekv'ont'a'j'n
sekvontan	sekv'ont'a'n
sekvontfoje	sekv'ont'foj'e
sekvontjare	sekv'ont'jar'e
sekvonttage	sekv'ont'tag'e
sekvulo	sekv'ul'o
sekvuloj	sekv'ul'o'j
sekvenca	sekvenc'a
sekvencaj	sekvenc'a'j
sekvenco	sekvenc'o
sekvencoj	sekvenc'o'j
sekvencojn	sekvenc'o'j'n
sekvencon	sekvenc'o'n
sekvencado	sekvenc'ad'o
sekvencadon	sekvenc'ad'o'n
sekvencita	sekvenc'it'a
sekvencitaj	sekvenc'it'a'j
sekvestrado	sekvestr'ad'o
sekvestrita	sekvestr'it'a
sela	sel'a
seli	sel'i
selo	sel'o
seloj	sel'o'j
selojn	sel'o'j'n
selon	sel'o'n
selu	sel'u
selakto	selakt'o
selangoro	selangor'o
selekta	selekt'a
selektaj	selekt'a'j
selektas	selekt'as
selekti	selekt'i
selektis	selekt'is
selekto	selekt'o
selekton	selekt'o'n
selektos	selekt'os
selektu	selekt'u
selektado	selekt'ad'o
selektadoj	selekt'ad'o'j
selektadojn	selekt'ad'o'j'n
selektadon	selekt'ad'o'n
selektante	selekt'ant'e
selektema	selekt'em'a
selektemaj	selekt'em'a'j
selekteman	selekt'em'a'n
selekteme	selekt'em'e
selektita	selekt'it'a
selektitaj	selekt'it'a'j
selektitajn	selekt'it'a'j'n
selektprocezo	selekt'procez'o
selena	selen'a
seleno	selen'o
selenato	selen'at'o
sema	sem'a
seman	sem'a'n
semas	sem'as
semi	sem'i
semis	sem'is
semo	sem'o
semoj	sem'o'j
semojn	sem'o'j'n
semon	sem'o'n
semos	sem'os
semu	sem'u
semado	sem'ad'o
semadon	sem'ad'o'n
semanto	sem'ant'o
semeroj	sem'er'o'j
semita	sem'it'a
semitaj	sem'it'a'j
semaforo	semafor'o
semaforoj	semafor'o'j
semajna	semajn'a
semajnaj	semajn'a'j
semajnajn	semajn'a'j'n
semajnan	semajn'a'n
semajne	semajn'e
semajno	semajn'o
semajnoj	semajn'o'j
semajnojn	semajn'o'j'n
semajnon	semajn'o'n
semajnfina	semajn'fin'a
semajnfinaj	semajn'fin'a'j
semajnfine	semajn'fin'e
semajnfino	semajn'fin'o
semajnfinoj	semajn'fin'o'j
semajnfinojn	semajn'fin'o'j'n
semajnfinon	semajn'fin'o'n
semajngazeto	semajn'gazet'o
semajnĵurnalo	semajn'ĵurnal'o
semajnĵurnalon	semajn'ĵurnal'o'n
semajnofino	semajn'o'fin'o
semajnofinon	semajn'o'fin'o'n
semajnotago	semajn'o'tag'o
semajnotagoj	semajn'o'tag'o'j
semajntago	semajn'tag'o
semajntagoj	semajn'tag'o'j
semantika	semantik'a
semantikaj	semantik'a'j
semantikajn	semantik'a'j'n
semantikan	semantik'a'n
semantike	semantik'e
semantiko	semantik'o
semantikoj	semantik'o'j
semantikon	semantik'o'n
semestro	semestr'o
semestroj	semestr'o'j
semestron	semestr'o'n
semikonduktaĵaj	semi'kondukt'aĵ'a'j
semikonduktaĵo	semi'kondukt'aĵ'o
semikonduktaĵoj	semi'kondukt'aĵ'o'j
semikonduktaĵojn	semi'kondukt'aĵ'o'j'n
semikonduktiloj	semi'kondukt'il'o'j
semida	semid'a
semidaj	semid'a'j
semidan	semid'a'n
semidoj	semid'o'j
seminaria	seminari'a
seminario	seminari'o
seminarioj	seminari'o'j
seminariojn	seminari'o'j'n
seminarion	seminari'o'n
seminariano	seminari'an'o
seminarianoj	seminari'an'o'j
seminariejo	seminari'ej'o
semiotika	semiotik'a
semiotikaj	semiotik'a'j
semiotiko	semiotik'o
sen	sen
sena	sen'a
senafekta	sen'afekt'a
senafekte	sen'afekt'e
senaga	sen'ag'a
senage	sen'ag'e
senakcenta	sen'akcent'a
senakcentaj	sen'akcent'a'j
senakva	sen'akv'a
senakvaj	sen'akv'a'j
senakvigi	sen'akv'ig'i
senakvigita	sen'akv'ig'it'a
senakvigitaj	sen'akv'ig'it'a'j
senalfabeta	sen'alfabet'a
senalianca	sen'alianc'a
senalkohola	sen'alkohol'a
senama	sen'am'a
senanima	sen'anim'a
senanimaj	sen'anim'a'j
senantaŭjuĝa	sen'antaŭ'juĝ'a
senantaŭjuĝaj	sen'antaŭ'juĝ'a'j
senarba	sen'arb'a
senarbaj	sen'arb'a'j
senarbarigo	sen'arb'ar'ig'o
senarbarigon	sen'arb'ar'ig'o'n
senarbejo	sen'arb'ej'o
senarbigo	sen'arb'ig'o
senarma	sen'arm'a
senarmaj	sen'arm'a'j
senarmigi	sen'arm'ig'i
senarmigis	sen'arm'ig'is
senarmigo	sen'arm'ig'o
senarmigita	sen'arm'ig'it'a
senarmiĝo	sen'arm'iĝ'o
senarmila	sen'arm'il'a
senartifika	sen'artifik'a
senatende	sen'atend'e
senatenta	sen'atent'a
senatentaj	sen'atent'a'j
senatente	sen'atent'e
senaverte	sen'avert'e
senbalastigi	sen'balast'ig'i
senbara	sen'bar'a
senbare	sen'bar'e
senbarba	sen'barb'a
senbaza	sen'baz'a
senbazaj	sen'baz'a'j
senbaze	sen'baz'e
senbezona	sen'bezon'a
senbezone	sen'bezon'e
senbrida	sen'brid'a
senbridaj	sen'brid'a'j
senbridajn	sen'brid'a'j'n
senbridan	sen'brid'a'n
senbride	sen'brid'e
senbrila	sen'bril'a
senbrilaj	sen'bril'a'j
senbrilan	sen'bril'a'n
senbrua	sen'bru'a
senbruaj	sen'bru'a'j
senbrue	sen'bru'e
sencede	sen'ced'e
sencela	sen'cel'a
sencelaj	sen'cel'a'j
sencele	sen'cel'e
sencerba	sen'cerb'a
sencerbulo	sen'cerb'ul'o
senceremonie	sen'ceremoni'e
senchesa	sen'ĉes'a
senĉesa	sen'ĉes'a
senchesaj	sen'ĉes'a'j
senĉesaj	sen'ĉes'a'j
senĉesajn	sen'ĉes'a'j'n
senĉesan	sen'ĉes'a'n
senchese	sen'ĉes'e
senĉese	sen'ĉes'e
sendanĝera	sen'danĝer'a
sendanĝeraj	sen'danĝer'a'j
sendanĝerajn	sen'danĝer'a'j'n
sendanĝeran	sen'danĝer'a'n
sendanĝere	sen'danĝer'e
sendanĝereco	sen'danĝer'ec'o
sendanĝerigi	sen'danĝer'ig'i
sendanka	sen'dank'a
sendependa	sen'de'pend'a
sendependaj	sen'de'pend'a'j
sendependajn	sen'de'pend'a'j'n
sendependan	sen'de'pend'a'n
sendepende	sen'de'pend'e
sendependo	sen'de'pend'o
sendependon	sen'de'pend'o'n
sendependeca	sen'de'pend'ec'a
sendependeco	sen'de'pend'ec'o
sendependecon	sen'de'pend'ec'o'n
sendependecmovado	sen'de'pend'ec'mov'ad'o
sendependiga	sen'de'pend'ig'a
sendependigi	sen'de'pend'ig'i
sendependigo	sen'de'pend'ig'o
sendependiĝi	sen'de'pend'iĝ'i
sendependiĝis	sen'de'pend'iĝ'is
sendependiĝo	sen'de'pend'iĝ'o
sendependiĝon	sen'de'pend'iĝ'o'n
sendependisma	sen'de'pend'ism'a
sendependismaj	sen'de'pend'ism'a'j
sendependuloj	sen'de'pend'ul'o'j
sendecida	sen'decid'a
sendecide	sen'decid'e
sendefenda	sen'defend'a
sendefendaj	sen'defend'a'j
sendenta	sen'dent'a
sendentaj	sen'dent'a'j
sendevigas	sen'dev'ig'as
sendevigi	sen'dev'ig'i
sendevigo	sen'dev'ig'o
sendevigoj	sen'dev'ig'o'j
sendevigojn	sen'dev'ig'o'j'n
sendevigon	sen'dev'ig'o'n
sendevigita	sen'dev'ig'it'a
sendevigitaj	sen'dev'ig'it'a'j
sendia	sen'di'a
sendiulo	sen'di'ul'o
sendifekta	sen'difekt'a
sendifektaj	sen'difekt'a'j
sendifektan	sen'difekt'a'n
sendifekte	sen'difekt'e
sendiference	sen'diferenc'e
sendimensia	sen'dimensi'a
sendimensiaj	sen'dimensi'a'j
sendisciplina	sen'disciplin'a
sendiskuta	sen'diskut'a
sendiskute	sen'diskut'e
sendispute	sen'disput'e
sendistinge	sen'disting'e
sendogma	sen'dogm'a
sendolora	sen'dolor'a
sendolore	sen'dolor'e
sendorma	sen'dorm'a
sendormaj	sen'dorm'a'j
sendormajn	sen'dorm'a'j'n
sendorman	sen'dorm'a'n
sendorme	sen'dorm'e
sendormeco	sen'dorm'ec'o
sendormecon	sen'dorm'ec'o'n
sendrata	sen'drat'a
sendrataj	sen'drat'a'j
sendratajn	sen'drat'a'j'n
sendratan	sen'drat'a'n
sendrate	sen'drat'e
senduba	sen'dub'a
sendubaj	sen'dub'a'j
senduban	sen'dub'a'n
sendube	sen'dub'e
senedza	sen'edz'a
senedzina	sen'edz'in'a
senefika	sen'efik'a
senefikaj	sen'efik'a'j
senefike	sen'efik'e
senekzempla	sen'ekzempl'a
senekzemplan	sen'ekzempl'a'n
senelira	sen'el'ir'a
senelirejo	sen'el'ir'ej'o
senelirejon	sen'el'ir'ej'o'n
senembarase	sen'embaras'e
senemocia	sen'emoci'a
senemocie	sen'emoci'e
senenhava	sen'en'hav'a
senenhavaj	sen'en'hav'a'j
senenergia	sen'energi'a
senerara	sen'erar'a
seneraraj	sen'erar'a'j
seneraran	sen'erar'a'n
senerare	sen'erar'e
senerareco	sen'erar'ec'o
senerarigo	sen'erar'ig'o
senescepta	sen'escept'a
senescepte	sen'escept'e
senespera	sen'esper'a
senesperaj	sen'esper'a'j
senesperajn	sen'esper'a'j'n
senesperan	sen'esper'a'n
senespere	sen'esper'e
senespero	sen'esper'o
senespereco	sen'esper'ec'o
senesperiga	sen'esper'ig'a
senesperigas	sen'esper'ig'as
senesperigis	sen'esper'ig'is
senesperigita	sen'esper'ig'it'a
senesperiĝis	sen'esper'iĝ'is
senesperiĝo	sen'esper'iĝ'o
senesprima	sen'esprim'a
senesprimaj	sen'esprim'a'j
senesprime	sen'esprim'e
senevite	sen'evit'e
senfara	sen'far'a
senfare	sen'far'e
senfenestra	sen'fenestr'a
senfina	sen'fin'a
senfinaj	sen'fin'a'j
senfinajn	sen'fin'a'j'n
senfinan	sen'fin'a'n
senfine	sen'fin'e
senfino	sen'fin'o
senfineco	sen'fin'ec'o
senfinecon	sen'fin'ec'o'n
senfoliaj	sen'foli'a'j
senfonta	sen'font'a
senforma	sen'form'a
senformaj	sen'form'a'j
senforman	sen'form'a'n
senforta	sen'fort'a
senfortaj	sen'fort'a'j
senfortan	sen'fort'a'n
senforte	sen'fort'e
senforteco	sen'fort'ec'o
senfortecon	sen'fort'ec'o'n
senfortigis	sen'fort'ig'is
senfortigita	sen'fort'ig'it'a
senfortiĝis	sen'fort'iĝ'is
senfrukta	sen'frukt'a
senfruktaj	sen'frukt'a'j
senfuma	sen'fum'a
senfunda	sen'fund'a
senfundaj	sen'fund'a'j
senfundan	sen'fund'a'n
senglacia	sen'glaci'a
senglaciaj	sen'glaci'a'j
senglutena	sen'gluten'a
sengusta	sen'gust'a
sengustaj	sen'gust'a'j
senĝena	sen'ĝen'a
senĝenaj	sen'ĝen'a'j
senĝenan	sen'ĝen'a'n
senĝene	sen'ĝen'e
senĝeneco	sen'ĝen'ec'o
senĝoja	sen'ĝoj'a
senhalta	sen'halt'a
senhaltan	sen'halt'a'n
senhalte	sen'halt'e
senhara	sen'har'a
senharaj	sen'har'a'j
senhaste	sen'hast'e
senhaŭtigas	sen'haŭt'ig'as
senhava	sen'hav'a
senhavaj	sen'hav'a'j
senhavigas	sen'hav'ig'as
senhavigi	sen'hav'ig'i
senhavigis	sen'hav'ig'is
senhavigante	sen'hav'ig'ant'e
senhavulo	sen'hav'ul'o
senhavuloj	sen'hav'ul'o'j
senhavulojn	sen'hav'ul'o'j'n
senhavena	sen'haven'a
senhejma	sen'hejm'a
senhejmaj	sen'hejm'a'j
senhejmulo	sen'hejm'ul'o
senhejmuloj	sen'hejm'ul'o'j
senhejmulojn	sen'hejm'ul'o'j'n
senhelpa	sen'help'a
senhelpaj	sen'help'a'j
senhelpajn	sen'help'a'j'n
senhelpan	sen'help'a'n
senhelpe	sen'help'e
senhelpeco	sen'help'ec'o
senhezite	sen'hezit'e
senhidratigo	sen'hidrat'ig'o
senhoma	sen'hom'a
senhomaj	sen'hom'a'j
senhomajn	sen'hom'a'j'n
senhoman	sen'hom'a'n
senhomigis	sen'hom'ig'is
senhomigita	sen'hom'ig'it'a
senhomiĝis	sen'hom'iĝ'is
senhonorigis	sen'honor'ig'is
senhonta	sen'hont'a
senhontaj	sen'hont'a'j
senhontan	sen'hont'a'n
senhonte	sen'hont'e
senhonteco	sen'hont'ec'o
senidea	sen'ide'a
senigas	sen'ig'as
senigi	sen'ig'i
senigis	sen'ig'is
senigo	sen'ig'o
senigojn	sen'ig'o'j'n
senigon	sen'ig'o'n
senigos	sen'ig'os
senigu	sen'ig'u
senigado	sen'ig'ad'o
senigante	sen'ig'ant'e
senigata	sen'ig'at'a
senigita	sen'ig'it'a
senigitaj	sen'ig'it'a'j
senigite	sen'ig'it'e
seniĝas	sen'iĝ'as
seniĝi	sen'iĝ'i
seniĝis	sen'iĝ'is
seniluziiga	sen'iluzi'ig'a
seniluziigaj	sen'iluzi'ig'a'j
seniluziigas	sen'iluzi'ig'as
seniluziigi	sen'iluzi'ig'i
seniluziigis	sen'iluzi'ig'is
seniluziigos	sen'iluzi'ig'os
seniluziigita	sen'iluzi'ig'it'a
seniluziigitaj	sen'iluzi'ig'it'a'j
seniluziiĝas	sen'iluzi'iĝ'as
seniluziiĝis	sen'iluzi'iĝ'is
seniluziiĝo	sen'iluzi'iĝ'o
seniluziiĝoj	sen'iluzi'iĝ'o'j
seniluziiĝojn	sen'iluzi'iĝ'o'j'n
seniluziiĝon	sen'iluzi'iĝ'o'n
seniluziiĝinta	sen'iluzi'iĝ'int'a
seniluziita	sen'iluzi'it'a
senimposta	sen'impost'a
senimpostaj	sen'impost'a'j
senindulga	sen'indulg'a
senindulge	sen'indulg'e
seninfana	sen'infan'a
seninfanaj	sen'infan'a'j
senintenca	sen'intenc'a
senintence	sen'intenc'e
seninterrompa	sen'inter'romp'a
seninterrompaj	sen'inter'romp'a'j
seninterrompan	sen'inter'romp'a'n
seninterrompe	sen'inter'romp'e
seninteresa	sen'interes'a
seninteresaj	sen'interes'a'j
senjunta	sen'junt'a
senjuntan	sen'junt'a'n
senjunte	sen'junt'e
senkapa	sen'kap'a
senkapaj	sen'kap'a'j
senkapan	sen'kap'a'n
senkapigas	sen'kap'ig'as
senkapigi	sen'kap'ig'i
senkapigis	sen'kap'ig'is
senkapigo	sen'kap'ig'o
senkapigu	sen'kap'ig'u
senkapigita	sen'kap'ig'it'a
senkapigitaj	sen'kap'ig'it'a'j
senkapabligita	sen'kapabl'ig'it'a
senkarna	sen'karn'a
senkaŝa	sen'kaŝ'a
senkaŝaj	sen'kaŝ'a'j
senkaŝajn	sen'kaŝ'a'j'n
senkaŝan	sen'kaŝ'a'n
senkaŝe	sen'kaŝ'e
senkaŭza	sen'kaŭz'a
senkaŭze	sen'kaŭz'e
senkiala	sen'kial'a
senkiale	sen'kial'e
senklasa	sen'klas'a
senkolora	sen'kolor'a
senkoloraj	sen'kolor'a'j
senkolorajn	sen'kolor'a'j'n
senkoloran	sen'kolor'a'n
senkolore	sen'kolor'e
senkolorigo	sen'kolor'ig'o
senkomente	sen'koment'e
senkompara	sen'kompar'a
senkompare	sen'kompar'e
senkompata	sen'kompat'a
senkompataj	sen'kompat'a'j
senkompatan	sen'kompat'a'n
senkompate	sen'kompat'e
senkomprena	sen'kompren'a
senkomprene	sen'kompren'e
senkompromisa	sen'kompromis'a
senkompromisaj	sen'kompromis'a'j
senkompromisan	sen'kompromis'a'n
senkompromise	sen'kompromis'e
senkondiĉa	sen'kondiĉ'a
senkondiĉaj	sen'kondiĉ'a'j
senkondiĉan	sen'kondiĉ'a'n
senkondiĉe	sen'kondiĉ'e
senkonfesiaj	sen'konfesi'a'j
senkonscia	sen'konsci'a
senkonsciaj	sen'konsci'a'j
senkonscian	sen'konsci'a'n
senkonscie	sen'konsci'e
senkonscieco	sen'konsci'ec'o
senkonsciiĝis	sen'konsci'iĝ'is
senkonsidera	sen'konsider'a
senkonsideraj	sen'konsider'a'j
senkonsidere	sen'konsider'e
senkonsila	sen'konsil'a
senkonsile	sen'konsil'e
senkonsola	sen'konsol'a
senkonstruaĵaj	sen'konstru'aĵ'a'j
senkontesta	sen'kontest'a
senkontestaj	sen'kontest'a'j
senkonteste	sen'kontest'e
senkontrola	sen'kontrol'a
senkora	sen'kor'a
senkoraj	sen'kor'a'j
senkorpa	sen'korp'a
senkorpaj	sen'korp'a'j
senkosta	sen'kost'a
senkostaj	sen'kost'a'j
senkostajn	sen'kost'a'j'n
senkostan	sen'kost'a'n
senkoste	sen'kost'e
senkreditigi	sen'kredit'ig'i
senkritika	sen'kritik'a
senkritike	sen'kritik'e
senkulpa	sen'kulp'a
senkulpaj	sen'kulp'a'j
senkulpajn	sen'kulp'a'j'n
senkulpan	sen'kulp'a'n
senkulpas	sen'kulp'as
senkulpe	sen'kulp'e
senkulpeco	sen'kulp'ec'o
senkulpecon	sen'kulp'ec'o'n
senkulpigas	sen'kulp'ig'as
senkulpigi	sen'kulp'ig'i
senkulpigis	sen'kulp'ig'is
senkulpigo	sen'kulp'ig'o
senkulpigoj	sen'kulp'ig'o'j
senkulpigojn	sen'kulp'ig'o'j'n
senkulpigon	sen'kulp'ig'o'n
senkulpigu	sen'kulp'ig'u
senkulpigita	sen'kulp'ig'it'a
senkulpulo	sen'kulp'ul'o
senkulpuloj	sen'kulp'ul'o'j
senkulpulojn	sen'kulp'ul'o'j'n
senkulpulon	sen'kulp'ul'o'n
senkultura	sen'kultur'a
senkuraĝa	sen'kuraĝ'a
senkuraĝiga	sen'kuraĝ'ig'a
senkuraĝigas	sen'kuraĝ'ig'as
senkuraĝigi	sen'kuraĝ'ig'i
senkuraĝigis	sen'kuraĝ'ig'is
senkuraĝigita	sen'kuraĝ'ig'it'a
senkuraĝiĝas	sen'kuraĝ'iĝ'as
senkuraĝiĝis	sen'kuraĝ'iĝ'is
senkuraĝiĝu	sen'kuraĝ'iĝ'u
senkurentiĝo	sen'kurent'iĝ'o
senkurentiĝoj	sen'kurent'iĝ'o'j
senlabora	sen'labor'a
senlaboraj	sen'labor'a'j
senlaborajn	sen'labor'a'j'n
senlaboreca	sen'labor'ec'a
senlaboreco	sen'labor'ec'o
senlaborecon	sen'labor'ec'o'n
senlaborecoprocento	sen'labor'ec'o'procent'o
senlaborsubteno	sen'labor'sub'ten'o
senlaborulo	sen'labor'ul'o
senlaboruloj	sen'labor'ul'o'j
senlaca	sen'lac'a
senlacaj	sen'lac'a'j
senlacan	sen'lac'a'n
senlace	sen'lac'e
senleĝeco	sen'leĝ'ec'o
senlicenca	sen'licenc'a
senlicencaj	sen'licenc'a'j
senlima	sen'lim'a
senlimaj	sen'lim'a'j
senlimajn	sen'lim'a'j'n
senliman	sen'lim'a'n
senlime	sen'lim'e
senlimeco	sen'lim'ec'o
senlokigitaj	sen'lok'ig'it'a'j
senluma	sen'lum'a
senlumaj	sen'lum'a'j
senluman	sen'lum'a'n
senlume	sen'lum'e
senlumeco	sen'lum'ec'o
senluna	sen'lun'a
senmakula	sen'makul'a
senmakulaj	sen'makul'a'j
senmakulan	sen'makul'a'n
senmakule	sen'makul'e
senmalhelpe	sen'mal'help'e
senmanika	sen'manik'a
senmanka	sen'mank'a
senmanke	sen'mank'e
senmarka	sen'mark'a
senmarkaj	sen'mark'a'j
senmarkajn	sen'mark'a'j'n
senmarkan	sen'mark'a'n
senmarke	sen'mark'e
senmaskigi	sen'mask'ig'i
senmaskigis	sen'mask'ig'is
senmateria	sen'materi'a
senmerita	sen'merit'a
senmerite	sen'merit'e
senmezura	sen'mezur'a
senmezuran	sen'mezur'a'n
senmezure	sen'mezur'e
senmona	sen'mon'a
senmonaj	sen'mon'a'j
senmorala	sen'moral'a
senmoraleco	sen'moral'ec'o
senmorta	sen'mort'a
senmortaj	sen'mort'a'j
senmortan	sen'mort'a'n
senmorteco	sen'mort'ec'o
senmortecon	sen'mort'ec'o'n
senmortuloj	sen'mort'ul'o'j
senmotiva	sen'motiv'a
senmotive	sen'motiv'e
senmova	sen'mov'a
senmovaj	sen'mov'a'j
senmovajn	sen'mov'a'j'n
senmovan	sen'mov'a'n
senmove	sen'mov'e
senmoveco	sen'mov'ec'o
senmovecon	sen'mov'ec'o'n
senmovigi	sen'mov'ig'i
senmovigita	sen'mov'ig'it'a
senmoviĝi	sen'mov'iĝ'i
senmoviĝis	sen'mov'iĝ'is
sennacia	sen'naci'a
sennacieca	sen'naci'ec'a
sennaciecan	sen'naci'ec'a'n
sennacieco	sen'naci'ec'o
sennaciisma	sen'naci'ism'a
sennaciismo	sen'naci'ism'o
sennaciismon	sen'naci'ism'o'n
sennaciisto	sen'naci'ist'o
sennaciistoj	sen'naci'ist'o'j
sennaciulo	sen'naci'ul'o
sennaciuloj	sen'naci'ul'o'j
sennecese	sen'neces'e
sennoma	sen'nom'a
sennomaj	sen'nom'a'j
sennombra	sen'nombr'a
sennombraj	sen'nombr'a'j
sennombrajn	sen'nombr'a'j'n
sennombre	sen'nombr'e
sennombro	sen'nombr'o
sennuanca	sen'nuanc'a
sennuancaj	sen'nuanc'a'j
sennuba	sen'nub'a
senobjekta	sen'objekt'a
senobjektaj	sen'objekt'a'j
senodora	sen'odor'a
senoksigenigita	sen'oksigen'ig'it'a
senokupa	sen'okup'a
senokupaj	sen'okup'a'j
senokupeco	sen'okup'ec'o
senorda	sen'ord'a
senordaj	sen'ord'a'j
senordan	sen'ord'a'n
senorde	sen'ord'e
senornama	sen'ornam'a
senpaca	sen'pac'a
senpacaj	sen'pac'a'j
senpacienca	sen'pacienc'a
senpaciencaj	sen'pacienc'a'j
senpaciencas	sen'pacienc'as
senpacience	sen'pacienc'e
senpaciencis	sen'pacienc'is
senpacienco	sen'pacienc'o
senpaciencon	sen'pacienc'o'n
senpacienciĝis	sen'pacienc'iĝ'is
senpaga	sen'pag'a
senpagaj	sen'pag'a'j
senpagajn	sen'pag'a'j'n
senpagan	sen'pag'a'n
senpage	sen'pag'e
senpageco	sen'pag'ec'o
senparencaj	sen'parenc'a'j
senparola	sen'parol'a
senparole	sen'parol'e
senpartia	sen'parti'a
senpartiaj	sen'parti'a'j
senpartian	sen'parti'a'n
senpartie	sen'parti'e
senpartieco	sen'parti'ec'o
senpasia	sen'pasi'a
senpasie	sen'pasi'e
senpaŭze	sen'paŭz'e
senpavimaj	sen'pavim'a'j
senpeka	sen'pek'a
senpeke	sen'pek'e
senpena	sen'pen'a
senpene	sen'pen'e
senpensa	sen'pens'a
senpense	sen'pens'e
senpera	sen'per'a
senperaj	sen'per'a'j
senperajn	sen'per'a'j'n
senperan	sen'per'a'n
senpere	sen'per'e
senperforta	sen'per'fort'a
senperforto	sen'per'fort'o
senperda	sen'perd'a
senperdaj	sen'perd'a'j
senpermese	sen'permes'e
senpersona	sen'person'a
senperspektiva	sen'perspektiv'a
senpeza	sen'pez'a
senpezeco	sen'pez'ec'o
senpezigi	sen'pez'ig'i
senpilota	sen'pilot'a
senpilotaj	sen'pilot'a'j
senpilotan	sen'pilot'a'n
senpintigita	sen'pint'ig'it'a
senplana	sen'plan'a
senplane	sen'plan'e
senplende	sen'plend'e
senplie	sen'pli'e
senpluma	sen'plum'a
senplumaj	sen'plum'a'j
senpluva	sen'pluv'a
senpluveco	sen'pluv'ec'o
senpolitika	sen'politik'a
senpolvigi	sen'polv'ig'i
senpopoliĝo	sen'popol'iĝ'o
senpotenca	sen'potenc'a
senpotencaj	sen'potenc'a'j
senpotencigi	sen'potenc'ig'i
senpova	sen'pov'a
senpovaj	sen'pov'a'j
senpove	sen'pov'e
senpovo	sen'pov'o
senpovon	sen'pov'o'n
senpoveco	sen'pov'ec'o
senpovecon	sen'pov'ec'o'n
senpovigi	sen'pov'ig'i
senpovigis	sen'pov'ig'is
senpovigita	sen'pov'ig'it'a
senprecedenca	sen'precedenc'a
senprecedencaj	sen'precedenc'a'j
senprecedencajn	sen'precedenc'a'j'n
senprecedencan	sen'precedenc'a'n
senprecedence	sen'precedenc'e
senprepara	sen'prepar'a
senpreparaj	sen'prepar'a'j
senpretenda	sen'pretend'a
senpripensa	sen'pri'pens'a
senpripensan	sen'pri'pens'a'n
senpripense	sen'pri'pens'e
senpripenseco	sen'pri'pens'ec'o
senprivilegiaj	sen'privilegi'a'j
senproblema	sen'problem'a
senproblemaj	sen'problem'a'j
senprobleme	sen'problem'e
senprofita	sen'profit'a
senprofitaj	sen'profit'a'j
senprofite	sen'profit'e
senprokrasta	sen'prokrast'a
senprokraste	sen'prokrast'e
senprotekta	sen'protekt'a
senprotektaj	sen'protekt'a'j
senproteste	sen'protest'e
senprudenta	sen'prudent'a
senpuna	sen'pun'a
senpunaj	sen'pun'a'j
senpune	sen'pun'e
senpuneco	sen'pun'ec'o
senracia	sen'raci'a
senrajta	sen'rajt'a
senrajte	sen'rajt'e
senrajtigitaj	sen'rajt'ig'it'a'j
senrangulo	sen'rang'ul'o
senranguloj	sen'rang'ul'o'j
senrevena	sen're'ven'a
senrevene	sen're'ven'e
senreceptaj	sen'recept'a'j
senrespekta	sen'respekt'a
senrespekte	sen'respekt'e
senresponda	sen'respond'a
senrespondaj	sen'respond'a'j
senrespondeca	sen'respond'ec'a
senrestrikta	sen'restrikt'a
senrestriktan	sen'restrikt'a'n
senreta	sen'ret'a
senretaj	sen'ret'a'j
senrete	sen'ret'e
senrezerva	sen'rezerv'a
senrezerve	sen'rezerv'e
senreziste	sen'rezist'e
senrezulta	sen'rezult'a
senrezultaj	sen'rezult'a'j
senrezulte	sen'rezult'e
senrigarde	sen'rigard'e
senrilata	sen'rilat'a
senrilataj	sen'rilat'a'j
senrilatajn	sen'rilat'a'j'n
senrilate	sen'rilat'e
senripoza	sen'ripoz'a
senripoze	sen'ripoz'e
senriproĉa	sen'riproĉ'a
senriproĉe	sen'riproĉ'e
senriska	sen'risk'a
senriske	sen'risk'e
sensala	sen'sal'a
sensaligi	sen'sal'ig'i
sensaligo	sen'sal'ig'o
sensalajra	sen'salajr'a
sensalajraj	sen'salajr'a'j
sensalajran	sen'salajr'a'n
sensanga	sen'sang'a
sensatelita	sen'satelit'a
senscia	sen'sci'a
sensciaj	sen'sci'a'j
senscie	sen'sci'e
senseksa	sen'seks'a
senseksaj	sen'seks'a'j
sensekse	sen'seks'e
sensekureco	sen'sekur'ec'o
sensemafora	sen'semafor'a
sensenca	sen'senc'a
sensencaj	sen'senc'a'j
sensencajn	sen'senc'a'j'n
sensencan	sen'senc'a'n
sensencas	sen'senc'as
sensence	sen'senc'e
sensencajho	sen'senc'aĵ'o
sensencaĵo	sen'senc'aĵ'o
sensencaĵoj	sen'senc'aĵ'o'j
sensencaĵojn	sen'senc'aĵ'o'j'n
sensencaĵon	sen'senc'aĵ'o'n
sensenceco	sen'senc'ec'o
sensensaĵo	sen'sens'aĵ'o
sensenta	sen'sent'a
sensentaj	sen'sent'a'j
sensignifa	sen'signif'a
sensignifaj	sen'signif'a'j
sensignifajn	sen'signif'a'j'n
sensignifan	sen'signif'a'n
sensignife	sen'signif'e
sensignifeco	sen'signif'ec'o
sensimptoma	sen'simptom'a
sensimptomaj	sen'simptom'a'j
senskrupula	sen'skrupul'a
senskrupulaj	sen'skrupul'a'j
senskrupule	sen'skrupul'e
sensoifigas	sen'soif'ig'as
sensoifigi	sen'soif'ig'i
sensoifigado	sen'soif'ig'ad'o
sensoifigita	sen'soif'ig'it'a
sensona	sen'son'a
sensone	sen'son'e
sensperta	sen'spert'a
senspertaj	sen'spert'a'j
senspira	sen'spir'a
senspire	sen'spir'e
senspirigis	sen'spir'ig'is
senspure	sen'spur'e
senstreĉa	sen'streĉ'a
senstreĉe	sen'streĉ'e
senstreĉiĝas	sen'streĉ'iĝ'as
senstreĉiĝi	sen'streĉ'iĝ'i
senstreĉiĝis	sen'streĉ'iĝ'is
senstruktura	sen'struktur'a
senstrukturaj	sen'struktur'a'j
sensubjekta	sen'subjekt'a
sensuka	sen'suk'a
sensukcesa	sen'sukces'a
sensukcesaj	sen'sukces'a'j
sensukcese	sen'sukces'e
sensuna	sen'sun'a
senŝanceliĝe	sen'ŝancel'iĝ'e
senŝanĝa	sen'ŝanĝ'a
senŝanĝaj	sen'ŝanĝ'a'j
senŝanĝan	sen'ŝanĝ'a'n
senŝanĝe	sen'ŝanĝ'e
senŝargiĝo	sen'ŝarg'iĝ'o
senŝargiĝoj	sen'ŝarg'iĝ'o'j
senŝargiĝon	sen'ŝarg'iĝ'o'n
senŝeligas	sen'ŝel'ig'as
senŝeligi	sen'ŝel'ig'i
senŝeligis	sen'ŝel'ig'is
senŝeligu	sen'ŝel'ig'u
senŝeligado	sen'ŝel'ig'ad'o
senŝeligita	sen'ŝel'ig'it'a
senŝeligitaj	sen'ŝel'ig'it'a'j
senŝirma	sen'ŝirm'a
senŝirmaj	sen'ŝirm'a'j
senŝirmajn	sen'ŝirm'a'j'n
senŝirman	sen'ŝirm'a'n
senŝtupe	sen'ŝtup'e
sentalenta	sen'talent'a
sentaŭga	sen'taŭg'a
sentaŭgaĵo	sen'taŭg'aĵ'o
sentaŭgeco	sen'taŭg'ec'o
sentaŭgulo	sen'taŭg'ul'o
sentaŭguloj	sen'taŭg'ul'o'j
senteme	sen'tem'e
sentempa	sen'temp'a
sentempaj	sen'temp'a'j
senteraj	sen'ter'a'j
sentiga	sen'tig'a
sentigaj	sen'tig'a'j
sentima	sen'tim'a
sentimaj	sen'tim'a'j
sentiman	sen'tim'a'n
sentime	sen'tim'e
sentimeco	sen'tim'ec'o
sentrankvila	sen'trankvil'a
senutila	sen'util'a
senutilaj	sen'util'a'j
senutilajn	sen'util'a'j'n
senutilan	sen'util'a'n
senutilas	sen'util'as
senutile	sen'util'e
senutileco	sen'util'ec'o
senvalidigas	sen'valid'ig'as
senvalora	sen'valor'a
senvaloraj	sen'valor'a'j
senvaloran	sen'valor'a'n
senvalorigas	sen'valor'ig'as
senvalorigi	sen'valor'ig'i
senvaria	sen'vari'a
senvariaj	sen'vari'a'j
senventa	sen'vent'a
senventeco	sen'vent'ec'o
senvertebraj	sen'vertebr'a'j
senvertebruloj	sen'vertebr'ul'o'j
senvertebrulojn	sen'vertebr'ul'o'j'n
senvesta	sen'vest'a
senvestigas	sen'vest'ig'as
senvestigi	sen'vest'ig'i
senvestigis	sen'vest'ig'is
senvestigu	sen'vest'ig'u
senvestigita	sen'vest'ig'it'a
senvestigitaj	sen'vest'ig'it'a'j
senvestiĝi	sen'vest'iĝ'i
senvestiĝis	sen'vest'iĝ'is
senviva	sen'viv'a
senvivaj	sen'viv'a'j
senvivajn	sen'viv'a'j'n
senvivan	sen'viv'a'n
senvive	sen'viv'e
senvivigas	sen'viv'ig'as
senvivigi	sen'viv'ig'i
senvivigis	sen'viv'ig'is
senvivigado	sen'viv'ig'ad'o
senvivigante	sen'viv'ig'ant'e
senvivigita	sen'viv'ig'it'a
senvivigitaj	sen'viv'ig'it'a'j
senvoĉa	sen'voĉ'a
senvoĉaj	sen'voĉ'a'j
senvoĉajn	sen'voĉ'a'j'n
senvoĉan	sen'voĉ'a'n
senvoĉe	sen'voĉ'e
senvoja	sen'voj'a
senvojaj	sen'voj'a'j
senvole	sen'vol'e
senvorta	sen'vort'a
senvorte	sen'vort'e
senvosta	sen'vost'a
senvostaj	sen'vost'a'j
senvualigis	sen'vual'ig'is
senvunda	sen'vund'a
senzorga	sen'zorg'a
senzorgaj	sen'zorg'a'j
senzorgan	sen'zorg'a'n
senzorge	sen'zorg'e
senzorgeco	sen'zorg'ec'o
senzorgemo	sen'zorg'em'o
senata	senat'a
senataj	senat'a'j
senate	senat'e
senato	senat'o
senaton	senat'o'n
senatana	senat'an'a
senatanaj	senat'an'a'j
senatano	senat'an'o
senatanoj	senat'an'o'j
senatanojn	senat'an'o'j'n
senatanon	senat'an'o'n
senatanino	senat'an'in'o
senatelektoj	senat'elekt'o'j
senatokonsulto	senat'o'konsult'o
senatoro	senator'o
senca	senc'a
sencan	senc'a'n
sencas	senc'as
sence	senc'e
senco	senc'o
sencoj	senc'o'j
sencojn	senc'o'j'n
sencon	senc'o'n
senchava	senc'hav'a
senchavaj	senc'hav'a'j
senchavajn	senc'hav'a'j'n
senchavan	senc'hav'a'n
senchavas	senc'hav'as
senchave	senc'hav'e
sencohava	senc'o'hav'a
sencohave	senc'o'hav'e
sencoplena	senc'o'plen'a
sencoplenaj	senc'o'plen'a'j
sencoplene	senc'o'plen'e
sendaj	send'a'j
sendas	send'as
sendi	send'i
sendis	send'is
sendo	send'o
sendon	send'o'n
sendos	send'os
sendu	send'u
sendus	send'us
sendadas	send'ad'as
sendadis	send'ad'is
sendado	send'ad'o
sendadon	send'ad'o'n
sendaĵo	send'aĵ'o
sendaĵoj	send'aĵ'o'j
sendaĵojn	send'aĵ'o'j'n
sendaĵon	send'aĵ'o'n
sendanta	send'ant'a
sendantaj	send'ant'a'j
sendante	send'ant'e
sendanto	send'ant'o
sendata	send'at'a
sendataj	send'at'a'j
sendilo	send'il'o
sendiloj	send'il'o'j
sendinta	send'int'a
sendinte	send'int'e
sendinto	send'int'o
sendintoj	send'int'o'j
sendinton	send'int'o'n
sendita	send'it'a
senditaj	send'it'a'j
senditajn	send'it'a'j'n
senditan	send'it'a'n
sendite	send'it'e
sendito	send'it'o
senditoj	send'it'o'j
senditojn	send'it'o'j'n
senditon	send'it'o'n
sendokostoj	send'o'kost'o'j
sendokostojn	send'o'kost'o'j'n
sendostacia	send'o'staci'a
sendostaciaj	send'o'staci'a'j
sendostaciajn	send'o'staci'a'j'n
sendostacian	send'o'staci'a'n
sendostacio	send'o'staci'o
sendota	send'ot'a
sendotaj	send'ot'a'j
senecio	seneci'o
senegala	senegal'a
senegalaj	senegal'a'j
senegalo	senegal'o
senegalio	senegal'i'o
seneko	senek'o
senila	senil'a
senjoro	senjor'o
senjoroj	senjor'o'j
senjorlando	senjor'land'o
senjorujo	senjor'uj'o
sensa	sens'a
sensaj	sens'a'j
sensajn	sens'a'j'n
sensan	sens'a'n
sensas	sens'as
sense	sens'e
sensi	sens'i
senso	sens'o
sensoj	sens'o'j
sensojn	sens'o'j'n
senson	sens'o'n
sensaĵon	sens'aĵ'o'n
sensebla	sens'ebl'a
sensilo	sens'il'o
sensiloj	sens'il'o'j
sensilojn	sens'il'o'j'n
sensilon	sens'il'o'n
sensorganoj	sens'organ'o'j
sensorganojn	sens'organ'o'j'n
sensaco	sensac'o
sensacoj	sensac'o'j
sensacia	sensaci'a
sensaciaj	sensaci'a'j
sensaciajn	sensaci'a'j'n
sensacian	sensaci'a'n
sensacie	sensaci'e
sensacio	sensaci'o
sensacioj	sensaci'o'j
sensaciojn	sensaci'o'j'n
sensacion	sensaci'o'n
senta	sent'a
sentaj	sent'a'j
sentajn	sent'a'j'n
sentan	sent'a'n
sentas	sent'as
senti	sent'i
sentis	sent'is
sento	sent'o
sentoj	sent'o'j
sentojn	sent'o'j'n
senton	sent'o'n
sentos	sent'os
sentu	sent'u
sentus	sent'us
sentado	sent'ad'o
sentadon	sent'ad'o'n
sentanta	sent'ant'a
sentantaj	sent'ant'a'j
sentante	sent'ant'e
sentata	sent'at'a
sentataj	sent'at'a'j
sentebla	sent'ebl'a
senteblaj	sent'ebl'a'j
senteblan	sent'ebl'a'n
senteblas	sent'ebl'as
senteble	sent'ebl'e
senteblis	sent'ebl'is
sentema	sent'em'a
sentemaj	sent'em'a'j
sentemajn	sent'em'a'j'n
senteman	sent'em'a'n
sentemo	sent'em'o
sentemoj	sent'em'o'j
sentemojn	sent'em'o'j'n
sentemon	sent'em'o'n
sentiga	sent'ig'a
sentigaj	sent'ig'a'j
sentigas	sent'ig'as
sentigi	sent'ig'i
sentigis	sent'ig'is
sentiĝas	sent'iĝ'as
sentiĝi	sent'iĝ'i
sentiĝis	sent'iĝ'is
sentiĝante	sent'iĝ'ant'e
sentinta	sent'int'a
sentita	sent'it'a
sentitaj	sent'it'a'j
sentite	sent'it'e
sentoplena	sent'o'plen'a
sentumo	sent'um'o
sentumoj	sent'um'o'j
sentenco	sentenc'o
sentencoj	sentenc'o'j
sentencojn	sentenc'o'j'n
sentencon	sentenc'o'n
sentimenta	sentiment'a
sentimento	sentiment'o
sentimentoj	sentiment'o'j
sentimentojn	sentiment'o'j'n
sentimenton	sentiment'o'n
sentimentala	sentimental'a
sentimentalaj	sentimental'a'j
sentimentalan	sentimental'a'n
sentimentaleco	sentimental'ec'o
sentimentalecon	sentimental'ec'o'n
sentinelo	sentinel'o
sentineloj	sentinel'o'j
sep	sep
sepa	sep'a
sepaj	sep'a'j
sepan	sep'a'n
sepcent	sep'cent
sepdek	sep'dek
sepdeka	sep'dek'a
sepdekaj	sep'dek'a'j
sepdekjara	sep'dek'jar'a
sepfoje	sep'foj'e
sepjara	sep'jar'a
sepoble	sep'obl'e
sepono	sep'on'o
sepopo	sep'op'o
septaga	sep'tag'a
sepaloj	sepal'o'j
sepalojn	sepal'o'j'n
separas	separ'as
separi	separ'i
separo	separ'o
separado	separ'ad'o
separata	separ'at'a
separataj	separ'at'a'j
separate	separ'at'e
separatisma	separ'at'ism'a
separatismaj	separ'at'ism'a'j
separatismo	separ'at'ism'o
separatistoj	separ'at'ist'o'j
separebla	separ'ebl'a
separeblaj	separ'ebl'a'j
separiĝas	separ'iĝ'as
separisma	separ'ism'a
separismo	separ'ism'o
separistoj	separ'ist'o'j
separita	separ'it'a
separitaj	separ'it'a'j
separitajn	separ'it'a'j'n
sepio	sepi'o
sepsa	seps'a
sepsaj	seps'a'j
sepsajn	seps'a'j'n
sepsan	seps'a'n
sepso	seps'o
septo	sept'o
septakordo	sept'akord'o
septembra	septembr'a
septembre	septembr'e
septembro	septembr'o
septembron	septembr'o'n
septimo	septim'o
septuaginto	septuagint'o
sepulta	sepult'a
sepultaj	sepult'a'j
sepultis	sepult'is
sepulto	sepult'o
sepultado	sepult'ad'o
sepultita	sepult'it'a
sepultitaj	sepult'it'a'j
sera	ser'a
sero	ser'o
serumo	ser'um'o
serafoj	seraf'o'j
serba	serb'a
serbaj	serb'a'j
serbajn	serb'a'j'n
serban	serb'a'n
serbo	serb'o
serboj	serb'o'j
serbojn	serb'o'j'n
serbia	serb'i'a
serbio	serb'i'o
serbion	serb'i'o'n
serbokroata	serb'o'kroat'a
serbokroato	serb'o'kroat'o
serbujo	serb'uj'o
serĉa	serĉ'a
serĉaj	serĉ'a'j
serĉas	serĉ'as
serĉe	serĉ'e
serĉi	serĉ'i
serĉis	serĉ'is
serĉo	serĉ'o
serĉoj	serĉ'o'j
serĉojn	serĉ'o'j'n
serĉon	serĉ'o'n
serĉos	serĉ'os
serĉu	serĉ'u
serĉus	serĉ'us
serĉadas	serĉ'ad'as
serĉadi	serĉ'ad'i
serĉadis	serĉ'ad'is
serĉado	serĉ'ad'o
serĉadoj	serĉ'ad'o'j
serĉadon	serĉ'ad'o'n
serĉanta	serĉ'ant'a
serĉantaj	serĉ'ant'a'j
serĉantajn	serĉ'ant'a'j'n
serĉantan	serĉ'ant'a'n
serĉante	serĉ'ant'e
serĉanto	serĉ'ant'o
serĉantoj	serĉ'ant'o'j
serĉata	serĉ'at'a
serĉataj	serĉ'at'a'j
serĉatan	serĉ'at'a'n
serĉatas	serĉ'at'as
serĉebla	serĉ'ebl'a
serĉilo	serĉ'il'o
serĉiloj	serĉ'il'o'j
serĉilon	serĉ'il'o'n
serĉinte	serĉ'int'e
serĉita	serĉ'it'a
serĉitaj	serĉ'it'a'j
serĉrezultoj	serĉ'rezult'o'j
serĉrezultojn	serĉ'rezult'o'j'n
serĉvortoj	serĉ'vort'o'j
serĉvorton	serĉ'vort'o'n
serena	seren'a
serenaj	seren'a'j
serenan	seren'a'n
serenas	seren'as
serene	seren'e
sereno	seren'o
sereneco	seren'ec'o
serenecon	seren'ec'o'n
sereniĝis	seren'iĝ'is
sergeo	serge'o
sergio	sergi'o
serĝo	serĝ'o
serĝento	serĝent'o
serĝentoj	serĝent'o'j
seria	seri'a
seriaj	seri'a'j
seriajn	seri'a'j'n
serian	seri'a'n
serie	seri'e
serio	seri'o
serioj	seri'o'j
seriojn	seri'o'j'n
serion	seri'o'n
seriaro	seri'ar'o
serialo	serial'o
serialoj	serial'o'j
serifoj	serif'o'j
serino	serin'o
serinoj	serin'o'j
serioza	serioz'a
seriozaj	serioz'a'j
seriozajn	serioz'a'j'n
seriozan	serioz'a'n
seriozas	serioz'as
serioze	serioz'e
seriozis	serioz'is
seriozo	serioz'o
seriozeco	serioz'ec'o
seriozecon	serioz'ec'o'n
serioziĝas	serioz'iĝ'as
serioziĝis	serioz'iĝ'is
serotonino	serotonin'o
serpo	serp'o
serpoj	serp'o'j
serpoĉela	serp'o'ĉel'a
serpenta	serpent'a
serpentaj	serpent'a'j
serpentan	serpent'a'n
serpentas	serpent'as
serpente	serpent'e
serpento	serpent'o
serpentoj	serpent'o'j
serpentojn	serpent'o'j'n
serpenton	serpent'o'n
serpentaglo	serpent'agl'o
serpentidino	serpent'id'in'o
serpentulo	serpent'ul'o
serpentuma	serpent'um'a
serpentumaj	serpent'um'a'j
serpentumas	serpent'um'as
serpentumis	serpent'um'is
serpentumoj	serpent'um'o'j
serpentumanta	serpent'um'ant'a
serpentumante	serpent'um'ant'e
serrano	serran'o
seruro	serur'o
seruroj	serur'o'j
serurojn	serur'o'j'n
seruron	serur'o'n
seruristo	serur'ist'o
serurtruo	serur'tru'o
serva	serv'a
servaj	serv'a'j
servajn	serv'a'j'n
servan	serv'a'n
servas	serv'as
serve	serv'e
servi	serv'i
servis	serv'is
servo	serv'o
servoj	serv'o'j
servojn	serv'o'j'n
servon	serv'o'n
servos	serv'os
servu	serv'u
servus	serv'us
servada	serv'ad'a
servadis	serv'ad'is
servado	serv'ad'o
servadon	serv'ad'o'n
servaĵo	serv'aĵ'o
servaĵoj	serv'aĵ'o'j
servaĵojn	serv'aĵ'o'j'n
servaĵon	serv'aĵ'o'n
servanta	serv'ant'a
servantaj	serv'ant'a'j
servantajn	serv'ant'a'j'n
servantan	serv'ant'a'n
servante	serv'ant'e
servanto	serv'ant'o
servantoj	serv'ant'o'j
servantojn	serv'ant'o'j'n
servanton	serv'ant'o'n
servantino	serv'ant'in'o
servata	serv'at'a
servataj	serv'at'a'j
servejo	serv'ej'o
servejoj	serv'ej'o'j
servema	serv'em'a
serveme	serv'em'e
servigi	serv'ig'i
servila	serv'il'a
servilo	serv'il'o
serviloj	serv'il'o'j
servilojn	serv'il'o'j'n
servilon	serv'il'o'n
servilflanka	serv'il'flank'a
servista	serv'ist'a
servisto	serv'ist'o
servistoj	serv'ist'o'j
servistojn	serv'ist'o'j'n
serviston	serv'ist'o'n
servistaro	serv'ist'ar'o
servistaron	serv'ist'ar'o'n
servistino	serv'ist'in'o
servistinoj	serv'ist'in'o'j
servistinojn	serv'ist'in'o'j'n
servistinon	serv'ist'in'o'n
servita	serv'it'a
servitaj	serv'it'a'j
servite	serv'it'e
servodaŭro	serv'o'daŭr'o
servoindustrio	serv'o'industri'o
servoindustrioj	serv'o'industri'o'j
servopreta	serv'o'pret'a
servosektoro	serv'o'sektor'o
servosoldato	serv'o'soldat'o
servotablo	serv'o'tabl'o
service	servic'e
servico	servic'o
servicoj	servic'o'j
servila	servil'a
serviri	servir'i
serviro	servir'o
serviroj	servir'o'j
servuta	servut'a
servuto	servut'o
servuteco	servut'ec'o
servutulo	servut'ul'o
servutuloj	servut'ul'o'j
servutulojn	servut'ul'o'j'n
ses	ses
sesa	ses'a
sesaj	ses'a'j
sesan	ses'a'n
sescent	ses'cent
sesdek	ses'dek
sese	ses'e
seso	ses'o
seson	ses'o'n
sesaplej	ses'a'plej
sesangula	ses'angul'a
sesangulaj	ses'angul'a'j
sesangulo	ses'angul'o
sesdekaj	ses'dek'a'j
sesdeko	ses'dek'o
sesdekjara	ses'dek'jar'a
sesflanka	ses'flank'a
sesfoje	ses'foj'e
sesfolion	ses'foli'o'n
sesjara	ses'jar'a
sesjaran	ses'jar'a'n
sesjaraĝa	ses'jar'aĝ'a
seslatera	ses'later'a
seslateraj	ses'later'a'j
sesmonata	ses'monat'a
sesono	ses'on'o
sesonon	ses'on'o'n
sesope	ses'op'e
sesopo	ses'op'o
sestaga	ses'tag'a
sesio	sesi'o
sesioj	sesi'o'j
sesiojn	sesi'o'j'n
sesion	sesi'o'n
sesila	sesil'a
sesilaj	sesil'a'j
sesilan	sesil'a'n
seskvikarbonato	seskvi'karbon'at'o
sesto	sest'o
setli	setl'i
setlis	setl'is
setlado	setl'ad'o
setlantoj	setl'ant'o'j
setlantojn	setl'ant'o'j'n
setleja	setl'ej'a
setlejo	setl'ej'o
setlejoj	setl'ej'o'j
setlejojn	setl'ej'o'j'n
setlejon	setl'ej'o'n
setliĝis	setl'iĝ'is
setlintoj	setl'int'o'j
seula	seul'a
seulo	seul'o
severa	sever'a
severaj	sever'a'j
severajn	sever'a'j'n
severan	sever'a'n
severas	sever'as
severe	sever'e
severo	sever'o
severus	sever'us
severeco	sever'ec'o
severecon	sever'ec'o'n
severega	sever'eg'a
sevilo	sevil'o
sezama	sezam'a
sezamo	sezam'o
sezona	sezon'a
sezonaj	sezon'a'j
sezonajn	sezon'a'j'n
sezonan	sezon'a'n
sezone	sezon'e
sezono	sezon'o
sezonoj	sezon'o'j
sezonojn	sezon'o'j'n
sezonon	sezon'o'n
sezoneco	sezon'ec'o
sfera	sfer'a
sferaj	sfer'a'j
sferajn	sfer'a'j'n
sferan	sfer'a'n
sfere	sfer'e
sfero	sfer'o
sferoj	sfer'o'j
sferojn	sfer'o'j'n
sferon	sfer'o'n
sfinkso	sfinks'o
sfinksoj	sfinks'o'j
si	si
sia	si'a
siaj	si'a'j
siajn	si'a'j'n
sian	si'a'n
sin	si'n
siaflanke	si'a'flank'e
siahejme	si'a'hejm'e
siahejmen	si'a'hejm'e'n
siamaniere	si'a'manier'e
siaspeca	si'a'spec'a
siaspecan	si'a'spec'a'n
siaspece	si'a'spec'e
siatempa	si'a'temp'a
siatempaj	si'a'temp'a'j
siatempan	si'a'temp'a'n
siatempe	si'a'temp'e
siavice	si'a'vic'e
sinadministracio	si'n'administraci'o
sinanonco	si'n'anonc'o
sindetenas	si'n'de'ten'as
sindeteni	si'n'de'ten'i
sindetenis	si'n'de'ten'is
sindeteno	si'n'de'ten'o
sindetenon	si'n'de'ten'o'n
sindediĉaj	si'n'dediĉ'a'j
sindediĉo	si'n'dediĉ'o
sindediĉon	si'n'dediĉ'o'n
sindefenda	si'n'defend'a
sindefendo	si'n'defend'o
sindeviga	si'n'dev'ig'a
sindevigo	si'n'dev'ig'o
sindevigon	si'n'dev'ig'o'n
sindona	si'n'don'a
sindonaj	si'n'don'a'j
sindone	si'n'don'e
sindono	si'n'don'o
sindoneco	si'n'don'ec'o
sindonema	si'n'don'em'a
sindonemaj	si'n'don'em'a'j
sindoneme	si'n'don'em'e
sindonemo	si'n'don'em'o
sindonemoj	si'n'don'em'o'j
sindonemon	si'n'don'em'o'n
sinesprimo	si'n'esprim'o
sinesprimado	si'n'esprim'ad'o
sinesprimlibereco	si'n'esprim'liber'ec'o
sinesprimliberecon	si'n'esprim'liber'ec'o'n
sinforgese	si'n'forges'e
singarda	si'n'gard'a
singardaj	si'n'gard'a'j
singardan	si'n'gard'a'n
singarde	si'n'gard'e
singardo	si'n'gard'o
singardon	si'n'gard'o'n
singardema	si'n'gard'em'a
singardemaj	si'n'gard'em'a'j
singardeme	si'n'gard'em'e
singardemo	si'n'gard'em'o
singardemon	si'n'gard'em'o'n
sinĝena	si'n'ĝen'a
sinĝene	si'n'ĝen'e
sinĝenema	si'n'ĝen'em'a
sinkonsekro	si'n'konsekr'o
sinmortiga	si'n'mort'ig'a
sinmortigi	si'n'mort'ig'i
sinmortigis	si'n'mort'ig'is
sinmortigo	si'n'mort'ig'o
sinmortigon	si'n'mort'ig'o'n
sinofera	si'n'ofer'a
sinofere	si'n'ofer'e
sinofero	si'n'ofer'o
sinoferon	si'n'ofer'o'n
sinprezento	si'n'prezent'o
sinprezenton	si'n'prezent'o'n
sinrego	si'n'reg'o
sinregon	si'n'reg'o'n
sinregado	si'n'reg'ad'o
sinregadon	si'n'reg'ad'o'n
sinsekva	si'n'sekv'a
sinsekvaj	si'n'sekv'a'j
sinsekvajn	si'n'sekv'a'j'n
sinsekvan	si'n'sekv'a'n
sinsekvas	si'n'sekv'as
sinsekve	si'n'sekv'e
sinsekvis	si'n'sekv'is
sinsekvo	si'n'sekv'o
sinsekvoj	si'n'sekv'o'j
sinsekvojn	si'n'sekv'o'j'n
sinsekvon	si'n'sekv'o'n
sintenas	si'n'ten'as
sinteni	si'n'ten'i
sintenis	si'n'ten'is
sinteno	si'n'ten'o
sintenoj	si'n'ten'o'j
sintenojn	si'n'ten'o'j'n
sintenon	si'n'ten'o'n
sintenado	si'n'ten'ad'o
sintenadon	si'n'ten'ad'o'n
sintrompo	si'n'tromp'o
sintrudo	si'n'trud'o
sinvestado	si'n'vest'ad'o
sialko	sialk'o
siama	siam'a
siamaj	siam'a'j
siamo	siam'o
siberia	siberi'a
siberiaj	siberi'a'j
siberio	siberi'o
siberion	siberi'o'n
sibilo	sibil'o
sibla	sibl'a
siblas	sibl'as
sibli	sibl'i
siblis	sibl'is
siblo	sibl'o
siblado	sibl'ad'o
sibladon	sibl'ad'o'n
siblante	sibl'ant'e
sicilia	sicili'a
siciliaj	sicili'a'j
sicilian	sicili'a'n
sicilio	sicili'o
sicilion	sicili'o'n
siciliano	sicili'an'o
sicilianoj	sicili'an'o'j
siĉuano	siĉŭan'o
sida	sid'a
sidas	sid'as
side	sid'e
sidi	sid'i
sidis	sid'is
sido	sid'o
sidon	sid'o'n
sidos	sid'os
sidu	sid'u
sidus	sid'us
sidadas	sid'ad'as
sidadi	sid'ad'i
sidadis	sid'ad'is
sidado	sid'ad'o
sidanta	sid'ant'a
sidantaj	sid'ant'a'j
sidantajn	sid'ant'a'j'n
sidantan	sid'ant'a'n
sidante	sid'ant'e
sidanto	sid'ant'o
sidantoj	sid'ant'o'j
sideja	sid'ej'a
sidejo	sid'ej'o
sidejoj	sid'ej'o'j
sidejojn	sid'ej'o'j'n
sidejon	sid'ej'o'n
sidema	sid'em'a
sidemaj	sid'em'a'j
sidiga	sid'ig'a
sidigas	sid'ig'as
sidigi	sid'ig'i
sidigis	sid'ig'is
sidigu	sid'ig'u
sidigado	sid'ig'ad'o
sidigadon	sid'ig'ad'o'n
sidigita	sid'ig'it'a
sidiĝas	sid'iĝ'as
sidiĝi	sid'iĝ'i
sidiĝis	sid'iĝ'is
sidiĝos	sid'iĝ'os
sidiĝu	sid'iĝ'u
sidiĝante	sid'iĝ'ant'e
sidiĝinte	sid'iĝ'int'e
sidilo	sid'il'o
sidilon	sid'il'o'n
sidinta	sid'int'a
sidloko	sid'lok'o
sidlokoj	sid'lok'o'j
sidlokojn	sid'lok'o'j'n
sidlokon	sid'lok'o'n
sidera	sider'a
sieĝas	sieĝ'as
sieĝi	sieĝ'i
sieĝis	sieĝ'is
sieĝo	sieĝ'o
sieĝoj	sieĝ'o'j
sieĝon	sieĝ'o'n
sieĝado	sieĝ'ad'o
sieĝantoj	sieĝ'ant'o'j
sieĝata	sieĝ'at'a
sieĝita	sieĝ'it'a
sieĝitaj	sieĝ'it'a'j
sieĝostato	sieĝ'o'stat'o
sieno	sien'o
sieraleono	sieraleon'o
siestas	siest'as
siesti	siest'i
siestis	siest'is
siesto	siest'o
siestos	siest'os
sifiliso	sifilis'o
sifono	sifon'o
sifonoj	sifon'o'j
sigelas	sigel'as
sigeli	sigel'i
sigelis	sigel'is
sigelo	sigel'o
sigeloj	sigel'o'j
sigelojn	sigel'o'j'n
sigelon	sigel'o'n
sigelado	sigel'ad'o
sigelante	sigel'ant'e
sigelilo	sigel'il'o
sigeliloj	sigel'il'o'j
sigelilon	sigel'il'o'n
sigelita	sigel'it'a
sigelitaj	sigel'it'a'j
sigelitan	sigel'it'a'n
sigismondo	sigismond'o
sigismundo	sigismund'o
siglo	sigl'o
sigloj	sigl'o'j
signa	sign'a
signaj	sign'a'j
signas	sign'as
signe	sign'e
signi	sign'i
signis	sign'is
signo	sign'o
signoj	sign'o'j
signojn	sign'o'j'n
signon	sign'o'n
signado	sign'ad'o
signante	sign'ant'e
signaro	sign'ar'o
signaron	sign'ar'o'n
signata	sign'at'a
signetoj	sign'et'o'j
signita	sign'it'a
signitaj	sign'it'a'j
signitan	sign'it'a'n
signobildo	sign'o'bild'o
signobildoj	sign'o'bild'o'j
signoĉeno	sign'o'ĉen'o
signolingvo	sign'o'lingv'o
signolingvoj	sign'o'lingv'o'j
signolingvojn	sign'o'lingv'o'j'n
signolingvon	sign'o'lingv'o'n
signostango	sign'o'stang'o
signostangoj	sign'o'stang'o'j
signovico	sign'o'vic'o
signala	signal'a
signalaj	signal'a'j
signalas	signal'as
signali	signal'i
signalis	signal'is
signalo	signal'o
signaloj	signal'o'j
signalojn	signal'o'j'n
signalon	signal'o'n
signalos	signal'os
signalado	signal'ad'o
signaladon	signal'ad'o'n
signalanta	signal'ant'a
signalantaj	signal'ant'a'j
signalantan	signal'ant'a'n
signalante	signal'ant'e
signaliloj	signal'il'o'j
signalita	signal'it'a
signalprilaborado	signal'pri'labor'ad'o
signalsendilo	signal'send'il'o
signalsendiloj	signal'send'il'o'j
signalvorto	signal'vort'o
signalvortoj	signal'vort'o'j
signalvortojn	signal'vort'o'j'n
signalvorton	signal'vort'o'n
signaturo	signatur'o
signaturoj	signatur'o'j
signaturojn	signatur'o'j'n
signaturon	signatur'o'n
signifa	signif'a
signifaj	signif'a'j
signifajn	signif'a'j'n
signifan	signif'a'n
signifas	signif'as
signife	signif'e
signifi	signif'i
signifis	signif'is
signifo	signif'o
signifoj	signif'o'j
signifojn	signif'o'j'n
signifon	signif'o'n
signifos	signif'os
signifu	signif'u
signifus	signif'us
signifado	signif'ad'o
signifanta	signif'ant'a
signifantaj	signif'ant'a'j
signifantan	signif'ant'a'n
signifante	signif'ant'e
signifita	signif'it'a
signifitaj	signif'it'a'j
signifoplena	signif'o'plen'a
signifoplenaj	signif'o'plen'a'j
signifoplenajn	signif'o'plen'a'j'n
signifoplenan	signif'o'plen'a'n
signifoplene	signif'o'plen'e
signifikas	signifik'as
siko	sik'o
sikoj	sik'o'j
silo	sil'o
silaba	silab'a
silabaj	silab'a'j
silaban	silab'a'n
silabo	silab'o
silaboj	silab'o'j
silabojn	silab'o'j'n
silabon	silab'o'n
silabaro	silab'ar'o
silabaroj	silab'ar'o'j
silenta	silent'a
silentaj	silent'a'j
silentajn	silent'a'j'n
silentan	silent'a'n
silentas	silent'as
silente	silent'e
silenti	silent'i
silentis	silent'is
silento	silent'o
silentoj	silent'o'j
silenton	silent'o'n
silentos	silent'os
silentu	silent'u
silentus	silent'us
silentadis	silent'ad'is
silentado	silent'ad'o
silentadon	silent'ad'o'n
silentanta	silent'ant'a
silentante	silent'ant'e
silentema	silent'em'a
silentemaj	silent'em'a'j
silenteme	silent'em'e
silentigas	silent'ig'as
silentigi	silent'ig'i
silentigis	silent'ig'is
silentigu	silent'ig'u
silentigita	silent'ig'it'a
silentigitaj	silent'ig'it'a'j
silentiĝas	silent'iĝ'as
silentiĝis	silent'iĝ'is
silentinte	silent'int'e
silezia	silezi'a
sileziaj	silezi'a'j
silezio	silezi'o
silicon	silic'o'n
silicoksido	silic'oksid'o
silicoksidon	silic'oksid'o'n
silicia	silici'a
siliciaj	silici'a'j
silicio	silici'o
silicion	silici'o'n
siliciodioksido	silici'o'di'oksid'o
siliciokarbido	silici'o'karb'id'o
silika	silik'a
siliko	silik'o
silikoj	silik'o'j
silikon	silik'o'n
silikatoj	silikat'o'j
silikatojn	silikat'o'j'n
silikono	silikon'o
silikozo	silikoz'o
silka	silk'a
silkaj	silk'a'j
silkajn	silk'a'j'n
silkan	silk'a'n
silke	silk'e
silko	silk'o
silkoj	silk'o'j
silkojn	silk'o'j'n
silkon	silk'o'n
silkaĵo	silk'aĵ'o
silkaĵoj	silk'aĵ'o'j
silkeca	silk'ec'a
silkecaj	silk'ec'a'j
silkfadeno	silk'faden'o
silkraŭpa	silk'raŭp'a
silkvojo	silk'voj'o
silogismo	silogism'o
silogismoj	silogism'o'j
silueto	siluet'o
siluetoj	siluet'o'j
siluetojn	siluet'o'j'n
silueton	siluet'o'n
silurio	siluri'o
silvano	silvan'o
silvestra	silvestr'a
silvestro	silvestr'o
silvia	silvi'a
silvio	silvi'o
silviedoj	silvi'ed'o'j
simbioza	simbioz'a
simbiozaj	simbioz'a'j
simbiozo	simbioz'o
simbola	simbol'a
simbolaj	simbol'a'j
simbolajn	simbol'a'j'n
simbolan	simbol'a'n
simbolas	simbol'as
simbole	simbol'e
simboli	simbol'i
simbolis	simbol'is
simbolo	simbol'o
simboloj	simbol'o'j
simbolojn	simbol'o'j'n
simbolon	simbol'o'n
simbolanta	simbol'ant'a
simbolantaj	simbol'ant'a'j
simbolante	simbol'ant'e
simbolaro	simbol'ar'o
simboleco	simbol'ec'o
simbolecon	simbol'ec'o'n
simboligas	simbol'ig'as
simboligu	simbol'ig'u
simbolismo	simbol'ism'o
simbolita	simbol'it'a
simeono	simeon'o
simetria	simetri'a
simetriaj	simetri'a'j
simetriajn	simetri'a'j'n
simetrian	simetri'a'n
simetrie	simetri'e
simetrio	simetri'o
simetrioj	simetri'o'j
simetriojn	simetri'o'j'n
simetrion	simetri'o'n
simfonia	simfoni'a
simfoniaj	simfoni'a'j
simfonian	simfoni'a'n
simfonio	simfoni'o
simfonioj	simfoni'o'j
simfoniojn	simfoni'o'j'n
simfonion	simfoni'o'n
simfoniorkestro	simfoni'orkestr'o
simia	simi'a
simian	simi'a'n
simio	simi'o
simioj	simi'o'j
simiojn	simi'o'j'n
simion	simi'o'n
simieto	simi'et'o
simiino	simi'in'o
simiulo	simi'ul'o
simila	simil'a
similaj	simil'a'j
similajn	simil'a'j'n
similan	simil'a'n
similas	simil'as
simile	simil'e
simili	simil'i
similis	simil'is
similo	simil'o
similon	simil'o'n
similos	simil'os
similu	simil'u
similus	simil'us
similaĵo	simil'aĵ'o
similaĵoj	simil'aĵ'o'j
similaĵojn	simil'aĵ'o'j'n
similaĵon	simil'aĵ'o'n
similanta	simil'ant'a
similante	simil'ant'e
similaspektas	simil'aspekt'as
simileco	simil'ec'o
similecoj	simil'ec'o'j
similecojn	simil'ec'o'j'n
similecon	simil'ec'o'n
similigas	simil'ig'as
similigi	simil'ig'i
similigis	simil'ig'is
similigita	simil'ig'it'a
similiĝo	simil'iĝ'o
similita	simil'it'a
similmaniere	simil'manier'e
similmensaj	simil'mens'a'j
similspecaj	simil'spec'a'j
similulo	simil'ul'o
similuloj	simil'ul'o'j
simono	simon'o
simonon	simon'o'n
simone	simone
simonio	simoni'o
simpatia	simpati'a
simpatiaj	simpati'a'j
simpatiajn	simpati'a'j'n
simpatian	simpati'a'n
simpatias	simpati'as
simpatie	simpati'e
simpatii	simpati'i
simpatiis	simpati'is
simpatio	simpati'o
simpatioj	simpati'o'j
simpatiojn	simpati'o'j'n
simpation	simpati'o'n
simpatiantaj	simpati'ant'a'j
simpatianto	simpati'ant'o
simpatiantoj	simpati'ant'o'j
simpatiantojn	simpati'ant'o'j'n
simpla	simpl'a
simplaj	simpl'a'j
simplajn	simpl'a'j'n
simplan	simpl'a'n
simplas	simpl'as
simple	simpl'e
simplo	simpl'o
simplanima	simpl'anim'a
simplanimaj	simpl'anim'a'j
simplanimajn	simpl'anim'a'j'n
simplaniman	simpl'anim'a'n
simpleco	simpl'ec'o
simplecon	simpl'ec'o'n
simpligas	simpl'ig'as
simpligi	simpl'ig'i
simpligis	simpl'ig'is
simpligo	simpl'ig'o
simpligoj	simpl'ig'o'j
simpligon	simpl'ig'o'n
simpligado	simpl'ig'ad'o
simpligante	simpl'ig'ant'e
simpligita	simpl'ig'it'a
simpligitaj	simpl'ig'it'a'j
simpligitajn	simpl'ig'it'a'j'n
simpligitan	simpl'ig'it'a'n
simpligite	simpl'ig'it'e
simpliĝis	simpl'iĝ'is
simplisma	simpl'ism'a
simplismaj	simpl'ism'a'j
simplulo	simpl'ul'o
simpluloj	simpl'ul'o'j
simpozio	simpozi'o
simpozioj	simpozi'o'j
simpoziojn	simpozi'o'j'n
simpozion	simpozi'o'n
simptoma	simptom'a
simptomaj	simptom'a'j
simptomo	simptom'o
simptomoj	simptom'o'j
simptomojn	simptom'o'j'n
simptomon	simptom'o'n
simptomaro	simptom'ar'o
simula	simul'a
simulas	simul'as
simuli	simul'i
simulis	simul'is
simulado	simul'ad'o
simuladoj	simul'ad'o'j
simuladon	simul'ad'o'n
simuladludoj	simul'ad'lud'o'j
simulaĵo	simul'aĵ'o
simulaĵoj	simul'aĵ'o'j
simulaĵojn	simul'aĵ'o'j'n
simulaĵon	simul'aĵ'o'n
simulante	simul'ant'e
simulilo	simul'il'o
simuliloj	simul'il'o'j
simulita	simul'it'a
simulitaj	simul'it'a'j
simultana	simultan'a
sina	sin'a
sinaj	sin'a'j
sinan	sin'a'n
sine	sin'e
sino	sin'o
sinon	sin'o'n
sinagogo	sinagog'o
sinagogoj	sinagog'o'j
sinagogon	sinagog'o'n
sinaja	sinaj'a
sinajo	sinaj'o
sinajo	sinaj'o
sinajon	sinaj'o'n
sinapo	sinap'o
sinapso	sinaps'o
sinapsoj	sinaps'o'j
sincera	sincer'a
sinceraj	sincer'a'j
sincerajn	sincer'a'j'n
sinceran	sincer'a'n
sincere	sincer'e
sincero	sincer'o
sinceron	sincer'o'n
sincerdire	sincer'dir'e
sincereco	sincer'ec'o
sincerecon	sincer'ec'o'n
sindo	sind'o
sindikiĝo	sindik'iĝ'o
sindikata	sindikat'a
sindikataj	sindikat'a'j
sindikatan	sindikat'a'n
sindikato	sindikat'o
sindikatoj	sindikat'o'j
sindikatojn	sindikat'o'j'n
sindikaton	sindikat'o'n
sindikatanoj	sindikat'an'o'j
sindikatestroj	sindikat'estr'o'j
sindikatismo	sindikat'ism'o
sindikatistoj	sindikat'ist'o'j
sindikatmovado	sindikat'mov'ad'o
sindromo	sindrom'o
sindromoj	sindrom'o'j
sindromon	sindrom'o'n
sinedrio	sinedri'o
sinergie	sinergi'e
sinergio	sinergi'o
sinergioj	sinergi'o'j
sinergiojn	sinergi'o'j'n
singapura	singapur'a
singapuro	singapur'o
singapuron	singapur'o'n
singapuranoj	singapur'an'o'j
singulara	singular'a
singularaj	singular'a'j
singularan	singular'a'n
singulare	singular'e
singularo	singular'o
singularon	singular'o'n
singulte	singult'e
singultis	singult'is
singulto	singult'o
sinhala	sinhal'a
sinhalaj	sinhal'a'j
sinhalo	sinhal'o
sinjora	sinjor'a
sinjoro	sinjor'o
sinjoroj	sinjor'o'j
sinjorojn	sinjor'o'j'n
sinjoron	sinjor'o'n
sinjorido	sinjor'id'o
sinjorina	sinjor'in'a
sinjorino	sinjor'in'o
sinjorinoj	sinjor'in'o'j
sinjorinojn	sinjor'in'o'j'n
sinjorinon	sinjor'in'o'n
sinkas	sink'as
sinki	sink'i
sinkis	sink'is
sinko	sink'o
sinkos	sink'os
sinkado	sink'ad'o
sinkanta	sink'ant'a
sinkantaj	sink'ant'a'j
sinkantan	sink'ant'a'n
sinkigis	sink'ig'is
sinkigo	sink'ig'o
sinkita	sink'it'a
sinkopo	sinkop'o
sinkretisma	sinkretism'a
sinkretismo	sinkretism'o
sinkrona	sinkron'a
sinkronaj	sinkron'a'j
sinkronan	sinkron'a'n
sinkrone	sinkron'e
sinkronigas	sinkron'ig'as
sinkronigi	sinkron'ig'i
sinkronigis	sinkron'ig'is
sinkronigo	sinkron'ig'o
sinkronigado	sinkron'ig'ad'o
sinkronigadon	sinkron'ig'ad'o'n
sinkronigita	sinkron'ig'it'a
sinkronigitaj	sinkron'ig'it'a'j
sinkronigitan	sinkron'ig'it'a'n
sinodo	sinod'o
sinodoj	sinod'o'j
sinodon	sinod'o'n
sinonima	sinonim'a
sinonimaj	sinonim'a'j
sinonime	sinonim'e
sinonimo	sinonim'o
sinonimoj	sinonim'o'j
sinonimojn	sinonim'o'j'n
sinonimon	sinonim'o'n
sinonimeco	sinonim'ec'o
sinoptika	sinoptik'a
sinoptikaj	sinoptik'a'j
sinoptikistoj	sinoptik'ist'o'j
sintagmo	sintagm'o
sintagmoj	sintagm'o'j
sintaksa	sintaks'a
sintaksaj	sintaks'a'j
sintaksajn	sintaks'a'j'n
sintaksan	sintaks'a'n
sintakse	sintaks'e
sintakso	sintaks'o
sintakson	sintaks'o'n
sinteza	sintez'a
sintezaj	sintez'a'j
sintezajn	sintez'a'j'n
sintezan	sintez'a'n
sintezas	sintez'as
sinteze	sintez'e
sintezi	sintez'i
sintezis	sintez'is
sintezo	sintez'o
sintezoj	sintez'o'j
sintezon	sintez'o'n
sintezado	sintez'ad'o
sintezante	sintez'ant'e
sintezilo	sintez'il'o
sinteziloj	sintez'il'o'j
sintezilojn	sintez'il'o'j'n
sintezita	sintez'it'a
sintezitaj	sintez'it'a'j
sintri	sintr'i
sintrado	sintr'ad'o
sinua	sinu'a
sinuoj	sinu'o'j
sinuso	sinus'o
sinusoj	sinus'o'j
sinusoido	sinus'oid'o
siono	sion'o
sira	sir'a
sire	sir'e
siro	sir'o
sirakuzo	sirakuz'o
sireno	siren'o
sirenoj	siren'o'j
siria	siri'a
siriaj	siri'a'j
sirian	siri'a'n
sirio	siri'o
sirion	siri'o'n
siriano	siri'an'o
sirianoj	siri'an'o'j
siringo	siring'o
siringoj	siring'o'j
siriuso	sirius'o
siropo	sirop'o
siropon	sirop'o'n
sisma	sism'a
sismaj	sism'a'j
sismajn	sism'a'j'n
sisman	sism'a'n
sismo	sism'o
sismoj	sism'o'j
sismojn	sism'o'j'n
sistema	sistem'a
sistemaj	sistem'a'j
sistemajn	sistem'a'j'n
sisteman	sistem'a'n
sisteme	sistem'e
sistemo	sistem'o
sistemoj	sistem'o'j
sistemojn	sistem'o'j'n
sistemon	sistem'o'n
sistemdezajno	sistem'dezajn'o
sistemeca	sistem'ec'a
sistemevoluo	sistem'evolu'o
sistemfiasko	sistem'fiask'o
sistemigi	sistem'ig'i
sistemigis	sistem'ig'is
sistemigo	sistem'ig'o
sisteminĝenieristiko	sistem'inĝenier'ist'ik'o
sistempostuloj	sistem'postul'o'j
sistematiko	sistematik'o
sistola	sistol'a
sitelo	sitel'o
siteloj	sitel'o'j
sitelojn	sitel'o'j'n
sitelon	sitel'o'n
situa	situ'a
situaj	situ'a'j
situas	situ'as
situi	situ'i
situis	situ'is
situo	situ'o
situoj	situ'o'j
situon	situ'o'n
situos	situ'os
situus	situ'us
situanta	situ'ant'a
situantaj	situ'ant'a'j
situantajn	situ'ant'a'j'n
situantan	situ'ant'a'n
situantas	situ'ant'as
situante	situ'ant'e
situejo	situ'ej'o
situigis	situ'ig'is
situiĝas	situ'iĝ'as
situinta	situ'int'a
situacia	situaci'a
situaciaj	situaci'a'j
situacian	situaci'a'n
situacio	situaci'o
situacioj	situaci'o'j
situaciojn	situaci'o'j'n
situacion	situaci'o'n
situaciista	situaci'ist'a
situaciisto	situaci'ist'o
situaciistoj	situaci'ist'o'j
skabeno	skaben'o
skabenoj	skaben'o'j
skabio	skabi'o
skafaldo	skafald'o
skafaldaro	skafald'ar'o
skafandro	skafandr'o
skafandroj	skafandr'o'j
skafandristoj	skafandr'ist'o'j
skala	skal'a
skalas	skal'as
skali	skal'i
skalis	skal'is
skalo	skal'o
skaloj	skal'o'j
skalon	skal'o'n
skalado	skal'ad'o
skalebla	skal'ebl'a
skaleblo	skal'ebl'o
skaleblon	skal'ebl'o'n
skalita	skal'it'a
skalitaj	skal'it'a'j
skalmodelo	skal'model'o
skalmodeloj	skal'model'o'j
skalara	skalar'a
skalaro	skalar'o
skalaroj	skalar'o'j
skaldo	skald'o
skaldoj	skald'o'j
skalpo	skalp'o
skalpon	skalp'o'n
skana	skan'a
skanas	skan'as
skani	skan'i
skanis	skan'is
skanado	skan'ad'o
skanadoj	skan'ad'o'j
skanadon	skan'ad'o'n
skananta	skan'ant'a
skanante	skan'ant'e
skanilo	skan'il'o
skaniloj	skan'il'o'j
skanita	skan'it'a
skanitaj	skan'it'a'j
skandala	skandal'a
skandalaj	skandal'a'j
skandalan	skandal'a'n
skandale	skandal'e
skandalis	skandal'is
skandalo	skandal'o
skandaloj	skandal'o'j
skandalojn	skandal'o'j'n
skandalon	skandal'o'n
skandalgazeto	skandal'gazet'o
skandio	skandi'o
skandinava	skandinav'a
skandinavaj	skandinav'a'j
skandinavajn	skandinav'a'j'n
skandinavan	skandinav'a'n
skandinavo	skandinav'o
skandinavoj	skandinav'o'j
skandinavia	skandinav'i'a
skandinaviaj	skandinav'i'a'j
skandinavio	skandinav'i'o
skandinavion	skandinav'i'o'n
skapolo	skapol'o
skapoloj	skapol'o'j
skarabo	skarab'o
skaraboj	skarab'o'j
skarabojn	skarab'o'j'n
skarabon	skarab'o'n
skarlata	skarlat'a
skarlataj	skarlat'a'j
skarlatan	skarlat'a'n
skarlato	skarlat'o
skarpo	skarp'o
skarpoj	skarp'o'j
skarpojn	skarp'o'j'n
skarpon	skarp'o'n
skatolo	skatol'o
skatoloj	skatol'o'j
skatolojn	skatol'o'j'n
skatolon	skatol'o'n
skatoleto	skatol'et'o
skatoleton	skatol'et'o'n
skeĉo	skeĉ'o
skeĉoj	skeĉ'o'j
skeĉojn	skeĉ'o'j'n
skeĉon	skeĉ'o'n
skeldo	skeld'o
skeleta	skelet'a
skeletaj	skelet'a'j
skeleto	skelet'o
skeletoj	skelet'o'j
skeletojn	skelet'o'j'n
skeleton	skelet'o'n
skeletmuskolo	skelet'muskol'o
skeletrestaĵoj	skelet'rest'aĵ'o'j
skema	skem'a
skemaj	skem'a'j
skeme	skem'e
skemo	skem'o
skemoj	skem'o'j
skemojn	skem'o'j'n
skemon	skem'o'n
skeptika	skeptik'a
skeptikaj	skeptik'a'j
skeptikan	skeptik'a'n
skeptikas	skeptik'as
skeptike	skeptik'e
skeptiko	skeptik'o
skeptikon	skeptik'o'n
skeptikeco	skeptik'ec'o
skeptikismo	skeptik'ism'o
skeptikulo	skeptik'ul'o
skeptikuloj	skeptik'ul'o'j
skeptikulojn	skeptik'ul'o'j'n
skerco	skerc'o
skermi	skerm'i
skermo	skerm'o
skermado	skerm'ad'o
skermadon	skerm'ad'o'n
skermisto	skerm'ist'o
skermita	skerm'it'a
skias	ski'as
skii	ski'i
skiis	ski'is
skio	ski'o
skioj	ski'o'j
skiojn	ski'o'j'n
skiadi	ski'ad'i
skiadis	ski'ad'is
skiado	ski'ad'o
skiadon	ski'ad'o'n
skianto	ski'ant'o
skiantoj	ski'ant'o'j
skiejo	ski'ej'o
skiejoj	ski'ej'o'j
skiistoj	ski'ist'o'j
skikurado	ski'kur'ad'o
skipa	skip'a
skipo	skip'o
skipoj	skip'o'j
skipojn	skip'o'j'n
skipon	skip'o'n
skipanoj	skip'an'o'j
skipestro	skip'estr'o
skismo	skism'o
skismoj	skism'o'j
skismojn	skism'o'j'n
skismon	skism'o'n
skisto	skist'o
skita	skit'a
skitaj	skit'a'j
skitoj	skit'o'j
skitio	skit'i'o
skiza	skiz'a
skizaj	skiz'a'j
skizan	skiz'a'n
skizas	skiz'as
skize	skiz'e
skizi	skiz'i
skizis	skiz'is
skizo	skiz'o
skizoj	skiz'o'j
skizojn	skiz'o'j'n
skizon	skiz'o'n
skizado	skiz'ad'o
skizante	skiz'ant'e
skizita	skiz'it'a
skizitaj	skiz'it'a'j
skizitajn	skiz'it'a'j'n
skizite	skiz'it'e
skizofrenia	skizofreni'a
skizofreniaj	skizofreni'a'j
skizofrenio	skizofreni'o
skizofrenion	skizofreni'o'n
sklava	sklav'a
sklavaj	sklav'a'j
sklavan	sklav'a'n
sklave	sklav'e
sklavi	sklav'i
sklavo	sklav'o
sklavoj	sklav'o'j
sklavojn	sklav'o'j'n
sklavon	sklav'o'n
sklaveca	sklav'ec'a
sklaveco	sklav'ec'o
sklavecon	sklav'ec'o'n
sklavigas	sklav'ig'as
sklavigi	sklav'ig'i
sklavigis	sklav'ig'is
sklavigo	sklav'ig'o
sklavigon	sklav'ig'o'n
sklavigos	sklav'ig'os
sklavigita	sklav'ig'it'a
sklavigitaj	sklav'ig'it'a'j
sklavino	sklav'in'o
sklavinoj	sklav'in'o'j
sklavinojn	sklav'in'o'j'n
sklavinon	sklav'in'o'n
sklavismo	sklav'ism'o
sklavkomerco	sklav'komerc'o
sklavlaboro	sklav'labor'o
sklavposedantoj	sklav'posed'ant'o'j
sklera	skler'a
sklero	skler'o
sklerozo	skler'oz'o
skolo	skol'o
skoloj	skol'o'j
skolojn	skol'o'j'n
skolon	skol'o'n
skolastika	skolastik'a
skolastikaj	skolastik'a'j
skolastiko	skolastik'o
skolastikismo	skolastik'ism'o
skolastikuloj	skolastik'ul'o'j
skoldas	skold'as
skoldis	skold'is
skolta	skolt'a
skoltaj	skolt'a'j
skolto	skolt'o
skoltoj	skolt'o'j
skoltojn	skolt'o'j'n
skoltado	skolt'ad'o
skoltismo	skolt'ism'o
skoltismon	skolt'ism'o'n
skombro	skombr'o
skorbuto	skorbut'o
skorio	skori'o
skorion	skori'o'n
skorpio	skorpi'o
skorpioj	skorpi'o'j
skota	skot'a
skotaj	skot'a'j
skotajn	skot'a'j'n
skotan	skot'a'n
skoto	skot'o
skotoj	skot'o'j
skotio	skot'i'o
skotlanda	skot'land'a
skotlando	skot'land'o
skotlandon	skot'land'o'n
skotujo	skot'uj'o
skotviskio	skot'viski'o
skotero	skoter'o
skoteroj	skoter'o'j
skrapas	skrap'as
skrapi	skrap'i
skrapis	skrap'is
skrapado	skrap'ad'o
skrapaĵo	skrap'aĵ'o
skrapgumo	skrap'gum'o
skrapilo	skrap'il'o
skrapiloj	skrap'il'o'j
skrapita	skrap'it'a
skrapitaj	skrap'it'a'j
skriba	skrib'a
skribaj	skrib'a'j
skribajn	skrib'a'j'n
skriban	skrib'a'n
skribas	skrib'as
skribe	skrib'e
skribi	skrib'i
skribis	skrib'is
skribo	skrib'o
skriboj	skrib'o'j
skribojn	skrib'o'j'n
skribon	skrib'o'n
skribos	skrib'os
skribu	skrib'u
skribus	skrib'us
skribaĉas	skrib'aĉ'as
skribaĉi	skrib'aĉ'i
skribaĉis	skrib'aĉ'is
skribadas	skrib'ad'as
skribadis	skrib'ad'is
skribado	skrib'ad'o
skribadon	skrib'ad'o'n
skribaĵo	skrib'aĵ'o
skribaĵoj	skrib'aĵ'o'j
skribaĵojn	skrib'aĵ'o'j'n
skribaĵon	skrib'aĵ'o'n
skribanta	skrib'ant'a
skribantaj	skrib'ant'a'j
skribantas	skrib'ant'as
skribante	skrib'ant'e
skribanto	skrib'ant'o
skribantoj	skrib'ant'o'j
skribarto	skrib'art'o
skribata	skrib'at'a
skribataj	skrib'at'a'j
skribebla	skrib'ebl'a
skribigis	skrib'ig'is
skribiĝas	skrib'iĝ'as
skribiĝis	skrib'iĝ'is
skribilo	skrib'il'o
skribiloj	skrib'il'o'j
skribilojn	skrib'il'o'j'n
skribilon	skrib'il'o'n
skribilaro	skrib'il'ar'o
skribinta	skrib'int'a
skribinte	skrib'int'e
skribinto	skrib'int'o
skribista	skrib'ist'a
skribisto	skrib'ist'o
skribistoj	skrib'ist'o'j
skribistojn	skrib'ist'o'j'n
skribita	skrib'it'a
skribitaj	skrib'it'a'j
skribitajn	skrib'it'a'j'n
skribitan	skrib'it'a'n
skribite	skrib'it'e
skribitaĵoj	skrib'it'aĵ'o'j
skriblingvo	skrib'lingv'o
skriblingvon	skrib'lingv'o'n
skribmaniero	skrib'manier'o
skribmanieroj	skrib'manier'o'j
skribmanierojn	skrib'manier'o'j'n
skribmanieron	skrib'manier'o'n
skribmaŝino	skrib'maŝin'o
skribmaŝinon	skrib'maŝin'o'n
skribolingvo	skrib'o'lingv'o
skribotabla	skrib'o'tabl'a
skribotablo	skrib'o'tabl'o
skribotabloj	skrib'o'tabl'o'j
skribotablon	skrib'o'tabl'o'n
skribonta	skrib'ont'a
skribplumo	skrib'plum'o
skribsignoj	skrib'sign'o'j
skribsistemo	skrib'sistem'o
skribsistemoj	skrib'sistem'o'j
skribsistemojn	skrib'sistem'o'j'n
skribsistemon	skrib'sistem'o'n
skribstilo	skrib'stil'o
skribtabla	skrib'tabl'a
skribtablaj	skrib'tabl'a'j
skribtablo	skrib'tabl'o
skribtablon	skrib'tabl'o'n
skribtabulo	skrib'tabul'o
skripto	skript'o
skriptoj	skript'o'j
skriptlingvo	skript'lingv'o
skrupula	skrupul'a
skrupule	skrupul'e
skrupulo	skrupul'o
skrupuloj	skrupul'o'j
skrupulojn	skrupul'o'j'n
skua	sku'a
skuaj	sku'a'j
skuas	sku'as
skue	sku'e
skui	sku'i
skuis	sku'is
skuo	sku'o
skuoj	sku'o'j
skuon	sku'o'n
skuos	sku'os
skuu	sku'u
skuadis	sku'ad'is
skuado	sku'ad'o
skuadon	sku'ad'o'n
skuanta	sku'ant'a
skuante	sku'ant'e
skuata	sku'at'a
skuetis	sku'et'is
skuiĝas	sku'iĝ'as
skuiĝis	sku'iĝ'is
skuiĝo	sku'iĝ'o
skuita	sku'it'a
skuitaj	sku'it'a'j
skulpta	skulpt'a
skulptaj	skulpt'a'j
skulptas	skulpt'as
skulpti	skulpt'i
skulptis	skulpt'is
skulptado	skulpt'ad'o
skulptadon	skulpt'ad'o'n
skulptaĵo	skulpt'aĵ'o
skulptaĵoj	skulpt'aĵ'o'j
skulptaĵojn	skulpt'aĵ'o'j'n
skulptaĵon	skulpt'aĵ'o'n
skulptarto	skulpt'art'o
skulptisto	skulpt'ist'o
skulptistoj	skulpt'ist'o'j
skulptiston	skulpt'ist'o'n
skulptita	skulpt'it'a
skulptitaj	skulpt'it'a'j
skulpturo	skulptur'o
skuno	skun'o
skurĝis	skurĝ'is
skurĝo	skurĝ'o
skurĝado	skurĝ'ad'o
skurĝita	skurĝ'it'a
skute	skut'e
skuti	skut'i
skvama	skvam'a
skvamaj	skvam'a'j
skvamoj	skvam'o'j
skvamojn	skvam'o'j'n
skvameca	skvam'ec'a
skvamecaj	skvam'ec'a'j
skvaŝo	skvaŝ'o
skvaŝon	skvaŝ'o'n
slabo	slab'o
slaboj	slab'o'j
slabon	slab'o'n
slanga	slang'a
slange	slang'e
slango	slang'o
slangon	slang'o'n
slangaĵo	slang'aĵ'o
slava	slav'a
slavaj	slav'a'j
slavajn	slav'a'j'n
slavan	slav'a'n
slave	slav'e
slavo	slav'o
slavoj	slav'o'j
slavojn	slav'o'j'n
slavona	slavon'a
slavonio	slavoni'o
sledo	sled'o
sledoj	sled'o'j
sledojn	sled'o'j'n
sledon	sled'o'n
sledeto	sled'et'o
slipo	slip'o
slipoj	slip'o'j
slipojn	slip'o'j'n
slipon	slip'o'n
sliparo	slip'ar'o
slogano	slogan'o
sloganoj	slogan'o'j
sloganojn	slogan'o'j'n
sloganon	slogan'o'n
slovaka	slovak'a
slovakaj	slovak'a'j
slovakan	slovak'a'n
slovako	slovak'o
slovakoj	slovak'o'j
slovakia	slovak'i'a
slovakio	slovak'i'o
slovakion	slovak'i'o'n
slovakujo	slovak'uj'o
slovena	sloven'a
slovenaj	sloven'a'j
slovenan	sloven'a'n
slovene	sloven'e
sloveno	sloven'o
slovenoj	sloven'o'j
slovenio	sloven'i'o
smeralda	smerald'a
smeraldaj	smerald'a'j
smeraldan	smerald'a'n
smeraldo	smerald'o
smeraldoj	smerald'o'j
smeraldojn	smerald'o'j'n
snoba	snob'a
snobo	snob'o
snufis	snuf'is
sobra	sobr'a
sobraj	sobr'a'j
sobran	sobr'a'n
sobre	sobr'e
sobreco	sobr'ec'o
socia	soci'a
sociaj	soci'a'j
sociajn	soci'a'j'n
socian	soci'a'n
socie	soci'e
socio	soci'o
socioj	soci'o'j
sociojn	soci'o'j'n
socion	soci'o'n
socianoj	soci'an'o'j
socianiĝo	soci'an'iĝ'o
sociareta	soci'ar'et'a
sociekonomia	soci'ekonomi'a
sociekonomiaj	soci'ekonomi'a'j
sociekonomian	soci'ekonomi'a'n
sociekonomika	soci'ekonomik'a
sociekonomikaj	soci'ekonomik'a'j
sociekonomikajn	soci'ekonomik'a'j'n
sociekonomikan	soci'ekonomik'a'n
sociema	soci'em'a
sociemaj	soci'em'a'j
sociemo	soci'em'o
socigarantia	soci'garanti'a
socihistorio	soci'histori'o
socikontrolo	soci'kontrol'o
socikritikaj	soci'kritik'a'j
socikultura	soci'kultur'a
socikulturaj	soci'kultur'a'j
socikulturan	soci'kultur'a'n
socilingvistika	soci'lingv'ist'ik'a
socilingvistikaj	soci'lingv'ist'ik'a'j
socilingvistiko	soci'lingv'ist'ik'o
sociolingvistiko	soci'o'lingv'ist'ik'o
socioscienco	soci'o'scienc'o
sociosciencoj	soci'o'scienc'o'j
sociologo	soci'olog'o
sociologoj	soci'olog'o'j
sociologia	soci'olog'i'a
sociologiaj	soci'olog'i'a'j
sociologiajn	soci'olog'i'a'j'n
sociologian	soci'olog'i'a'n
sociologie	soci'olog'i'e
sociologio	soci'olog'i'o
sociologion	soci'olog'i'o'n
sociordo	soci'ord'o
sociordon	soci'ord'o'n
socipolitika	soci'politik'a
socipolitikaj	soci'politik'a'j
socipolitikajn	soci'politik'a'j'n
socirondoj	soci'rond'o'j
sociscienca	soci'scienc'a
sociservoj	soci'serv'o'j
socisistemoj	soci'sistem'o'j
socitavolo	soci'tavol'o
socitavoloj	soci'tavol'o'j
sociteknika	soci'teknik'a
sociteorio	soci'teori'o
sociutila	soci'util'a
sociutilaj	soci'util'a'j
sociala	social'a
socialaj	social'a'j
socialajn	social'a'j'n
socialan	social'a'n
sociale	social'e
socialaferoj	social'afer'o'j
socialaferojn	social'afer'o'j'n
socialasekuro	social'asekur'o
socialdarvinismo	social'darvin'ism'o
socialdemokrata	social'demokrat'a
socialdemokrataj	social'demokrat'a'j
socialdemokrato	social'demokrat'o
socialdemokratoj	social'demokrat'o'j
socialdemokratojn	social'demokrat'o'j'n
socialdemokratia	social'demokrat'i'a
socialdemokratio	social'demokrat'i'o
socialhelpantoj	social'help'ant'o'j
socialigo	social'ig'o
socialisma	social'ism'a
socialismaj	social'ism'a'j
socialismajn	social'ism'a'j'n
socialisman	social'ism'a'n
socialismo	social'ism'o
socialismon	social'ism'o'n
socialista	social'ist'a
socialistaj	social'ist'a'j
socialistan	social'ist'a'n
socialisto	social'ist'o
socialistoj	social'ist'o'j
socialistojn	social'ist'o'j'n
socialkontrakto	social'kontrakt'o
socialservo	social'serv'o
socialŝanĝo	social'ŝanĝ'o
socialŝanĝoj	social'ŝanĝ'o'j
societa	societ'a
societaj	societ'a'j
societan	societ'a'n
societo	societ'o
societoj	societ'o'j
societojn	societ'o'j'n
societon	societ'o'n
societanoj	societ'an'o'j
societema	societ'em'a
societemaj	societ'em'a'j
societemo	societ'em'o
societumi	societ'um'i
sodo	sod'o
sodakvo	sod'akv'o
sodomii	sodomi'i
sodomio	sodomi'o
sofo	sof'o
sofoj	sof'o'j
sofon	sof'o'n
sofia	sofi'a
sofio	sofi'o
sofismo	sofism'o
sofistoj	sofist'o'j
sofistika	sofist'ik'a
sofistikaj	sofist'ik'a'j
sofistikajn	sofist'ik'a'j'n
sofistikan	sofist'ik'a'n
sofistikeco	sofist'ik'ec'o
soforo	sofor'o
softa	soft'a
softe	soft'e
softbalo	softbal'o
softvara	softvar'a
softvaraj	softvar'a'j
softvarajn	softvar'a'j'n
softvaran	softvar'a'n
softvare	softvar'e
softvaro	softvar'o
softvaroj	softvar'o'j
softvarojn	softvar'o'j'n
softvaron	softvar'o'n
softvaraĵo	softvar'aĵ'o
softvaraĵoj	softvar'aĵ'o'j
softvararkitekturo	softvar'arkitektur'o
softvardezajno	softvar'dezajn'o
softvarigo	softvar'ig'o
softvariloj	softvar'il'o'j
softvaristoj	softvar'ist'o'j
softvarprojektoj	softvar'projekt'o'j
softvarsistemo	softvar'sistem'o
softvarsistemoj	softvar'sistem'o'j
soifa	soif'a
soifaj	soif'a'j
soifas	soif'as
soifis	soif'is
soifo	soif'o
soifon	soif'o'n
soifos	soif'os
soifanta	soif'ant'a
soja	soj'a
sojo	soj'o
sojon	soj'o'n
sojfaba	soj'fab'a
sojfabo	soj'fab'o
sojfaboj	soj'fab'o'j
sojfabojn	soj'fab'o'j'n
sojlakto	soj'lakt'o
sojoleo	soj'ole'o
sojsaŭco	soj'saŭc'o
sojla	sojl'a
sojlan	sojl'a'n
sojle	sojl'e
sojlo	sojl'o
sojloj	sojl'o'j
sojlojn	sojl'o'j'n
sojlon	sojl'o'n
soka	sok'a
soko	sok'o
soklo	sokl'o
sokloj	sokl'o'j
soklon	sokl'o'n
sokrata	sokrat'a
sokrato	sokrat'o
sokraton	sokrat'o'n
sola	sol'a
solaj	sol'a'j
solajn	sol'a'j'n
solan	sol'a'n
solas	sol'as
sole	sol'e
soli	sol'i
solis	sol'is
solo	sol'o
solon	sol'o'n
soleca	sol'ec'a
solecaj	sol'ec'a'j
solecan	sol'ec'a'n
solece	sol'ec'e
soleco	sol'ec'o
solecon	sol'ec'o'n
solema	sol'em'a
solemaj	sol'em'a'j
solemulo	sol'em'ul'o
solflanka	sol'flank'a
solinfano	sol'infan'o
solinfanoj	sol'infan'o'j
solisto	sol'ist'o
solistoj	sol'ist'o'j
solluda	sol'lud'a
solludaj	sol'lud'a'j
solludajn	sol'lud'a'j'n
solludo	sol'lud'o
solula	sol'ul'a
solulo	sol'ul'o
soluloj	sol'ul'o'j
solana	solan'a
solano	solan'o
solanacoj	solan'ac'o'j
soldulo	sold'ul'o
solduloj	sold'ul'o'j
soldulojn	sold'ul'o'j'n
soldata	soldat'a
soldataj	soldat'a'j
soldatajn	soldat'a'j'n
soldatan	soldat'a'n
soldato	soldat'o
soldatoj	soldat'o'j
soldatojn	soldat'o'j'n
soldaton	soldat'o'n
soldataro	soldat'ar'o
soldataroj	soldat'ar'o'j
soldataron	soldat'ar'o'n
soldateduko	soldat'eduk'o
soldatiĝi	soldat'iĝ'i
soldatiĝis	soldat'iĝ'is
soldatinoj	soldat'in'o'j
soldatloĝejo	soldat'loĝ'ej'o
soldatservis	soldat'serv'is
soldatservo	soldat'serv'o
soldatservantoj	soldat'serv'ant'o'j
solena	solen'a
solenaj	solen'a'j
solenajn	solen'a'j'n
solenan	solen'a'n
solenas	solen'as
solene	solen'e
soleni	solen'i
solenis	solen'is
soleno	solen'o
solenoj	solen'o'j
solenon	solen'o'n
solenado	solen'ad'o
solenaĵo	solen'aĵ'o
solenaĵoj	solen'aĵ'o'j
solenaĵon	solen'aĵ'o'n
soleneco	solen'ec'o
solenoido	solenoid'o
solida	solid'a
solidaj	solid'a'j
solidajn	solid'a'j'n
solidan	solid'a'n
solide	solid'e
solido	solid'o
solidoj	solid'o'j
solidojn	solid'o'j'n
solidon	solid'o'n
solidaĵo	solid'aĵ'o
solideco	solid'ec'o
solidecon	solid'ec'o'n
solidigi	solid'ig'i
solidigis	solid'ig'is
solidigita	solid'ig'it'a
solidiĝas	solid'iĝ'as
solidiĝi	solid'iĝ'i
solidiĝis	solid'iĝ'is
solidiĝo	solid'iĝ'o
solidrubo	solid'rub'o
solidsolviĝon	solid'solv'iĝ'o'n
solidstata	solid'stat'a
solidsubstanca	solid'substanc'a
solidsubstancaj	solid'substanc'a'j
solidara	solidar'a
solidaraj	solidar'a'j
solidare	solidar'e
solidaro	solidar'o
solidareca	solidar'ec'a
solidarecan	solidar'ec'a'n
solidareco	solidar'ec'o
solidarecon	solidar'ec'o'n
soloo	solo'o
solooj	solo'o'j
soloon	solo'o'n
soloisto	solo'ist'o
soloistoj	solo'ist'o'j
solono	solon'o
soloturno	soloturn'o
solstico	solstic'o
solvas	solv'as
solvi	solv'i
solvis	solv'is
solvo	solv'o
solvoj	solv'o'j
solvojn	solv'o'j'n
solvon	solv'o'n
solvos	solv'os
solvu	solv'u
solvus	solv'us
solvado	solv'ad'o
solvadon	solv'ad'o'n
solvaĵo	solv'aĵ'o
solvaĵoj	solv'aĵ'o'j
solvaĵojn	solv'aĵ'o'j'n
solvaĵon	solv'aĵ'o'n
solvanta	solv'ant'a
solvante	solv'ant'e
solvanto	solv'ant'o
solvantoj	solv'ant'o'j
solvata	solv'at'a
solvataj	solv'at'a'j
solvebla	solv'ebl'a
solveblaj	solv'ebl'a'j
solveblajn	solv'ebl'a'j'n
solveblan	solv'ebl'a'n
solveblas	solv'ebl'as
solvebleco	solv'ebl'ec'o
solveblecon	solv'ebl'ec'o'n
solvenda	solv'end'a
solvendaj	solv'end'a'j
solviĝas	solv'iĝ'as
solviĝi	solv'iĝ'i
solviĝis	solv'iĝ'is
solviĝos	solv'iĝ'os
solvilo	solv'il'o
solviloj	solv'il'o'j
solvilojn	solv'il'o'j'n
solvinta	solv'int'a
solvita	solv'it'a
solvitaj	solv'it'a'j
solvoproponoj	solv'o'propon'o'j
solventa	solvent'a
solventaj	solvent'a'j
sombra	sombr'a
sombraj	sombr'a'j
sombre	sombr'e
somera	somer'a
someraj	somer'a'j
somerajn	somer'a'j'n
someran	somer'a'n
somere	somer'e
somero	somer'o
someroj	somer'o'j
somerojn	somer'o'j'n
someron	somer'o'n
somerdomo	somer'dom'o
somerferioj	somer'feri'o'j
somerferiojn	somer'feri'o'j'n
somerkomenco	somer'komenc'o
somermeza	somer'mez'a
somermezo	somer'mez'o
somermonatoj	somer'monat'o'j
somersezono	somer'sezon'o
someruma	somer'um'a
somerumado	somer'um'ad'o
somerumejo	somer'um'ej'o
sona	son'a
sonaj	son'a'j
sonan	son'a'n
sonas	son'as
sone	son'e
soni	son'i
sonis	son'is
sono	son'o
sonoj	son'o'j
sonojn	son'o'j'n
sonon	son'o'n
sonos	son'os
sonu	son'u
sonus	son'us
sonadis	son'ad'is
sonado	son'ad'o
sonadon	son'ad'o'n
sonanta	son'ant'a
sonantaj	son'ant'a'j
sonante	son'ant'e
sonaro	son'ar'o
sonaroj	son'ar'o'j
sonaron	son'ar'o'n
sonartikolo	son'artikol'o
sonartikoloj	son'artikol'o'j
sonartikolojn	son'artikol'o'j'n
sonartikolon	son'artikol'o'n
sonata	son'at'a
sonato	son'at'o
sonatoj	son'at'o'j
sonaton	son'at'o'n
sonbendo	son'bend'o
sonbendoj	son'bend'o'j
sonbendojn	son'bend'o'j'n
sonbendon	son'bend'o'n
sondiskoj	son'disk'o'j
sondiskojn	son'disk'o'j'n
sondokumentoj	son'dokument'o'j
sondosiero	son'dosier'o
sondosieroj	son'dosier'o'j
sondosierojn	son'dosier'o'j'n
sonefekto	son'efekt'o
sonefektoj	son'efekt'o'j
sonefektojn	son'efekt'o'j'n
soneto	son'et'o
sonetoj	son'et'o'j
sonetojn	son'et'o'j'n
soneton	son'et'o'n
sonfilmo	son'film'o
sonfonto	son'font'o
sonigas	son'ig'as
sonigi	son'ig'i
sonigis	son'ig'is
sonimitoj	son'imit'o'j
sonkasedo	son'kased'o
sonkasedoj	son'kased'o'j
sonkesto	son'kest'o
sonkoloro	son'kolor'o
sonkoloroj	son'kolor'o'j
sonkoloron	son'kolor'o'n
sonkvalito	son'kvalit'o
sonkvaliton	son'kvalit'o'n
sonlibro	son'libr'o
sonlibroj	son'libr'o'j
sononda	son'ond'a
sonondaj	son'ond'a'j
sonondo	son'ond'o
sonondoj	son'ond'o'j
sonondojn	son'ond'o'j'n
sonpremo	son'prem'o
sonregistris	son'registr'is
sonregistrado	son'registr'ad'o
sonregistraĵo	son'registr'aĵ'o
sonregistraĵoj	son'registr'aĵ'o'j
sonregistraĵojn	son'registr'aĵ'o'j'n
sonregistrilo	son'registr'il'o
sonsignalo	son'signal'o
sonsignaloj	son'signal'o'j
sonsistemo	son'sistem'o
sonspuro	son'spur'o
sonspurojn	son'spur'o'j'n
sontrako	son'trak'o
sonata	sonat'a
sonato	sonat'o
sonatoj	sonat'o'j
sonaton	sonat'o'n
sonda	sond'a
sondaj	sond'a'j
sondas	sond'as
sondi	sond'i
sondis	sond'is
sondo	sond'o
sondoj	sond'o'j
sondado	sond'ad'o
sondilo	sond'il'o
sondiloj	sond'il'o'j
soneto	sonet'o
sonetoj	sonet'o'j
sonetojn	sonet'o'j'n
soneton	sonet'o'n
sonĝa	sonĝ'a
sonĝas	sonĝ'as
sonĝe	sonĝ'e
sonĝi	sonĝ'i
sonĝis	sonĝ'is
sonĝo	sonĝ'o
sonĝoj	sonĝ'o'j
sonĝojn	sonĝ'o'j'n
sonĝon	sonĝ'o'n
sonĝu	sonĝ'u
sonĝaĉas	sonĝ'aĉ'as
sonĝaĉis	sonĝ'aĉ'is
sonĝaĉos	sonĝ'aĉ'os
sonĝado	sonĝ'ad'o
sonĝanta	sonĝ'ant'a
sonĝante	sonĝ'ant'e
sonja	sonj'a
sonjo	sonj'o
sonora	sonor'a
sonoraj	sonor'a'j
sonoran	sonor'a'n
sonoras	sonor'as
sonore	sonor'e
sonori	sonor'i
sonoris	sonor'is
sonoro	sonor'o
sonoron	sonor'o'n
sonoru	sonor'u
sonoradis	sonor'ad'is
sonorado	sonor'ad'o
sonoradon	sonor'ad'o'n
sonoranta	sonor'ant'a
sonoranto	sonor'ant'o
sonorantoj	sonor'ant'o'j
sonoreco	sonor'ec'o
sonoregas	sonor'eg'as
sonoregi	sonor'eg'i
sonoregis	sonor'eg'is
sonorigas	sonor'ig'as
sonorigi	sonor'ig'i
sonorigis	sonor'ig'is
sonorigu	sonor'ig'u
sonorila	sonor'il'a
sonorilo	sonor'il'o
sonoriloj	sonor'il'o'j
sonorilojn	sonor'il'o'j'n
sonorilon	sonor'il'o'n
sonorilado	sonor'il'ad'o
sonorilaro	sonor'il'ar'o
sonorilego	sonor'il'eg'o
sonorilejo	sonor'il'ej'o
sonorileto	sonor'il'et'o
sonoriletoj	sonor'il'et'o'j
sonorileton	sonor'il'et'o'n
sonorilforma	sonor'il'form'a
sonorilostablo	sonor'il'o'stabl'o
sonorilturo	sonor'il'tur'o
sonorilturoj	sonor'il'tur'o'j
sopira	sopir'a
sopiras	sopir'as
sopire	sopir'e
sopiri	sopir'i
sopiris	sopir'is
sopiro	sopir'o
sopiroj	sopir'o'j
sopirojn	sopir'o'j'n
sopiron	sopir'o'n
sopiros	sopir'os
sopiradas	sopir'ad'as
sopiradi	sopir'ad'i
sopiradis	sopir'ad'is
sopirado	sopir'ad'o
sopiradon	sopir'ad'o'n
sopiranta	sopir'ant'a
sopirantaj	sopir'ant'a'j
sopirante	sopir'ant'e
sopirata	sopir'at'a
sopiratan	sopir'at'a'n
sopiregas	sopir'eg'as
sopiregis	sopir'eg'is
sopirita	sopir'it'a
sopiritaj	sopir'it'a'j
soprano	sopran'o
sorba	sorb'a
sorbas	sorb'as
sorbi	sorb'i
sorbis	sorb'is
sorbo	sorb'o
sorbus	sorb'us
sorbado	sorb'ad'o
sorbadon	sorb'ad'o'n
sorbata	sorb'at'a
sorbita	sorb'it'a
sorbitaj	sorb'it'a'j
sorbono	sorbon'o
sorbuso	sorbus'o
sorĉa	sorĉ'a
sorĉaj	sorĉ'a'j
sorĉajn	sorĉ'a'j'n
sorĉan	sorĉ'a'n
sorĉas	sorĉ'as
sorĉe	sorĉ'e
sorĉi	sorĉ'i
sorĉis	sorĉ'is
sorĉo	sorĉ'o
sorĉoj	sorĉ'o'j
sorĉojn	sorĉ'o'j'n
sorĉon	sorĉ'o'n
sorĉado	sorĉ'ad'o
sorĉadon	sorĉ'ad'o'n
sorĉarto	sorĉ'art'o
sorĉbastono	sorĉ'baston'o
sorĉisto	sorĉ'ist'o
sorĉistoj	sorĉ'ist'o'j
sorĉistojn	sorĉ'ist'o'j'n
sorĉiston	sorĉ'ist'o'n
sorĉistino	sorĉ'ist'in'o
sorĉistinoj	sorĉ'ist'in'o'j
sorĉistinojn	sorĉ'ist'in'o'j'n
sorĉistinon	sorĉ'ist'in'o'n
sorĉita	sorĉ'it'a
sorĉitaj	sorĉ'it'a'j
sorĉitan	sorĉ'it'a'n
sorgo	sorg'o
sorgon	sorg'o'n
sorobano	soroban'o
sorpo	sorp'o
sorta	sort'a
sorto	sort'o
sortoj	sort'o'j
sortojn	sort'o'j'n
sorton	sort'o'n
sortobato	sort'o'bat'o
sortobatoj	sort'o'bat'o'j
sortoŝanĝo	sort'o'ŝanĝ'o
sortoŝanĝoj	sort'o'ŝanĝ'o'j
sortimento	sortiment'o
sortimenton	sortiment'o'n
sovaĝa	sovaĝ'a
sovaĝaj	sovaĝ'a'j
sovaĝajn	sovaĝ'a'j'n
sovaĝan	sovaĝ'a'n
sovaĝe	sovaĝ'e
sovaĝbesto	sovaĝ'best'o
sovaĝbestoj	sovaĝ'best'o'j
sovaĝeco	sovaĝ'ec'o
sovaĝecon	sovaĝ'ec'o'n
sovaĝejo	sovaĝ'ej'o
sovaĝejoj	sovaĝ'ej'o'j
sovaĝejon	sovaĝ'ej'o'n
sovaĝiĝinta	sovaĝ'iĝ'int'a
sovaĝiĝintaj	sovaĝ'iĝ'int'a'j
sovaĝulo	sovaĝ'ul'o
sovaĝuloj	sovaĝ'ul'o'j
soveta	sovet'a
sovetaj	sovet'a'j
sovetajn	sovet'a'j'n
sovetan	sovet'a'n
soveto	sovet'o
sovetoj	sovet'o'j
sovetarmeo	sovet'arme'o
soveterao	sovet'era'o
sovetia	sovet'i'a
sovetiaj	sovet'i'a'j
sovetiajn	sovet'i'a'j'n
sovetian	sovet'i'a'n
sovetio	sovet'i'o
sovetion	sovet'i'o'n
sovetianoj	sovet'i'an'o'j
sovetianojn	sovet'i'an'o'j'n
sovetinstancoj	sovet'instanc'o'j
sovetregistaro	sovet'reg'ist'ar'o
sovetrespubliko	sovet'respublik'o
sovetrusio	sovet'rusi'o
sovetunia	sovet'uni'a
sovetuniaj	sovet'uni'a'j
sovetunio	sovet'uni'o
sovetunion	sovet'uni'o'n
sozio	sozi'o
spaca	spac'a
spacaj	spac'a'j
spacajn	spac'a'j'n
spacan	spac'a'n
space	spac'e
spaco	spac'o
spacoj	spac'o'j
spacojn	spac'o'j'n
spacon	spac'o'n
spacagentejo	spac'agent'ej'o
spacbazita	spac'baz'it'a
spaceto	spac'et'o
spacetoj	spac'et'o'j
spacetojn	spac'et'o'j'n
spaceton	spac'et'o'n
spacigita	spac'ig'it'a
spacigitaj	spac'ig'it'a'j
spacigitajn	spac'ig'it'a'j'n
spacmisioj	spac'misi'o'j
spacomanko	spac'o'mank'o
spacoŝipo	spac'o'ŝip'o
spacotempo	spac'o'temp'o
spacprogramo	spac'program'o
spacprogramoj	spac'program'o'j
spacpromenado	spac'promen'ad'o
spacstacio	spac'staci'o
spacŝipo	spac'ŝip'o
spactempo	spac'temp'o
spacveturilo	spac'vetur'il'o
spacveturiloj	spac'vetur'il'o'j
spacvojaĝo	spac'vojaĝ'o
spacvojaĝoj	spac'vojaĝ'o'j
spacvojaĝojn	spac'vojaĝ'o'j'n
spacvojaĝon	spac'vojaĝ'o'n
spaciala	spacial'a
spado	spad'o
spadoj	spad'o'j
spadon	spad'o'n
spageto	spaget'o
spagetoj	spaget'o'j
spagetojn	spaget'o'j'n
spajro	spajr'o
spajroj	spajr'o'j
spamo	spam'o
spamon	spam'o'n
spamisto	spam'ist'o
spamistoj	spam'ist'o'j
spano	span'o
spanoj	span'o'j
spanielo	spaniel'o
spanieloj	spaniel'o'j
sparka	spark'a
sparko	spark'o
sparkoj	spark'o'j
sparkojn	spark'o'j'n
sparkon	spark'o'n
sparkilo	spark'il'o
sparkiloj	spark'il'o'j
spartana	spart'an'a
spartanaj	spart'an'a'j
spartanan	spart'an'a'n
spartano	spart'an'o
spartanoj	spart'an'o'j
spartanojn	spart'an'o'j'n
spartanino	spart'an'in'o
spasma	spasm'a
spasmaj	spasm'a'j
spasme	spasm'e
spasmo	spasm'o
spasmoj	spasm'o'j
spato	spat'o
speca	spec'a
speco	spec'o
specoj	spec'o'j
specojn	spec'o'j'n
specon	spec'o'n
speciĝo	spec'iĝ'o
specia	speci'a
speciaj	speci'a'j
specio	speci'o
specioj	speci'o'j
speciojn	speci'o'j'n
specion	speci'o'n
speciigo	speci'ig'o
speciodiverseco	speci'o'divers'ec'o
specioriĉa	speci'o'riĉ'a
specioriĉeco	speci'o'riĉ'ec'o
speciospecifa	speci'o'specif'a
speciala	special'a
specialaj	special'a'j
specialajn	special'a'j'n
specialan	special'a'n
speciale	special'e
specialadaptita	special'adapt'it'a
specialadaptitaj	special'adapt'it'a'j
specialadaptitajn	special'adapt'it'a'j'n
specialadaptitan	special'adapt'it'a'n
specialaĵo	special'aĵ'o
specialaĵoj	special'aĵ'o'j
specialaĵojn	special'aĵ'o'j'n
specialaĵon	special'aĵ'o'n
specialeca	special'ec'a
specialecaj	special'ec'a'j
specialecajn	special'ec'a'j'n
specialecan	special'ec'a'n
specialeco	special'ec'o
specialecon	special'ec'o'n
specialefektoj	special'efekt'o'j
specialefektojn	special'efekt'o'j'n
specialeldono	special'el'don'o
specialigas	special'ig'as
specialigi	special'ig'i
specialigis	special'ig'is
specialigo	special'ig'o
specialigante	special'ig'ant'e
specialigita	special'ig'it'a
specialigitaj	special'ig'it'a'j
specialigitajn	special'ig'it'a'j'n
specialigitan	special'ig'it'a'n
specialiĝas	special'iĝ'as
specialiĝi	special'iĝ'i
specialiĝis	special'iĝ'is
specialiĝo	special'iĝ'o
specialiĝoj	special'iĝ'o'j
specialiĝon	special'iĝ'o'n
specialiĝanta	special'iĝ'ant'a
specialiĝantaj	special'iĝ'ant'a'j
specialiĝante	special'iĝ'ant'e
specialiĝinta	special'iĝ'int'a
specialiĝintaj	special'iĝ'int'a'j
specialiĝintajn	special'iĝ'int'a'j'n
specialiĝintan	special'iĝ'int'a'n
specialintereso	special'interes'o
specialinteresoj	special'interes'o'j
specialista	special'ist'a
specialistaj	special'ist'a'j
specialisto	special'ist'o
specialistoj	special'ist'o'j
specialistojn	special'ist'o'j'n
specialiston	special'ist'o'n
specializita	special'iz'it'a
specializitaj	special'iz'it'a'j
specialpermeso	special'permes'o
specialpermeson	special'permes'o'n
specialtrupo	special'trup'o
specifa	specif'a
specifaj	specif'a'j
specifajn	specif'a'j'n
specifan	specif'a'n
specifas	specif'as
specife	specif'e
specifi	specif'i
specifis	specif'is
specifo	specif'o
specifoj	specif'o'j
specifojn	specif'o'j'n
specifon	specif'o'n
specifaĵo	specif'aĵ'o
specifaĵoj	specif'aĵ'o'j
specifaĵojn	specif'aĵ'o'j'n
specifeco	specif'ec'o
specifecon	specif'ec'o'n
specifita	specif'it'a
specifika	specifik'a
specimena	specimen'a
specimeno	specimen'o
specimenoj	specimen'o'j
specimenojn	specimen'o'j'n
specimenon	specimen'o'n
specimenigo	specimen'ig'o
spegula	spegul'a
spegulaj	spegul'a'j
spegulan	spegul'a'n
spegulas	spegul'as
spegule	spegul'e
speguli	spegul'i
spegulis	spegul'is
spegulo	spegul'o
speguloj	spegul'o'j
spegulojn	spegul'o'j'n
spegulon	spegul'o'n
spegulos	spegul'os
spegulu	spegul'u
spegulado	spegul'ad'o
spegulanta	spegul'ant'a
spegulantaj	spegul'ant'a'j
spegulante	spegul'ant'e
spegulata	spegul'at'a
spegulbildo	spegul'bild'o
speguleto	spegul'et'o
speguliĝas	spegul'iĝ'as
speguliĝis	spegul'iĝ'is
spegulita	spegul'it'a
spegulitaj	spegul'it'a'j
spegulneŭronoj	spegul'neŭr'on'o'j
spektas	spekt'as
spekti	spekt'i
spektis	spekt'is
spekto	spekt'o
spektos	spekt'os
spektu	spekt'u
spektado	spekt'ad'o
spektadon	spekt'ad'o'n
spektaĵo	spekt'aĵ'o
spektaĵon	spekt'aĵ'o'n
spektanta	spekt'ant'a
spektantaj	spekt'ant'a'j
spektante	spekt'ant'e
spektanto	spekt'ant'o
spektantoj	spekt'ant'o'j
spektantojn	spekt'ant'o'j'n
spektanton	spekt'ant'o'n
spektantaro	spekt'ant'ar'o
spektantaroj	spekt'ant'ar'o'j
spektantarojn	spekt'ant'ar'o'j'n
spektantaron	spekt'ant'ar'o'n
spektebla	spekt'ebl'a
spekteblaj	spekt'ebl'a'j
spekteblas	spekt'ebl'as
spektejo	spekt'ej'o
spektinda	spekt'ind'a
spektita	spekt'it'a
spektitaj	spekt'it'a'j
spektakla	spektakl'a
spektaklaj	spektakl'a'j
spektaklajn	spektakl'a'j'n
spektaklan	spektakl'a'n
spektakle	spektakl'e
spektaklo	spektakl'o
spektakloj	spektakl'o'j
spektaklojn	spektakl'o'j'n
spektaklon	spektakl'o'n
spektaklejo	spektakl'ej'o
spektakloarto	spektakl'o'art'o
spektra	spektr'a
spektraj	spektr'a'j
spektrajn	spektr'a'j'n
spektran	spektr'a'n
spektre	spektr'e
spektro	spektr'o
spektroj	spektr'o'j
spektrojn	spektr'o'j'n
spektron	spektr'o'n
spektromalsanoj	spektr'o'mal'san'o'j
spektrometro	spektr'o'metr'o
spektroskopaj	spektr'o'skop'a'j
spektroskopio	spektr'o'skop'i'o
spektroskopion	spektr'o'skop'i'o'n
spekuli	spekul'i
spekulado	spekul'ad'o
spekulantoj	spekul'ant'o'j
spekulistoj	spekul'ist'o'j
spekulacio	spekulaci'o
spekulacioj	spekulaci'o'j
spekulativa	spekulativ'a
spekulativado	spekulativ'ad'o
spermo	sperm'o
spermoj	sperm'o'j
spermon	sperm'o'n
spermobanko	sperm'o'bank'o
spermobankoj	sperm'o'bank'o'j
spermoĉeloj	sperm'o'ĉel'o'j
spermatozoo	spermatozo'o
spermatozooj	spermatozo'o'j
sperta	spert'a
spertaj	spert'a'j
spertajn	spert'a'j'n
spertan	spert'a'n
spertas	spert'as
sperte	spert'e
sperti	spert'i
spertis	spert'is
sperto	spert'o
spertoj	spert'o'j
spertojn	spert'o'j'n
sperton	spert'o'n
spertos	spert'os
spertu	spert'u
spertus	spert'us
spertado	spert'ad'o
spertanta	spert'ant'a
spertantaj	spert'ant'a'j
spertante	spert'ant'e
spertanto	spert'ant'o
spertata	spert'at'a
spertebla	spert'ebl'a
sperteca	spert'ec'a
sperteco	spert'ec'o
spertecon	spert'ec'o'n
spertiĝi	spert'iĝ'i
spertiĝis	spert'iĝ'is
spertinta	spert'int'a
spertintaj	spert'int'a'j
spertinte	spert'int'e
spertita	spert'it'a
spertitaj	spert'it'a'j
spertitan	spert'it'a'n
spertula	spert'ul'a
spertulo	spert'ul'o
spertuloj	spert'ul'o'j
spertulojn	spert'ul'o'j'n
spertulon	spert'ul'o'n
speso	spes'o
spesoj	spes'o'j
speson	spes'o'n
spesmilo	spes'mil'o
spezo	spez'o
spezon	spez'o'n
spezfluo	spez'flu'o
spezfluoj	spez'flu'o'j
spezkalkula	spez'kalkul'a
spica	spic'a
spicaj	spic'a'j
spican	spic'a'n
spicas	spic'as
spici	spic'i
spicis	spic'is
spico	spic'o
spicoj	spic'o'j
spicojn	spic'o'j'n
spicon	spic'o'n
spicado	spic'ad'o
spicaĵo	spic'aĵ'o
spicaĵoj	spic'aĵ'o'j
spicaĵojn	spic'aĵ'o'j'n
spicherboj	spic'herb'o'j
spicita	spic'it'a
spicitaj	spic'it'a'j
spicitan	spic'it'a'n
spickomerco	spic'komerc'o
spickuko	spic'kuk'o
spiko	spik'o
spikoj	spik'o'j
spikojn	spik'o'j'n
spiketoj	spik'et'o'j
spina	spin'a
spinaj	spin'a'j
spino	spin'o
spinoj	spin'o'j
spinojn	spin'o'j'n
spinon	spin'o'n
spinaco	spinac'o
spinacon	spinac'o'n
spindelo	spindel'o
spindeloj	spindel'o'j
spinoroj	spinor'o'j
spinoza	spinoz'a
spinozo	spinoz'o
spiona	spion'a
spionas	spion'as
spioni	spion'i
spionis	spion'is
spiono	spion'o
spionoj	spion'o'j
spionojn	spion'o'j'n
spionon	spion'o'n
spionado	spion'ad'o
spionadon	spion'ad'o'n
spionino	spion'in'o
spionservo	spion'serv'o
spionservoj	spion'serv'o'j
spionvaro	spion'var'o
spira	spir'a
spiraj	spir'a'j
spirajn	spir'a'j'n
spiran	spir'a'n
spiras	spir'as
spiri	spir'i
spiris	spir'is
spiro	spir'o
spiroj	spir'o'j
spiron	spir'o'n
spiros	spir'os
spiru	spir'u
spiradis	spir'ad'is
spirado	spir'ad'o
spiradon	spir'ad'o'n
spiranta	spir'ant'a
spirantaj	spir'ant'a'j
spirantan	spir'ant'a'n
spirante	spir'ant'e
spirebla	spir'ebl'a
spiregis	spir'eg'is
spiregante	spir'eg'ant'e
spirmanka	spir'mank'a
spirmanko	spir'mank'o
spirotruoj	spir'o'tru'o'j
spirorganoj	spir'organ'o'j
spirsistemo	spir'sistem'o
spirala	spiral'a
spiralaj	spiral'a'j
spiralan	spiral'a'n
spirale	spiral'e
spiralo	spiral'o
spiraloj	spiral'o'j
spiralon	spiral'o'n
spirita	spirit'a
spiritaj	spirit'a'j
spiritajn	spirit'a'j'n
spiritan	spirit'a'n
spirite	spirit'e
spirito	spirit'o
spiritoj	spirit'o'j
spiritojn	spirit'o'j'n
spiriton	spirit'o'n
spiriteca	spirit'ec'a
spiriteco	spirit'ec'o
spiritecon	spirit'ec'o'n
spiritisma	spirit'ism'a
spiritismaj	spirit'ism'a'j
spiritismo	spirit'ism'o
spiritismon	spirit'ism'o'n
spiritisto	spirit'ist'o
spiritistoj	spirit'ist'o'j
spiritmondo	spirit'mond'o
spiritostato	spirit'o'stat'o
spiritstato	spirit'stat'o
spiritualo	spiritual'o
spiritualeco	spiritual'ec'o
spiritualismo	spiritual'ism'o
spita	spit'a
spitas	spit'as
spite	spit'e
spiti	spit'i
spitis	spit'is
spito	spit'o
spitu	spit'u
spitado	spit'ad'o
spitante	spit'ant'e
spitema	spit'em'a
spiteme	spit'em'e
spitemo	spit'em'o
spleno	splen'o
splenda	splend'a
splendo	splend'o
splito	split'o
splitoj	split'o'j
splitojn	split'o'j'n
spliton	split'o'n
splitiĝis	split'iĝ'is
spoko	spok'o
spokoj	spok'o'j
spondeo	sponde'o
sponga	spong'a
spongo	spong'o
spongoj	spong'o'j
spongon	spong'o'n
spongeca	spong'ec'a
spongecaj	spong'ec'a'j
sponguloj	spong'ul'o'j
sponsoras	sponsor'as
sponsori	sponsor'i
sponsoris	sponsor'is
sponsoro	sponsor'o
sponsoroj	sponsor'o'j
sponsorojn	sponsor'o'j'n
sponsoron	sponsor'o'n
sponsorado	sponsor'ad'o
sponsoradon	sponsor'ad'o'n
sponsorita	sponsor'it'a
sponsoritaj	sponsor'it'a'j
spontana	spontan'a
spontanaj	spontan'a'j
spontanan	spontan'a'n
spontane	spontan'e
spontaneco	spontan'ec'o
spontanecon	spontan'ec'o'n
spontanea	spontane'a
spontaneaj	spontane'a'j
spontanean	spontane'a'n
spontanee	spontane'e
sporo	spor'o
sporoj	spor'o'j
sporojn	spor'o'j'n
sporada	sporad'a
sporadaj	sporad'a'j
sporadajn	sporad'a'j'n
sporade	sporad'e
sporangio	sporangi'o
sporangioj	sporangi'o'j
sporta	sport'a
sportaj	sport'a'j
sportajn	sport'a'j'n
sportan	sport'a'n
sportas	sport'as
sporte	sport'e
sporti	sport'i
sportis	sport'is
sporto	sport'o
sportoj	sport'o'j
sportojn	sport'o'j'n
sporton	sport'o'n
sportado	sport'ad'o
sportadon	sport'ad'o'n
sportaŭto	sport'aŭt'o
sportaŭtoj	sport'aŭt'o'j
sportaŭton	sport'aŭt'o'n
sportejo	sport'ej'o
sportejoj	sport'ej'o'j
sportejojn	sport'ej'o'j'n
sportejon	sport'ej'o'n
sportema	sport'em'a
sportemuloj	sport'em'ul'o'j
sportevento	sport'event'o
sporteventoj	sport'event'o'j
sporteventojn	sport'event'o'j'n
sporthalo	sport'hal'o
sporthaloj	sport'hal'o'j
sportinstalaĵo	sport'instal'aĵ'o
sportinstalaĵoj	sport'instal'aĵ'o'j
sportinstalaĵojn	sport'instal'aĵ'o'j'n
sportista	sport'ist'a
sportisto	sport'ist'o
sportistoj	sport'ist'o'j
sportistojn	sport'ist'o'j'n
sportistino	sport'ist'in'o
sportistinoj	sport'ist'in'o'j
sportkamionetoj	sport'kamion'et'o'j
sportkunveno	sport'kun'ven'o
sportkunvenon	sport'kun'ven'o'n
sportludoj	sport'lud'o'j
sportteamoj	sport'team'o'j
sportulo	sport'ul'o
sportuloj	sport'ul'o'j
sportumi	sport'um'i
sprita	sprit'a
spritaj	sprit'a'j
spritajn	sprit'a'j'n
spritan	sprit'a'n
sprite	sprit'e
sprito	sprit'o
spriton	sprit'o'n
spritaĵo	sprit'aĵ'o
spritaĵoj	sprit'aĵ'o'j
spritaĵojn	sprit'aĵ'o'j'n
spriteco	sprit'ec'o
spritecon	sprit'ec'o'n
spritulo	sprit'ul'o
spronas	spron'as
sproni	spron'i
spronis	spron'is
sprono	spron'o
spronoj	spron'o'j
spronojn	spron'o'j'n
spronon	spron'o'n
spronburgo	spron'burg'o
spronita	spron'it'a
spura	spur'a
spuraj	spur'a'j
spuras	spur'as
spuri	spur'i
spuris	spur'is
spuro	spur'o
spuroj	spur'o'j
spurojn	spur'o'j'n
spuron	spur'o'n
spurado	spur'ad'o
spuradon	spur'ad'o'n
spuranta	spur'ant'a
spurantan	spur'ant'a'n
spurante	spur'ant'e
spurebla	spur'ebl'a
spureblaj	spur'ebl'a'j
spurebleco	spur'ebl'ec'o
spurilo	spur'il'o
spuristo	spur'ist'o
spuristoj	spur'ist'o'j
spurita	spur'it'a
spuritaj	spur'it'a'j
spurkvantoj	spur'kvant'o'j
sputis	sput'is
sputniko	sputnik'o
sputnikoj	sputnik'o'j
srilanka	srilank'a
srilankaj	srilank'a'j
srilanko	srilank'o
srilankon	srilank'o'n
stabo	stab'o
staboj	stab'o'j
stabon	stab'o'n
stabanoj	stab'an'o'j
stabanaro	stab'an'ar'o
stabejo	stab'ej'o
stabestro	stab'estr'o
stabestraro	stab'estr'ar'o
stabila	stabil'a
stabilaj	stabil'a'j
stabilajn	stabil'a'j'n
stabilan	stabil'a'n
stabilas	stabil'as
stabile	stabil'e
stabileco	stabil'ec'o
stabilecon	stabil'ec'o'n
stabiliga	stabil'ig'a
stabiligas	stabil'ig'as
stabiligi	stabil'ig'i
stabiligis	stabil'ig'is
stabiligo	stabil'ig'o
stabiligon	stabil'ig'o'n
stabiligado	stabil'ig'ad'o
stabiligante	stabil'ig'ant'e
stabiliganto	stabil'ig'ant'o
stabiligilo	stabil'ig'il'o
stabiligita	stabil'ig'it'a
stabiligitaj	stabil'ig'it'a'j
stabiliĝas	stabil'iĝ'as
stabiliĝis	stabil'iĝ'is
stabiliĝo	stabil'iĝ'o
stablo	stabl'o
stabloj	stabl'o'j
stablon	stabl'o'n
stacia	staci'a
stacio	staci'o
stacioj	staci'o'j
staciojn	staci'o'j'n
stacion	staci'o'n
stacidoma	staci'dom'a
stacidomo	staci'dom'o
stacidomoj	staci'dom'o'j
stacidomojn	staci'dom'o'j'n
stacidomon	staci'dom'o'n
staciestro	staci'estr'o
stadio	stadi'o
stadioj	stadi'o'j
stadiojn	stadi'o'j'n
stadion	stadi'o'n
stadiono	stadion'o
stadionoj	stadion'o'j
stadionojn	stadion'o'j'n
stadionon	stadion'o'n
stafeto	stafet'o
stafetado	stafet'ad'o
stafetadon	stafet'ad'o'n
stafetkurado	stafet'kur'ad'o
stafetkuradon	stafet'kur'ad'o'n
stagna	stagn'a
stagnaj	stagn'a'j
stagnas	stagn'as
stagnis	stagn'is
stagno	stagn'o
stagnon	stagn'o'n
stagnado	stagn'ad'o
stagnadon	stagn'ad'o'n
stagnanta	stagn'ant'a
staĝo	staĝ'o
staĝoj	staĝ'o'j
staĝojn	staĝ'o'j'n
staĝon	staĝ'o'n
staĝantoj	staĝ'ant'o'j
stako	stak'o
stakoj	stak'o'j
stakojn	stak'o'j'n
stakon	stak'o'n
stakigi	stak'ig'i
stakigis	stak'ig'is
stakigita	stak'ig'it'a
stakigitaj	stak'ig'it'a'j
stakato	stakat'o
stalo	stal'o
staloj	stal'o'j
stalojn	stal'o'j'n
stalon	stal'o'n
stalsterko	stal'sterk'o
stalsterkon	stal'sterk'o'n
stalagmitoj	stalagmit'o'j
stalaktitoj	stalaktit'o'j
stalina	stalin'a
stalino	stalin'o
stalinon	stalin'o'n
stalinisma	stalin'ism'a
stalinismo	stalin'ism'o
stalinistoj	stalin'ist'o'j
stalingrado	stalingrad'o
stalono	stalon'o
stamenoj	stamen'o'j
stamenojn	stamen'o'j'n
stamfas	stamf'as
stamfis	stamf'is
stamfado	stamf'ad'o
stampa	stamp'a
stampas	stamp'as
stampi	stamp'i
stampis	stamp'is
stampo	stamp'o
stampoj	stamp'o'j
stampon	stamp'o'n
stampado	stamp'ad'o
stampilo	stamp'il'o
stampiloj	stamp'il'o'j
stampilon	stamp'il'o'n
stampita	stamp'it'a
stampitaj	stamp'it'a'j
stana	stan'a
stanaj	stan'a'j
stanajn	stan'a'j'n
stanan	stan'a'n
stane	stan'e
stano	stan'o
stanon	stan'o'n
stanisto	stan'ist'o
stansoldato	stan'soldat'o
stanulo	stan'ul'o
stando	stand'o
standoj	stand'o'j
standojn	stand'o'j'n
standon	stand'o'n
standarda	standard'a
standardo	standard'o
standardoj	standard'o'j
standardojn	standard'o'j'n
standardon	standard'o'n
stanforda	stanford'a
stanfordo	stanford'o
stango	stang'o
stangoj	stang'o'j
stangojn	stang'o'j'n
stangon	stang'o'n
stangeto	stang'et'o
stangetoj	stang'et'o'j
stangetojn	stang'et'o'j'n
stangeton	stang'et'o'n
stanislava	stanislav'a
stanislavo	stanislav'o
staplo	stapl'o
staploj	stapl'o'j
staplado	stapl'ad'o
staplitaj	stapl'it'a'j
stara	star'a
staraj	star'a'j
staras	star'as
stare	star'e
stari	star'i
staris	star'is
staro	star'o
staros	star'os
staru	star'u
starus	star'us
staradi	star'ad'i
staradis	star'ad'is
starado	star'ad'o
staranta	star'ant'a
starantaj	star'ant'a'j
starantajn	star'ant'a'j'n
starantan	star'ant'a'n
starante	star'ant'e
starejo	star'ej'o
starigas	star'ig'as
starigi	star'ig'i
starigis	star'ig'is
starigo	star'ig'o
starigoj	star'ig'o'j
starigon	star'ig'o'n
starigos	star'ig'os
starigu	star'ig'u
starigus	star'ig'us
starigado	star'ig'ad'o
starigante	star'ig'ant'e
starigata	star'ig'at'a
starigataj	star'ig'at'a'j
stariginta	star'ig'int'a
stariginte	star'ig'int'e
starigita	star'ig'it'a
starigitaj	star'ig'it'a'j
starigitajn	star'ig'it'a'j'n
starigitan	star'ig'it'a'n
starigite	star'ig'it'e
starigitis	star'ig'it'is
starigota	star'ig'ot'a
stariĝas	star'iĝ'as
stariĝi	star'iĝ'i
stariĝis	star'iĝ'is
stariĝo	star'iĝ'o
stariĝos	star'iĝ'os
stariĝu	star'iĝ'u
stariĝante	star'iĝ'ant'e
starinta	star'int'a
starintaj	star'int'a'j
starloko	star'lok'o
starpunkto	star'punkt'o
starpunktoj	star'punkt'o'j
starpunktojn	star'punkt'o'j'n
starpunkton	star'punkt'o'n
starta	start'a
startas	start'as
starti	start'i
startis	start'is
starto	start'o
starton	start'o'n
startos	start'os
startu	start'u
startante	start'ant'e
startigas	start'ig'as
startigi	start'ig'i
startigis	start'ig'is
startigo	start'ig'o
startigu	start'ig'u
startigilo	start'ig'il'o
startita	start'it'a
startleno	start'len'o
startlenoj	start'len'o'j
startlenojn	start'len'o'j'n
startlenon	start'len'o'n
startpunkto	start'punkt'o
stata	stat'a
stataj	stat'a'j
statas	stat'as
state	stat'e
statis	stat'is
stato	stat'o
statoj	stat'o'j
statojn	stat'o'j'n
staton	stat'o'n
statu	stat'u
status	stat'us
statika	statik'a
statikaj	statik'a'j
statike	statik'e
statiko	statik'o
statisto	statist'o
statistoj	statist'o'j
statistika	statistik'a
statistikaj	statistik'a'j
statistikajn	statistik'a'j'n
statistikan	statistik'a'n
statistike	statistik'e
statistiko	statistik'o
statistikoj	statistik'o'j
statistikojn	statistik'o'j'n
statistikon	statistik'o'n
statistikisto	statistik'ist'o
statistikistoj	statistik'ist'o'j
stative	stativ'e
stativo	stativ'o
statoro	stator'o
statuo	statu'o
statuoj	statu'o'j
statuojn	statu'o'j'n
statuon	statu'o'n
statuaro	statu'ar'o
statueto	statu'et'o
statuetoj	statu'et'o'j
statuetojn	statu'et'o'j'n
statueton	statu'et'o'n
staturo	statur'o
staturoj	statur'o'j
staturon	statur'o'n
statusa	status'a
statuso	status'o
statusoj	status'o'j
statuson	status'o'n
statuta	statut'a
statutaj	statut'a'j
statute	statut'e
statuto	statut'o
statutoj	statut'o'j
statutojn	statut'o'j'n
statuton	statut'o'n
staŭda	staŭd'a
staŭdoj	staŭd'o'j
stebi	steb'i
stebado	steb'ad'o
stebkovrilo	steb'kovr'il'o
stebkovriloj	steb'kovr'il'o'j
stefano	stefan'o
stefanon	stefan'o'n
stegi	steg'i
stego	steg'o
stegita	steg'it'a
stela	stel'a
stelaj	stel'a'j
stelajn	stel'a'j'n
stelan	stel'a'n
stele	stel'e
stelo	stel'o
steloj	stel'o'j
stelojn	stel'o'j'n
stelon	stel'o'n
stelamaso	stel'amas'o
stelamasoj	stel'amas'o'j
stelaro	stel'ar'o
stelaroj	stel'ar'o'j
steleto	stel'et'o
steletoj	stel'et'o'j
steleton	stel'et'o'n
stelfloto	stel'flot'o
stelformaj	stel'form'a'j
stelformacio	stel'formaci'o
stellumo	stel'lum'o
stelmilito	stel'milit'o
stelnavigado	stel'navig'ad'o
stelplena	stel'plen'a
stelpolvo	stel'polv'o
stelsistemo	stel'sistem'o
stelsistemoj	stel'sistem'o'j
stelŝipo	stel'ŝip'o
stelŝipoj	stel'ŝip'o'j
stelŝipon	stel'ŝip'o'n
stelŝipanoj	stel'ŝip'an'o'j
stelŝiparo	stel'ŝip'ar'o
stelulo	stel'ul'o
steluloj	stel'ul'o'j
stelulino	stel'ul'in'o
steleo	stele'o
steleoj	stele'o'j
stenografi	stenograf'i
stenografo	stenograf'o
stenografia	stenograf'i'a
stenografio	stenograf'i'o
stenografion	stenograf'i'o'n
stenozo	stenoz'o
stepa	step'a
stepaj	step'a'j
stepan	step'a'n
stepo	step'o
stepoj	step'o'j
stepojn	step'o'j'n
stepon	step'o'n
stereoskopa	stereo'skop'a
stereoskopan	stereo'skop'a'n
stereotipa	stereotip'a
stereotipaj	stereotip'a'j
stereotipajn	stereotip'a'j'n
stereotipan	stereotip'a'n
stereotipi	stereotip'i
stereotipo	stereotip'o
stereotipoj	stereotip'o'j
stereotipojn	stereotip'o'j'n
stereotipon	stereotip'o'n
sterila	steril'a
sterilaj	steril'a'j
sterilajn	steril'a'j'n
sterileco	steril'ec'o
steriligi	steril'ig'i
steriligo	steril'ig'o
steriligon	steril'ig'o'n
steriligita	steril'ig'it'a
steriligitaj	steril'ig'it'a'j
sterkas	sterk'as
sterki	sterk'i
sterko	sterk'o
sterkoj	sterk'o'j
sterkojn	sterk'o'j'n
sterkon	sterk'o'n
sterkado	sterk'ad'o
sterkaĵo	sterk'aĵ'o
sterkaĵoj	sterk'aĵ'o'j
sterkejo	sterk'ej'o
sterkita	sterk'it'a
sterkitaj	sterk'it'a'j
sterna	stern'a
sternas	stern'as
sterne	stern'e
sterni	stern'i
sternis	stern'is
sternaĵo	stern'aĵ'o
sterniĝas	stern'iĝ'as
sterniĝis	stern'iĝ'is
sternita	stern'it'a
sternitaj	stern'it'a'j
sternumo	sternum'o
stevardo	stevard'o
stevardoj	stevard'o'j
stevardino	stevard'in'o
steveno	steven'o
stifto	stift'o
stiftoj	stift'o'j
stiftojn	stift'o'j'n
stifton	stift'o'n
stigmo	stigm'o
stigmoj	stigm'o'j
stigmato	stigmat'o
stigmatoj	stigmat'o'j
stigmaton	stigmat'o'n
stila	stil'a
stilaj	stil'a'j
stilajn	stil'a'j'n
stilan	stil'a'n
stile	stil'e
stilo	stil'o
stiloj	stil'o'j
stilojn	stil'o'j'n
stilon	stil'o'n
stileto	stil'et'o
stilfolio	stil'foli'o
stiligita	stil'ig'it'a
stiligitaj	stil'ig'it'a'j
stiligitajn	stil'ig'it'a'j'n
stiligitan	stil'ig'it'a'n
stilisto	stil'ist'o
stilistoj	stil'ist'o'j
stilistiko	stil'ist'ik'o
stilita	stil'it'a
stilitaj	stil'it'a'j
stileto	stilet'o
stilzoj	stilz'o'j
stimula	stimul'a
stimulaj	stimul'a'j
stimulajn	stimul'a'j'n
stimulan	stimul'a'n
stimulas	stimul'as
stimule	stimul'e
stimuli	stimul'i
stimulis	stimul'is
stimulo	stimul'o
stimuloj	stimul'o'j
stimulojn	stimul'o'j'n
stimulon	stimul'o'n
stimulos	stimul'os
stimulu	stimul'u
stimulado	stimul'ad'o
stimuladon	stimul'ad'o'n
stimulanta	stimul'ant'a
stimulante	stimul'ant'e
stimulilo	stimul'il'o
stimuliloj	stimul'il'o'j
stimulilon	stimul'il'o'n
stimulita	stimul'it'a
stimulitaj	stimul'it'a'j
stimulitan	stimul'it'a'n
stimulite	stimul'it'e
stinkas	stink'as
stipe	stip'e
stipo	stip'o
stipendio	stipendi'o
stipendioj	stipendi'o'j
stipendiojn	stipendi'o'j'n
stipendion	stipendi'o'n
stipuloj	stipul'o'j
stira	stir'a
stiras	stir'as
stiri	stir'i
stiris	stir'is
stiros	stir'os
stiru	stir'u
stirado	stir'ad'o
stiradon	stir'ad'o'n
stiranta	stir'ant'a
stirantaj	stir'ant'a'j
stirante	stir'ant'e
stiranto	stir'ant'o
stirata	stir'at'a
stirebla	stir'ebl'a
stirejo	stir'ej'o
stirejon	stir'ej'o'n
stirilo	stir'il'o
stirilon	stir'il'o'n
stiristo	stir'ist'o
stiristoj	stir'ist'o'j
stiriston	stir'ist'o'n
stirita	stir'it'a
stirmekanismoj	stir'mekanism'o'j
stirorgano	stir'organ'o
stirpermeson	stir'permes'o'n
stirpermesilo	stir'permes'il'o
stirpermesilon	stir'permes'il'o'n
stirrado	stir'rad'o
stirradon	stir'rad'o'n
stirstango	stir'stang'o
stirstangoj	stir'stang'o'j
stireno	stiren'o
stirio	stiri'o
stoika	stoik'a
stoikeco	stoik'ec'o
stoikismo	stoik'ism'o
stoikistoj	stoik'ist'o'j
stoikulo	stoik'ul'o
stoikuloj	stoik'ul'o'j
stoka	stok'a
stokaj	stok'a'j
stokan	stok'a'n
stokas	stok'as
stoki	stok'i
stokis	stok'is
stoko	stok'o
stokoj	stok'o'j
stokojn	stok'o'j'n
stokon	stok'o'n
stokos	stok'os
stokado	stok'ad'o
stokadon	stok'ad'o'n
stokadmedio	stok'ad'medi'o
stokante	stok'ant'e
stokataj	stok'at'a'j
stokeblaj	stok'ebl'a'j
stokejo	stok'ej'o
stokejoj	stok'ej'o'j
stokejojn	stok'ej'o'j'n
stokejon	stok'ej'o'n
stokita	stok'it'a
stokitaj	stok'it'a'j
stokitajn	stok'it'a'j'n
stokitan	stok'it'a'n
stokite	stok'it'e
stokregistro	stok'registr'o
stokregistroj	stok'registr'o'j
stokregistron	stok'registr'o'n
stokujo	stok'uj'o
stokujoj	stok'uj'o'j
stokasta	stokast'a
stokastaj	stokast'a'j
stokholma	stokholm'a
stokholmo	stokholm'o
stolo	stol'o
stolon	stol'o'n
stolonoj	stolon'o'j
stolonojn	stolon'o'j'n
stomaka	stomak'a
stomakaj	stomak'a'j
stomakajn	stomak'a'j'n
stomakan	stomak'a'n
stomako	stomak'o
stomakoj	stomak'o'j
stomakojn	stomak'o'j'n
stomakon	stomak'o'n
stomakdoloro	stomak'dolor'o
stomakdoloron	stomak'dolor'o'n
stoplo	stopl'o
strabas	strab'as
strabe	strab'e
strabis	strab'is
strabo	strab'o
strabismo	strab'ism'o
strabono	strabon'o
stranda	strand'a
strando	strand'o
strandoj	strand'o'j
strandojn	strand'o'j'n
strandon	strand'o'n
stranga	strang'a
strangaj	strang'a'j
strangajn	strang'a'j'n
strangan	strang'a'n
strangas	strang'as
strange	strang'e
strangaĵo	strang'aĵ'o
strangaĵoj	strang'aĵ'o'j
strangaĵojn	strang'aĵ'o'j'n
strangaĵon	strang'aĵ'o'n
strangeco	strang'ec'o
strangega	strang'eg'a
strangulo	strang'ul'o
stranguloj	strang'ul'o'j
strangulojn	strang'ul'o'j'n
strangolas	strangol'as
strangoli	strangol'i
strangolis	strangol'is
strangolos	strangol'os
strangolita	strangol'it'a
strasburga	strasburg'a
strasburgo	strasburg'o
strata	strat'a
strataj	strat'a'j
stratan	strat'a'n
straten	strat'e'n
strato	strat'o
stratoj	strat'o'j
stratojn	strat'o'j'n
straton	strat'o'n
stratangulo	strat'angul'o
stratanguloj	strat'angul'o'j
stratego	strat'eg'o
strategoj	strat'eg'o'j
strateto	strat'et'o
stratetoj	strat'et'o'j
stratetojn	strat'et'o'j'n
strateton	strat'et'o'n
stratkanaletoj	strat'kanal'et'o'j
stratkomercistoj	strat'komerc'ist'o'j
stratlampoj	strat'lamp'o'j
stratnivelo	strat'nivel'o
stratnomoj	strat'nom'o'j
stratovulkano	strat'o'vulkan'o
strattrafiko	strat'trafik'o
stratveturiloj	strat'vetur'il'o'j
stratvido	strat'vid'o
strategia	strateg'i'a
strategiaj	strateg'i'a'j
strategiajn	strateg'i'a'j'n
strategian	strateg'i'a'n
strategie	strateg'i'e
strategio	strateg'i'o
strategioj	strateg'i'o'j
strategiojn	strateg'i'o'j'n
strategion	strateg'i'o'n
strategiisto	strateg'i'ist'o
strategiistoj	strateg'i'ist'o'j
strategiludoj	strateg'i'lud'o'j
stratigrafio	stratigraf'i'o
stratosfera	stratosfer'a
stratosfero	stratosfer'o
stratosferon	stratosfer'o'n
stratumo	stratum'o
strebas	streb'as
strebe	streb'e
strebi	streb'i
strebis	streb'is
strebo	streb'o
streboj	streb'o'j
strebojn	streb'o'j'n
strebon	streb'o'n
strebos	streb'os
strebu	streb'u
strebus	streb'us
strebadis	streb'ad'is
strebado	streb'ad'o
strebadoj	streb'ad'o'j
strebadojn	streb'ad'o'j'n
strebadon	streb'ad'o'n
strebanta	streb'ant'a
strebantaj	streb'ant'a'j
strebante	streb'ant'e
streĉa	streĉ'a
streĉaj	streĉ'a'j
streĉajn	streĉ'a'j'n
streĉan	streĉ'a'n
streĉas	streĉ'as
streĉe	streĉ'e
streĉi	streĉ'i
streĉis	streĉ'is
streĉo	streĉ'o
streĉoj	streĉ'o'j
streĉojn	streĉ'o'j'n
streĉon	streĉ'o'n
streĉos	streĉ'os
streĉu	streĉ'u
streĉado	streĉ'ad'o
streĉadoj	streĉ'ad'o'j
streĉadon	streĉ'ad'o'n
streĉanta	streĉ'ant'a
streĉantaj	streĉ'ant'a'j
streĉante	streĉ'ant'e
streĉata	streĉ'at'a
streĉeco	streĉ'ec'o
streĉiĝas	streĉ'iĝ'as
streĉiĝis	streĉ'iĝ'is
streĉiĝo	streĉ'iĝ'o
streĉiĝoj	streĉ'iĝ'o'j
streĉiĝojn	streĉ'iĝ'o'j'n
streĉiĝon	streĉ'iĝ'o'n
streĉinte	streĉ'int'e
streĉita	streĉ'it'a
streĉitaj	streĉ'it'a'j
streĉitajn	streĉ'it'a'j'n
streĉitan	streĉ'it'a'n
streĉite	streĉ'it'e
streĉiteco	streĉ'it'ec'o
streĉitecoj	streĉ'it'ec'o'j
streĉitecojn	streĉ'it'ec'o'j'n
streĉitecon	streĉ'it'ec'o'n
strekaj	strek'a'j
strekas	strek'as
streki	strek'i
strekis	strek'is
streko	strek'o
strekoj	strek'o'j
strekojn	strek'o'j'n
strekon	strek'o'n
streketo	strek'et'o
streketoj	strek'et'o'j
streketon	strek'et'o'n
strekita	strek'it'a
stresa	stres'a
stresas	stres'as
streso	stres'o
stresoj	stres'o'j
stresojn	stres'o'j'n
streson	stres'o'n
stresigis	stres'ig'is
stresigita	stres'ig'it'a
stresigitaj	stres'ig'it'a'j
stresitaj	stres'it'a'j
stresmalsano	stres'mal'san'o
stria	stri'a
striaj	stri'a'j
strii	stri'i
strio	stri'o
strioj	stri'o'j
striojn	stri'o'j'n
strion	stri'o'n
striado	stri'ad'o
striata	stri'at'a
strieca	stri'ec'a
striecaj	stri'ec'a'j
striecajn	stri'ec'a'j'n
striecan	stri'ec'a'n
strieco	stri'ec'o
striecon	stri'ec'o'n
strieto	stri'et'o
strietoj	stri'et'o'j
striita	stri'it'a
striitaj	stri'it'a'j
striitajn	stri'it'a'j'n
striitan	stri'it'a'n
strizono	stri'zon'o
striata	striat'a
strida	strid'a
stridan	strid'a'n
strigo	strig'o
strigoj	strig'o'j
strigon	strig'o'n
strikas	strik'as
strike	strik'e
striki	strik'i
strikis	strik'is
striko	strik'o
strikoj	strik'o'j
strikojn	strik'o'j'n
strikon	strik'o'n
strikantaj	strik'ant'a'j
strikantoj	strik'ant'o'j
strikisto	strik'ist'o
strikistoj	strik'ist'o'j
strikta	strikt'a
striktaj	strikt'a'j
striktajn	strikt'a'j'n
striktan	strikt'a'n
strikte	strikt'e
striktasence	strikt'a'senc'e
strikteco	strikt'ec'o
stringas	string'as
stringis	string'is
strobilo	strobil'o
strobiloj	strobil'o'j
strobilforma	strobil'form'a
strofo	strof'o
strofoj	strof'o'j
strofojn	strof'o'j'n
strofon	strof'o'n
struktura	struktur'a
strukturaj	struktur'a'j
strukturajn	struktur'a'j'n
strukturan	struktur'a'n
strukturas	struktur'as
strukture	struktur'e
strukturi	struktur'i
strukturis	struktur'is
strukturo	struktur'o
strukturoj	struktur'o'j
strukturojn	struktur'o'j'n
strukturon	struktur'o'n
strukturado	struktur'ad'o
strukturismo	struktur'ism'o
strukturita	struktur'it'a
strukturitaj	struktur'it'a'j
strukturitajn	struktur'it'a'j'n
strukturitan	struktur'it'a'n
strutaj	strut'a'j
struto	strut'o
strutoj	strut'o'j
strutoformaj	strut'o'form'a'j
studa	stud'a
studaj	stud'a'j
studan	stud'a'n
studas	stud'as
studi	stud'i
studis	stud'is
studo	stud'o
studoj	stud'o'j
studojn	stud'o'j'n
studon	stud'o'n
studos	stud'os
studu	stud'u
studus	stud'us
studadas	stud'ad'as
studadi	stud'ad'i
studadis	stud'ad'is
studado	stud'ad'o
studadoj	stud'ad'o'j
studadon	stud'ad'o'n
studaĵo	stud'aĵ'o
studaĵoj	stud'aĵ'o'j
studanta	stud'ant'a
studantaj	stud'ant'a'j
studante	stud'ant'e
studanto	stud'ant'o
studantoj	stud'ant'o'j
studantojn	stud'ant'o'j'n
studanton	stud'ant'o'n
studantino	stud'ant'in'o
studaro	stud'ar'o
studata	stud'at'a
studataj	stud'at'a'j
studejo	stud'ej'o
studema	stud'em'a
studfako	stud'fak'o
studfakoj	stud'fak'o'j
studfakon	stud'fak'o'n
studgrupo	stud'grup'o
studinda	stud'ind'a
studinta	stud'int'a
studintaj	stud'int'a'j
studinte	stud'int'e
studintus	stud'int'us
studita	stud'it'a
studitaj	stud'it'a'j
studjaro	stud'jar'o
studjaroj	stud'jar'o'j
studjarojn	stud'jar'o'j'n
studjaron	stud'jar'o'n
studmaterialo	stud'material'o
studobjekto	stud'objekt'o
studobjektoj	stud'objekt'o'j
studobjekton	stud'objekt'o'n
studprogramo	stud'program'o
studprogramoj	stud'program'o'j
studprogramojn	stud'program'o'j'n
studprogramon	stud'program'o'n
studrondo	stud'rond'o
studrondoj	stud'rond'o'j
studuloj	stud'ul'o'j
studenta	student'a
studentaj	student'a'j
studentajn	student'a'j'n
studentan	student'a'n
studento	student'o
studentoj	student'o'j
studentojn	student'o'j'n
studenton	student'o'n
studentaro	student'ar'o
studentaron	student'ar'o'n
studentgrupoj	student'grup'o'j
studentiĝis	student'iĝ'is
studentiĝado	student'iĝ'ad'o
studentino	student'in'o
studentinoj	student'in'o'j
studentinojn	student'in'o'j'n
studentorganizoj	student'organiz'o'j
studentregistaro	student'reg'ist'ar'o
studentsindikato	student'sindikat'o
studentunuiĝo	student'unu'iĝ'o
studentvivo	student'viv'o
studia	studi'a
studiaj	studi'a'j
studio	studi'o
studioj	studi'o'j
studiojn	studi'o'j'n
studion	studi'o'n
stufaĵo	stuf'aĵ'o
stufaĵoj	stuf'aĵ'o'j
stuka	stuk'a
stuko	stuk'o
stukoj	stuk'o'j
stulta	stult'a
stultaj	stult'a'j
stultajn	stult'a'j'n
stultan	stult'a'n
stultas	stult'as
stulte	stult'e
stultis	stult'is
stulto	stult'o
stulton	stult'o'n
stultajho	stult'aĵ'o
stultaĵo	stult'aĵ'o
stultaĵoj	stult'aĵ'o'j
stultaĵojn	stult'aĵ'o'j'n
stultaĵon	stult'aĵ'o'n
stulteco	stult'ec'o
stultecon	stult'ec'o'n
stultega	stult'eg'a
stultigas	stult'ig'as
stultigis	stult'ig'is
stultulo	stult'ul'o
stultuloj	stult'ul'o'j
stultulojn	stult'ul'o'j'n
stultulon	stult'ul'o'n
stultulaĉo	stult'ul'aĉ'o
stultulino	stult'ul'in'o
stultumi	stult'um'i
stumblas	stumbl'as
stumble	stumbl'e
stumbli	stumbl'i
stumblis	stumbl'is
stumbloj	stumbl'o'j
stumblos	stumbl'os
stumblante	stumbl'ant'e
stumpa	stump'a
stumpo	stump'o
stumpoj	stump'o'j
stumpeto	stump'et'o
stumpigita	stump'ig'it'a
stumpigitaj	stump'ig'it'a'j
stupo	stup'o
stupao	stupa'o
stupaoj	stupa'o'j
stuporo	stupor'o
stuporiĝis	stupor'iĝ'is
sturgo	sturg'o
sturmas	sturm'as
sturmi	sturm'i
sturmis	sturm'is
sturmo	sturm'o
sturmon	sturm'o'n
sturno	sturn'o
sturnoj	sturn'o'j
sturnedoj	sturn'ed'o'j
sub	sub
suba	sub'a
subaj	sub'a'j
subajn	sub'a'j'n
suban	sub'a'n
sube	sub'e
suben	sub'e'n
subo	sub'o
subaĉeti	sub'aĉet'i
subaĉetis	sub'aĉet'is
subaĉeto	sub'aĉet'o
subaĉeton	sub'aĉet'o'n
subaĉetaĵoj	sub'aĉet'aĵ'o'j
subaĉetaĵojn	sub'aĉet'aĵ'o'j'n
subaĉetita	sub'aĉet'it'a
subaĉetitaj	sub'aĉet'it'a'j
subaĵo	sub'aĵ'o
subaĵoj	sub'aĵ'o'j
subaĵon	sub'aĵ'o'n
subakva	sub'akv'a
subakvaj	sub'akv'a'j
subakvajn	sub'akv'a'j'n
subakvan	sub'akv'a'n
subakve	sub'akv'e
subakvigi	sub'akv'ig'i
subakvigis	sub'akv'ig'is
subakvigita	sub'akv'ig'it'a
subakviĝas	sub'akv'iĝ'as
subakviĝi	sub'akv'iĝ'i
subakviĝis	sub'akv'iĝ'is
subakviĝo	sub'akv'iĝ'o
subaro	sub'ar'o
subaroj	sub'ar'o'j
subarojn	sub'ar'o'j'n
subaron	sub'ar'o'n
subaraknoida	sub'araknoid'a
subarkta	sub'arkt'a
subarktaj	sub'arkt'a'j
subatoma	sub'atom'a
subatomaj	sub'atom'a'j
subaŭskultas	sub'aŭskult'as
subaŭskulti	sub'aŭskult'i
subaŭskultis	sub'aŭskult'is
subaŭskultado	sub'aŭskult'ad'o
subaŭskultanto	sub'aŭskult'ant'o
subbrake	sub'brak'e
subbrako	sub'brak'o
subĉemizo	sub'ĉemiz'o
subĉiela	sub'ĉiel'a
subĉielaj	sub'ĉiel'a'j
subĉielajn	sub'ĉiel'a'j'n
subĉielan	sub'ĉiel'a'n
subĉiele	sub'ĉiel'e
subĉielaĵo	sub'ĉiel'aĵ'o
subdiakono	sub'diakon'o
subdialektoj	sub'dialekt'o'j
subdisciplinoj	sub'disciplin'o'j
subdistrikta	sub'distrikt'a
subdistrikto	sub'distrikt'o
subdividas	sub'divid'as
subdividi	sub'divid'i
subdivido	sub'divid'o
subdividoj	sub'divid'o'j
subdividojn	sub'divid'o'j'n
subdividon	sub'divid'o'n
subdividiĝas	sub'divid'iĝ'as
subdividita	sub'divid'it'a
subdividitaj	sub'divid'it'a'j
subdominanto	sub'domin'ant'o
subeniris	sub'e'n'ir'is
subesta	sub'est'a
subestaj	sub'est'a'j
subestajn	sub'est'a'j'n
subestan	sub'est'a'n
subestas	sub'est'as
subestro	sub'estr'o
subevoluo	sub'evolu'o
subevoluinta	sub'evolu'int'a
subevoluintaj	sub'evolu'int'a'j
subfako	sub'fak'o
subfakoj	sub'fak'o'j
subfamilio	sub'famili'o
subfamilioj	sub'famili'o'j
subfelo	sub'fel'o
subflugiloj	sub'flug'il'o'j
subformo	sub'form'o
subfosa	sub'fos'a
subfosaj	sub'fos'a'j
subfosas	sub'fos'as
subfosi	sub'fos'i
subfosis	sub'fos'is
subfosos	sub'fos'os
subfosus	sub'fos'us
subfosado	sub'fos'ad'o
subfosante	sub'fos'ant'e
subfosita	sub'fos'it'a
subfositaj	sub'fos'it'a'j
subfrazo	sub'fraz'o
subfrazoj	sub'fraz'o'j
subfrazojn	sub'fraz'o'j'n
subfrazon	sub'fraz'o'n
subgenro	sub'genr'o
subgrafeo	sub'grafe'o
subgrunda	sub'grund'a
subgrundaj	sub'grund'a'j
subgrunde	sub'grund'e
subgrundo	sub'grund'o
subgrupo	sub'grup'o
subgrupoj	sub'grup'o'j
subgrupojn	sub'grup'o'j'n
subgrupon	sub'grup'o'n
subĝenro	sub'ĝenr'o
subĝenroj	sub'ĝenr'o'j
subĝenrojn	sub'ĝenr'o'j'n
subĝenron	sub'ĝenr'o'n
subigas	sub'ig'as
subigi	sub'ig'i
subigis	sub'ig'is
subigo	sub'ig'o
subigon	sub'ig'o'n
subigado	sub'ig'ad'o
subigante	sub'ig'ant'e
subigita	sub'ig'it'a
subigitaj	sub'ig'it'a'j
subiĝas	sub'iĝ'as
subiĝi	sub'iĝ'i
subiĝis	sub'iĝ'is
subiĝo	sub'iĝ'o
subiras	sub'ir'as
subiri	sub'ir'i
subiris	sub'ir'is
subiro	sub'ir'o
subiros	sub'ir'os
subiranta	sub'ir'ant'a
subkampo	sub'kamp'o
subkampoj	sub'kamp'o'j
subkategorio	sub'kategori'o
subkategorioj	sub'kategori'o'j
subkategoriojn	sub'kategori'o'j'n
subklaso	sub'klas'o
subklasoj	sub'klas'o'j
subklasojn	sub'klas'o'j'n
subkolonelo	sub'kolonel'o
subkomisiono	sub'komision'o
subkomitato	sub'komitat'o
subkomitatoj	sub'komitat'o'j
subkomponentoj	sub'komponent'o'j
subkomprenas	sub'kompren'as
subkompreni	sub'kompren'i
subkomprenis	sub'kompren'is
subkomprenata	sub'kompren'at'a
subkomprenataj	sub'kompren'at'a'j
subkomprenigas	sub'kompren'ig'as
subkomprenita	sub'kompren'it'a
subkonscia	sub'konsci'a
subkonsciaj	sub'konsci'a'j
subkonscie	sub'konsci'e
subkonscio	sub'konsci'o
subkonscion	sub'konsci'o'n
subkonstruaĵo	sub'konstru'aĵ'o
subkonstruaĵoj	sub'konstru'aĵ'o'j
subkontinento	sub'kontinent'o
subkontinenton	sub'kontinent'o'n
subkontraktado	sub'kontrakt'ad'o
subkontraktitaj	sub'kontrakt'it'a'j
subkorteksaj	sub'korteks'a'j
subkreskaĵaro	sub'kresk'aĵ'ar'o
subkulturo	sub'kultur'o
subkulturoj	sub'kultur'o'j
subkuŝanta	sub'kuŝ'ant'a
submara	sub'mar'a
submaraj	sub'mar'a'j
submarajn	sub'mar'a'j'n
submaran	sub'mar'a'n
submarŝipa	sub'mar'ŝip'a
submarŝipo	sub'mar'ŝip'o
submarŝipoj	sub'mar'ŝip'o'j
submarŝipojn	sub'mar'ŝip'o'j'n
submarŝipon	sub'mar'ŝip'o'n
submastro	sub'mastr'o
submetas	sub'met'as
submeti	sub'met'i
submetis	sub'met'is
submetos	sub'met'os
submetu	sub'met'u
submetado	sub'met'ad'o
submetadoj	sub'met'ad'o'j
submetadon	sub'met'ad'o'n
submetante	sub'met'ant'e
submetata	sub'met'at'a
submetataj	sub'met'at'a'j
submetiĝas	sub'met'iĝ'as
submetiĝi	sub'met'iĝ'i
submetiĝis	sub'met'iĝ'is
submetiĝo	sub'met'iĝ'o
submetiĝon	sub'met'iĝ'o'n
submetiĝos	sub'met'iĝ'os
submetiĝu	sub'met'iĝ'u
submetiĝema	sub'met'iĝ'em'a
submetiĝemaj	sub'met'iĝ'em'a'j
submetinte	sub'met'int'e
submetita	sub'met'it'a
submetitaj	sub'met'it'a'j
submetitajn	sub'met'it'a'j'n
submetite	sub'met'it'e
subministro	sub'ministr'o
subministrojn	sub'ministr'o'j'n
submondo	sub'mond'o
submondon	sub'mond'o'n
submunicipoj	sub'municip'o'j
subnacia	sub'naci'a
subnaciaj	sub'naci'a'j
subnobelaro	sub'nobel'ar'o
subnutrado	sub'nutr'ad'o
subnutradon	sub'nutr'ad'o'n
subnutrita	sub'nutr'it'a
suboficiro	sub'oficir'o
suboficiroj	sub'oficir'o'j
subokula	sub'okul'a
suborbita	sub'orbit'a
subordo	sub'ord'o
subordigi	sub'ord'ig'i
subordigo	sub'ord'ig'o
subordigita	sub'ord'ig'it'a
subordigitaj	sub'ord'ig'it'a'j
subpartoj	sub'part'o'j
subpasejo	sub'pas'ej'o
subpasejoj	sub'pas'ej'o'j
subpluve	sub'pluv'e
subpopulacioj	sub'populaci'o'j
subporta	sub'port'a
subportan	sub'port'a'n
subprema	sub'prem'a
subpremaj	sub'prem'a'j
subpremajn	sub'prem'a'j'n
subpreman	sub'prem'a'n
subpremas	sub'prem'as
subpremi	sub'prem'i
subpremis	sub'prem'is
subpremo	sub'prem'o
subpremoj	sub'prem'o'j
subpremon	sub'prem'o'n
subpremu	sub'prem'u
subpremado	sub'prem'ad'o
subpremadon	sub'prem'ad'o'n
subpremanta	sub'prem'ant'a
subpremante	sub'prem'ant'e
subpremanto	sub'prem'ant'o
subpremantoj	sub'prem'ant'o'j
subpremata	sub'prem'at'a
subpremataj	sub'prem'at'a'j
subprematoj	sub'prem'at'o'j
subpremita	sub'prem'it'a
subpremitaj	sub'prem'it'a'j
subprogramo	sub'program'o
subprogramoj	sub'program'o'j
subpropozicio	sub'propozici'o
subpropozicioj	sub'propozici'o'j
subprovinco	sub'provinc'o
subpugo	sub'pug'o
subregiono	sub'region'o
subregionoj	sub'region'o'j
subregionojn	sub'region'o'j'n
subreprezentitaj	sub'reprezent'it'a'j
subridis	sub'rid'is
subrido	sub'rid'o
subridante	sub'rid'ant'e
subsahara	sub'sahar'a
subsaharaj	sub'sahar'a'j
subsaharan	sub'sahar'a'n
subsekcio	sub'sekci'o
subsekcioj	sub'sekci'o'j
subsekciojn	sub'sekci'o'j'n
subsistemo	sub'sistem'o
subsistemoj	sub'sistem'o'j
subsistemojn	sub'sistem'o'j'n
subskriba	sub'skrib'a
subskriban	sub'skrib'a'n
subskribas	sub'skrib'as
subskribi	sub'skrib'i
subskribis	sub'skrib'is
subskribo	sub'skrib'o
subskriboj	sub'skrib'o'j
subskribojn	sub'skrib'o'j'n
subskribon	sub'skrib'o'n
subskribos	sub'skrib'os
subskribu	sub'skrib'u
subskribus	sub'skrib'us
subskribado	sub'skrib'ad'o
subskribante	sub'skrib'ant'e
subskribintaj	sub'skrib'int'a'j
subskribinto	sub'skrib'int'o
subskribintoj	sub'skrib'int'o'j
subskribita	sub'skrib'it'a
subskribitaj	sub'skrib'it'a'j
subskribitan	sub'skrib'it'a'n
subsona	sub'son'a
subsonaj	sub'son'a'j
subspaco	sub'spac'o
subspecoj	sub'spec'o'j
subspecio	sub'speci'o
subspecioj	sub'speci'o'j
subspeciojn	sub'speci'o'j'n
subspecion	sub'speci'o'n
substacioj	sub'staci'o'j
substrekas	sub'strek'as
substreki	sub'strek'i
substrekis	sub'strek'is
substreko	sub'strek'o
substreku	sub'strek'u
substrekado	sub'strek'ad'o
substrekante	sub'strek'ant'e
substrekita	sub'strek'it'a
substrekitaj	sub'strek'it'a'j
substrukturo	sub'struktur'o
substrukturoj	sub'struktur'o'j
subsune	sub'sun'e
subsurfaca	sub'surfac'a
subŝtata	sub'ŝtat'a
subŝtataj	sub'ŝtat'a'j
subŝtato	sub'ŝtat'o
subŝtatoj	sub'ŝtat'o'j
subŝtofo	sub'ŝtof'o
subŝtofon	sub'ŝtof'o'n
subtaksas	sub'taks'as
subtaksi	sub'taks'i
subtaksis	sub'taks'is
subtakso	sub'taks'o
subtaksu	sub'taks'u
subtaksata	sub'taks'at'a
subtaksita	sub'taks'it'a
subtaksitaj	sub'taks'it'a'j
subtaso	sub'tas'o
subtavolo	sub'tavol'o
subtegmenta	sub'tegment'a
subtegmento	sub'tegment'o
subtegmentoj	sub'tegment'o'j
subtegmenton	sub'tegment'o'n
subtegmentejo	sub'tegment'ej'o
subteksto	sub'tekst'o
subtekstoj	sub'tekst'o'j
subtekstojn	sub'tekst'o'j'n
subtekstigis	sub'tekst'ig'is
subtekstigado	sub'tekst'ig'ad'o
subtekstigita	sub'tekst'ig'it'a
subtekstigitaj	sub'tekst'ig'it'a'j
subtemo	sub'tem'o
subtemoj	sub'tem'o'j
subtena	sub'ten'a
subtenaj	sub'ten'a'j
subtenajn	sub'ten'a'j'n
subtenan	sub'ten'a'n
subtenas	sub'ten'as
subtene	sub'ten'e
subteni	sub'ten'i
subtenis	sub'ten'is
subteno	sub'ten'o
subtenoj	sub'ten'o'j
subtenojn	sub'ten'o'j'n
subtenon	sub'ten'o'n
subtenos	sub'ten'os
subtenu	sub'ten'u
subtenus	sub'ten'us
subtenadi	sub'ten'ad'i
subtenadis	sub'ten'ad'is
subtenado	sub'ten'ad'o
subtenadon	sub'ten'ad'o'n
subtenanta	sub'ten'ant'a
subtenantaj	sub'ten'ant'a'j
subtenantan	sub'ten'ant'a'n
subtenante	sub'ten'ant'e
subtenanto	sub'ten'ant'o
subtenantoj	sub'ten'ant'o'j
subtenantojn	sub'ten'ant'o'j'n
subtenanton	sub'ten'ant'o'n
subtenata	sub'ten'at'a
subtenataj	sub'ten'at'a'j
subtenatan	sub'ten'at'a'n
subtenate	sub'ten'at'e
subtenemuloj	sub'ten'em'ul'o'j
subtenilo	sub'ten'il'o
subteniloj	sub'ten'il'o'j
subteninda	sub'ten'ind'a
subtenita	sub'ten'it'a
subtenitaj	sub'ten'it'a'j
subtenstrukturoj	sub'ten'struktur'o'j
subtera	sub'ter'a
subteraj	sub'ter'a'j
subterajn	sub'ter'a'j'n
subteran	sub'ter'a'n
subtere	sub'ter'e
subteren	sub'ter'e'n
subtero	sub'ter'o
subteraĵo	sub'ter'aĵ'o
subteraĵoj	sub'ter'aĵ'o'j
subteraĵon	sub'ter'aĵ'o'n
subterejo	sub'ter'ej'o
subtipo	sub'tip'o
subtipoj	sub'tip'o'j
subtitolo	sub'titol'o
subtitoloj	sub'titol'o'j
subtitolojn	sub'titol'o'j'n
subtitolon	sub'titol'o'n
subtropika	sub'tropik'a
subtropikaj	sub'tropik'a'j
subtropikan	sub'tropik'a'n
subtropikoj	sub'tropik'o'j
subturejo	sub'tur'ej'o
subulo	sub'ul'o
subuloj	sub'ul'o'j
subulojn	sub'ul'o'j'n
subulon	sub'ul'o'n
subunuo	sub'unu'o
subunuoj	sub'unu'o'j
suburbo	sub'urb'o
subventro	sub'ventr'o
subventron	sub'ventr'o'n
subvesto	sub'vest'o
subvestoj	sub'vest'o'j
subvestojn	sub'vest'o'j'n
subveston	sub'vest'o'n
subvortoj	sub'vort'o'j
subvostaj	sub'vost'a'j
subvosto	sub'vost'o
subalternaj	subaltern'a'j
subalternuloj	subaltern'ul'o'j
subdukcio	subdukci'o
subita	subit'a
subitaj	subit'a'j
subitajn	subit'a'j'n
subitan	subit'a'n
subite	subit'e
subito	subit'o
subiteco	subit'ec'o
subitmorto	subit'mort'o
subjekta	subjekt'a
subjekto	subjekt'o
subjektoj	subjekt'o'j
subjektojn	subjekt'o'j'n
subjekton	subjekt'o'n
subjektiva	subjektiv'a
subjektivaj	subjektiv'a'j
subjektivajn	subjektiv'a'j'n
subjektivan	subjektiv'a'n
subjektive	subjektiv'e
subjektiveco	subjektiv'ec'o
subjektivecon	subjektiv'ec'o'n
subjektivismo	subjektiv'ism'o
subjunkcio	subjunkci'o
subjunkcioj	subjunkci'o'j
subjunktivo	subjunktiv'o
subjunktivon	subjunktiv'o'n
sublima	sublim'a
subliman	sublim'a'n
sublimo	sublim'o
sublimado	sublim'ad'o
subsidiareco	subsidiar'ec'o
substanca	substanc'a
substancaj	substanc'a'j
substancan	substanc'a'n
substance	substanc'e
substanco	substanc'o
substancoj	substanc'o'j
substancojn	substanc'o'j'n
substancon	substanc'o'n
substantiva	substantiv'a
substantivaj	substantiv'a'j
substantivajn	substantiv'a'j'n
substantivan	substantiv'a'n
substantive	substantiv'e
substantivo	substantiv'o
substantivoj	substantiv'o'j
substantivojn	substantiv'o'j'n
substantivon	substantiv'o'n
substitui	substitu'i
substrato	substrat'o
substratoj	substrat'o'j
substratojn	substrat'o'j'n
substraton	substrat'o'n
subtila	subtil'a
subtilaj	subtil'a'j
subtilajn	subtil'a'j'n
subtilan	subtil'a'n
subtile	subtil'e
subtilaĵoj	subtil'aĵ'o'j
subtileco	subtil'ec'o
subtrahas	subtrah'as
subtrahi	subtrah'i
subtrahis	subtrah'is
subtraho	subtrah'o
subtrahante	subtrah'ant'e
subtrahita	subtrah'it'a
subtrahitaj	subtrah'it'a'j
subvencias	subvenci'as
subvencii	subvenci'i
subvenciis	subvenci'is
subvencio	subvenci'o
subvencioj	subvenci'o'j
subvenciojn	subvenci'o'j'n
subvencion	subvenci'o'n
subvenciado	subvenci'ad'o
subvenciata	subvenci'at'a
subvenciita	subvenci'it'a
subvenciitaj	subvenci'it'a'j
suĉas	suĉ'as
suĉi	suĉ'i
suĉis	suĉ'is
suĉo	suĉ'o
suĉado	suĉ'ad'o
suĉante	suĉ'ant'e
suĉinfano	suĉ'infan'o
suĉinfanoj	suĉ'infan'o'j
suĉita	suĉ'it'a
suda	sud'a
sudaj	sud'a'j
sudajn	sud'a'j'n
sudan	sud'a'n
sude	sud'e
suden	sud'e'n
sudo	sud'o
sudon	sud'o'n
sudaazianaj	sud'a'azi'an'a'j
sudafrika	sud'afrik'a
sudafrikaj	sud'afrik'a'j
sudafrikan	sud'afrik'a'n
sudafriko	sud'afrik'o
sudafrikon	sud'afrik'o'n
sudafrikano	sud'afrik'an'o
sudafrikanoj	sud'afrik'an'o'j
sudamerika	sud'amerik'a
sudamerikaj	sud'amerik'a'j
sudameriko	sud'amerik'o
sudamerikon	sud'amerik'o'n
sudamerikano	sud'amerik'an'o
sudamerikanoj	sud'amerik'an'o'j
sudana	sud'an'a
sudanaj	sud'an'a'j
sudano	sud'an'o
sudanoj	sud'an'o'j
sudanon	sud'an'o'n
sudanglo	sud'angl'o
sudaŭstralio	sud'aŭstrali'o
sudazia	sud'azi'a
sudaziaj	sud'azi'a'j
sudazio	sud'azi'o
sudbordo	sud'bord'o
sudcentra	sud'centr'a
sudĉina	sud'ĉin'a
sudeŭropaj	sud'eŭrop'a'j
sudeŭropo	sud'eŭrop'o
sudfranca	sud'franc'a
sudgeorgio	sud'georgi'o
sudgermana	sud'german'a
sudhemisfera	sud'hemisfer'a
sudkorea	sud'kore'a
sudkoreaj	sud'kore'a'j
sudkoreio	sud'kore'i'o
sudkoreion	sud'kore'i'o'n
sudokcidenta	sud'okcident'a
sudokcidentaj	sud'okcident'a'j
sudokcidentan	sud'okcident'a'n
sudokcidente	sud'okcident'e
sudokcidenten	sud'okcident'e'n
sudokcidento	sud'okcident'o
sudokcidentazia	sud'okcident'azi'a
sudokcidentaziaj	sud'okcident'azi'a'j
sudorienta	sud'orient'a
sudorientaj	sud'orient'a'j
sudorientan	sud'orient'a'n
sudoriente	sud'orient'e
sudorienten	sud'orient'e'n
sudoriento	sud'orient'o
sudorientazia	sud'orient'azi'a
sudorientaziaj	sud'orient'azi'a'j
sudorientazio	sud'orient'azi'o
sudosetio	sud'oset'i'o
sudsuda	sud'sud'a
sudsudano	sud'sudan'o
sudŝtatoj	sud'ŝtat'o'j
sudŝtatojn	sud'ŝtat'o'j'n
sudtirolo	sud'tirol'o
suduloj	sud'ul'o'j
sudana	sudan'a
sudanaj	sudan'a'j
sudano	sudan'o
sudanoj	sudan'o'j
sudanon	sudan'o'n
sufera	sufer'a
suferas	sufer'as
sufere	sufer'e
suferi	sufer'i
suferis	sufer'is
sufero	sufer'o
suferoj	sufer'o'j
suferojn	sufer'o'j'n
suferon	sufer'o'n
suferos	sufer'os
suferu	sufer'u
suferus	sufer'us
suferadis	sufer'ad'is
suferado	sufer'ad'o
suferadon	sufer'ad'o'n
suferanta	sufer'ant'a
suferantaj	sufer'ant'a'j
suferantajn	sufer'ant'a'j'n
suferantan	sufer'ant'a'n
suferante	sufer'ant'e
suferanto	sufer'ant'o
suferantoj	sufer'ant'o'j
suferantojn	sufer'ant'o'j'n
suferanton	sufer'ant'o'n
suferegis	sufer'eg'is
suferiga	sufer'ig'a
suferigan	sufer'ig'a'n
suferigas	sufer'ig'as
suferige	sufer'ig'e
suferigi	sufer'ig'i
suferigis	sufer'ig'is
suferigos	sufer'ig'os
suferinta	sufer'int'a
suferintaj	sufer'int'a'j
suferinte	sufer'int'e
suferintoj	sufer'int'o'j
suferita	sufer'it'a
suferitaj	sufer'it'a'j
suferplena	sufer'plen'a
suferspertas	sufer'spert'as
sufersperti	sufer'spert'i
suferspertis	sufer'spert'is
suferspertante	sufer'spert'ant'e
sufiĉa	sufiĉ'a
sufiĉaj	sufiĉ'a'j
sufiĉajn	sufiĉ'a'j'n
sufiĉan	sufiĉ'a'n
sufiĉas	sufiĉ'as
sufiĉe	sufiĉ'e
sufiĉi	sufiĉ'i
sufiĉis	sufiĉ'is
sufiĉo	sufiĉ'o
sufiĉon	sufiĉ'o'n
sufiĉos	sufiĉ'os
sufiĉu	sufiĉ'u
sufiĉus	sufiĉ'us
sufiĉeco	sufiĉ'ec'o
sufiksa	sufiks'a
sufikso	sufiks'o
sufiksoj	sufiks'o'j
sufiksojn	sufiks'o'j'n
sufikson	sufiks'o'n
sufiksigo	sufiks'ig'o
sufiksita	sufiks'it'a
sufloras	suflor'as
suflori	suflor'i
sufloris	suflor'is
sufoka	sufok'a
sufokaj	sufok'a'j
sufokan	sufok'a'n
sufokas	sufok'as
sufoke	sufok'e
sufoki	sufok'i
sufokis	sufok'is
sufoko	sufok'o
sufokon	sufok'o'n
sufokado	sufok'ad'o
sufokanta	sufok'ant'a
sufokante	sufok'ant'e
sufokata	sufok'at'a
sufokiĝas	sufok'iĝ'as
sufokiĝi	sufok'iĝ'i
sufokiĝis	sufok'iĝ'is
sufokiĝo	sufok'iĝ'o
sufokiĝante	sufok'iĝ'ant'e
sufokita	sufok'it'a
sufokitaj	sufok'it'a'j
sugesta	sugest'a
sugestas	sugest'as
sugesti	sugest'i
sugestis	sugest'is
sugesto	sugest'o
sugestoj	sugest'o'j
sugestojn	sugest'o'j'n
sugeston	sugest'o'n
sugestos	sugest'os
sugestu	sugest'u
sugestus	sugest'us
sugestado	sugest'ad'o
sugestanta	sugest'ant'a
sugestantaj	sugest'ant'a'j
sugestante	sugest'ant'e
sugestita	sugest'it'a
sugestitaj	sugest'it'a'j
sugestite	sugest'it'e
sugestia	sugesti'a
sugestiaj	sugesti'a'j
sugestio	sugesti'o
suicidis	suicid'is
suicido	suicid'o
suicidon	suicid'o'n
suite	suit'e
suito	suit'o
suitoj	suit'o'j
suka	suk'a
sukaj	suk'a'j
sukan	suk'a'n
suko	suk'o
sukoj	suk'o'j
sukojn	suk'o'j'n
sukon	suk'o'n
sukoplena	suk'o'plen'a
sukoplenaj	suk'o'plen'a'j
sukcedi	sukced'i
sukcedis	sukced'is
sukcedo	sukced'o
sukcedado	sukced'ad'o
sukcedante	sukced'ant'e
sukcedanto	sukced'ant'o
sukcedita	sukced'it'a
sukcena	sukcen'a
sukcenaj	sukcen'a'j
sukceno	sukcen'o
sukcenon	sukcen'o'n
sukcenata	sukcen'at'a
sukcenato	sukcen'at'o
sukcesa	sukces'a
sukcesaj	sukces'a'j
sukcesajn	sukces'a'j'n
sukcesan	sukces'a'n
sukcesas	sukces'as
sukcese	sukces'e
sukcesi	sukces'i
sukcesis	sukces'is
sukceso	sukces'o
sukcesoj	sukces'o'j
sukcesojn	sukces'o'j'n
sukceson	sukces'o'n
sukcesos	sukces'os
sukcesu	sukces'u
sukcesus	sukces'us
sukcesadis	sukces'ad'is
sukcesanta	sukces'ant'a
sukcesante	sukces'ant'e
sukcesega	sukces'eg'a
sukcesigi	sukces'ig'i
sukcesigis	sukces'ig'is
sukcesigo	sukces'ig'o
sukcesinta	sukces'int'a
sukcesintaj	sukces'int'a'j
sukcesinte	sukces'int'e
sukcesintoj	sukces'int'o'j
sukcesintus	sukces'int'us
sukcesita	sukces'it'a
sukcesplena	sukces'plen'a
sukcesplene	sukces'plen'e
sukera	suker'a
sukeraj	suker'a'j
sukeran	suker'a'n
sukero	suker'o
sukeroj	suker'o'j
sukerojn	suker'o'j'n
sukeron	suker'o'n
sukeraĵo	suker'aĵ'o
sukeraĵoj	suker'aĵ'o'j
sukeraĵojn	suker'aĵ'o'j'n
sukeraĵejo	suker'aĵ'ej'o
sukeraĵejoj	suker'aĵ'ej'o'j
sukerbeto	suker'bet'o
sukerbetoj	suker'bet'o'j
sukerita	suker'it'a
sukerkana	suker'kan'a
sukerkano	suker'kan'o
sukerkanoj	suker'kan'o'j
sukerkanojn	suker'kan'o'j'n
sukerkanon	suker'kan'o'n
sukerujo	suker'uj'o
sukulentaj	sukulent'a'j
sukulentoj	sukulent'o'j
sukuro	sukur'o
sukuristo	sukur'ist'o
sukuristoj	sukur'ist'o'j
sulfata	sulf'at'a
sulfatan	sulf'at'a'n
sulfato	sulf'at'o
sulfatoj	sulf'at'o'j
sulfaton	sulf'at'o'n
sulfida	sulf'id'a
sulfido	sulf'id'o
sulfidoj	sulf'id'o'j
sulfidon	sulf'id'o'n
sulfita	sulf'it'a
sulfito	sulf'it'o
sulfonata	sulfon'at'a
sulfura	sulfur'a
sulfuraj	sulfur'a'j
sulfuran	sulfur'a'n
sulfuro	sulfur'o
sulfuron	sulfur'o'n
sulfuratomoj	sulfur'atom'o'j
sulka	sulk'a
sulkis	sulk'is
sulko	sulk'o
sulkoj	sulk'o'j
sulkojn	sulk'o'j'n
sulkon	sulk'o'n
sulkante	sulk'ant'e
sulketoj	sulk'et'o'j
sulkigas	sulk'ig'as
sulkigis	sulk'ig'is
sulkigante	sulk'ig'ant'e
sulkigita	sulk'ig'it'a
sulkiĝis	sulk'iĝ'is
sulkoplena	sulk'o'plen'a
sultano	sultan'o
sultanoj	sultan'o'j
sultanon	sultan'o'n
sultanino	sultan'in'o
sultanlando	sultan'land'o
sultanlandoj	sultan'land'o'j
suma	sum'a
suman	sum'a'n
sume	sum'e
sumo	sum'o
sumoj	sum'o'j
sumojn	sum'o'j'n
sumon	sum'o'n
sumenergio	sum'energi'o
sumigas	sum'ig'as
sumigi	sum'ig'i
sumigis	sum'ig'is
sumigo	sum'ig'o
sumigilo	sum'ig'il'o
sumigita	sum'ig'it'a
sumigitaj	sum'ig'it'a'j
sumiĝas	sum'iĝ'as
sumiĝi	sum'iĝ'i
sumiĝis	sum'iĝ'is
sumatra	sumatr'a
sumatro	sumatr'o
sumera	sumer'a
sumeraj	sumer'a'j
sumero	sumer'o
sumeroj	sumer'o'j
sumerano	sumer'an'o
sumeranoj	sumer'an'o'j
sumoo	sumo'o
suna	sun'a
sunaj	sun'a'j
sunajn	sun'a'j'n
sunan	sun'a'n
sunas	sun'as
sune	sun'e
suno	sun'o
sunoj	sun'o'j
sunojn	sun'o'j'n
sunon	sun'o'n
sunbrila	sun'bril'a
sunbrilo	sun'bril'o
sunbrilon	sun'bril'o'n
sunbruna	sun'brun'a
sunbrunaj	sun'brun'a'j
sunbruno	sun'brun'o
sunbrunigita	sun'brun'ig'it'a
sunbruniĝi	sun'brun'iĝ'i
suncentrismo	sun'centr'ism'o
sunĉelo	sun'ĉel'o
sunĉeloj	sun'ĉel'o'j
sunĉelojn	sun'ĉel'o'j'n
sundio	sun'di'o
sundisko	sun'disk'o
sunenergia	sun'energi'a
sunenergiaj	sun'energi'a'j
sunenergiajn	sun'energi'a'j'n
sunenergio	sun'energi'o
sunenergion	sun'energi'o'n
sunfloro	sun'flor'o
sunfloroj	sun'flor'o'j
sunfrapo	sun'frap'o
sunhorloĝo	sun'horloĝ'o
sunkaldronoj	sun'kaldron'o'j
sunkremo	sun'krem'o
sunleviĝo	sun'lev'iĝ'o
sunleviĝon	sun'lev'iĝ'o'n
sunluma	sun'lum'a
sunlumo	sun'lum'o
sunlumon	sun'lum'o'n
sunmakuloj	sun'makul'o'j
sunokulvitroj	sun'okul'vitr'o'j
sunokulvitrojn	sun'okul'vitr'o'j'n
sunombrelo	sun'ombrel'o
sunombrelon	sun'ombrel'o'n
sunpanelo	sun'panel'o
sunpaneloj	sun'panel'o'j
sunpanelojn	sun'panel'o'j'n
sunperiodo	sun'period'o
sunplena	sun'plen'a
sunradio	sun'radi'o
sunradioj	sun'radi'o'j
sunradiojn	sun'radi'o'j'n
sunradiado	sun'radi'ad'o
sunsistemo	sun'sistem'o
sunsistemoj	sun'sistem'o'j
sunsistemon	sun'sistem'o'n
sunsubiro	sun'sub'ir'o
sunsubiroj	sun'sub'ir'o'j
sunsubiron	sun'sub'ir'o'n
sunumas	sun'um'as
sunumi	sun'um'i
sunumis	sun'um'is
sunumado	sun'um'ad'o
sunaa	suna'a
sunaaj	suna'a'j
sunao	suna'o
sunaisma	suna'ism'a
sunaismaj	suna'ism'a'j
sunaismo	suna'ism'o
sunaisto	suna'ist'o
sunaistoj	suna'ist'o'j
supo	sup'o
supoj	sup'o'j
supojn	sup'o'j'n
supon	sup'o'n
supujo	sup'uj'o
supujon	sup'uj'o'n
super	super
supera	super'a
superaj	super'a'j
superajn	super'a'j'n
superan	super'a'n
superas	super'as
supere	super'e
superi	super'i
superis	super'is
supero	super'o
superos	super'os
superu	super'u
superus	super'us
superabundo	super'abund'o
superado	super'ad'o
superanta	super'ant'a
superantaj	super'ant'a'j
superante	super'ant'e
superata	super'at'a
superbazaro	super'bazar'o
superbazaroj	super'bazar'o'j
superbazaron	super'bazar'o'n
superbela	super'bel'a
superbrilis	super'bril'is
superdimensia	super'dimensi'a
superdozo	super'doz'o
superebla	super'ebl'a
supereca	super'ec'a
superece	super'ec'e
supereco	super'ec'o
superecoj	super'ec'o'j
superecon	super'ec'o'n
superega	super'eg'a
superfamilio	super'famili'o
superflua	super'flu'a
superfluaj	super'flu'a'j
superfluajn	super'flu'a'j'n
superfluan	super'flu'a'n
superfluas	super'flu'as
superflue	super'flu'e
superfluis	super'flu'is
superfluo	super'flu'o
superfluaĵo	super'flu'aĵ'o
superfluigas	super'flu'ig'as
superflugis	super'flug'is
superforta	super'fort'a
superfortaj	super'fort'a'j
superfortan	super'fort'a'n
superfortas	super'fort'as
superforte	super'fort'e
superforti	super'fort'i
superfortis	super'fort'is
superforto	super'fort'o
superfortos	super'fort'os
superfortado	super'fort'ad'o
superfortante	super'fort'ant'e
superfortita	super'fort'it'a
superfortitaj	super'fort'it'a'j
superheroo	super'hero'o
superherooj	super'hero'o'j
superhoma	super'hom'a
superhomaj	super'hom'a'j
superhomajn	super'hom'a'j'n
superhoman	super'hom'a'n
superhomo	super'hom'o
superinte	super'int'e
superinteligenteco	super'inteligent'ec'o
superita	super'it'a
superitaj	super'it'a'j
superjaro	super'jar'o
superklasa	super'klas'a
superklasaj	super'klas'a'j
superkomputilo	super'komput'il'o
superkomputiloj	super'komput'il'o'j
superkondensatoro	super'kondensator'o
superkondensatoroj	super'kondensator'o'j
superkondukanto	super'konduk'ant'o
superkondukantoj	super'konduk'ant'o'j
superkondukta	super'kondukt'a
superkonduktaj	super'kondukt'a'j
superkonduktivo	super'kondukt'iv'o
superkonstruaĵo	super'konstru'aĵ'o
superkreskitaj	super'kresk'it'a'j
superkritika	super'kritik'a
superlikvaĵo	super'likv'aĵ'o
supermalfacila	super'mal'facil'a
supermalfacilaj	super'mal'facil'a'j
supermerkato	super'merkat'o
supermerkatoj	super'merkat'o'j
supermeto	super'met'o
supermetado	super'met'ad'o
supermetita	super'met'it'a
supermetitaj	super'met'it'a'j
supermezura	super'mezur'a
supermezure	super'mezur'e
supernacia	super'naci'a
supernaciaj	super'naci'a'j
supernacian	super'naci'a'n
supernatura	super'natur'a
supernaturaj	super'natur'a'j
supernaturajn	super'natur'a'j'n
supernaturan	super'natur'a'n
supernature	super'natur'e
supernaturo	super'natur'o
supernovao	super'nova'o
supernovaoj	super'nova'o'j
superoksido	super'oksid'o
superokula	super'okul'a
superokulan	super'okul'a'n
superpago	super'pag'o
superpagoj	super'pag'o'j
superpagon	super'pag'o'n
superpasi	super'pas'i
superpezas	super'pez'as
superpezi	super'pez'i
superpezis	super'pez'is
superplena	super'plen'a
superplenaj	super'plen'a'j
superplenigis	super'plen'ig'is
superpotenco	super'potenc'o
superpotencoj	super'potenc'o'j
superpremo	super'prem'o
superrapida	super'rapid'a
superrapidaj	super'rapid'a'j
superreala	super'real'a
superrealaj	super'real'a'j
superrealisma	super'real'ism'a
superrealismo	super'real'ism'o
superrega	super'reg'a
superregaj	super'reg'a'j
superregan	super'reg'a'n
superregas	super'reg'as
superregi	super'reg'i
superregis	super'reg'is
superrego	super'reg'o
superregon	super'reg'o'n
superregos	super'reg'os
superregado	super'reg'ad'o
superregadon	super'reg'ad'o'n
superreganta	super'reg'ant'a
superregantaj	super'reg'ant'a'j
superregante	super'reg'ant'e
superregata	super'reg'at'a
superrigardas	super'rigard'as
superrigardi	super'rigard'i
superrigardis	super'rigard'is
superrigardo	super'rigard'o
superrigardon	super'rigard'o'n
superruzi	super'ruz'i
superruzis	super'ruz'is
supersaturiĝo	super'satur'iĝ'o
superseksa	super'seks'a
superseksaj	super'seks'a'j
supersignaj	super'sign'a'j
supersigno	super'sign'o
supersignoj	super'sign'o'j
supersignojn	super'sign'o'j'n
supersignitaj	super'sign'it'a'j
supersignitajn	super'sign'it'a'j'n
supersimetrio	super'simetri'o
supersistemo	super'sistem'o
supersojla	super'sojl'a
supersona	super'son'a
supersonaj	super'son'a'j
supersonan	super'son'a'n
superspecion	super'speci'o'n
superstaras	super'star'as
superstrukturo	super'struktur'o
superŝarĝo	super'ŝarĝ'o
superŝarĝita	super'ŝarĝ'it'a
superŝtatoj	super'ŝtat'o'j
superŝutas	super'ŝut'as
superŝuti	super'ŝut'i
superŝutis	super'ŝut'is
superŝutita	super'ŝut'it'a
superŝutitaj	super'ŝut'it'a'j
supertaksas	super'taks'as
supertaksi	super'taks'i
supertaksis	super'taks'is
supertera	super'ter'a
superteraj	super'ter'a'j
supertuto	super'tut'o
supertuton	super'tut'o'n
superulo	super'ul'o
superuloj	super'ul'o'j
superulojn	super'ul'o'j'n
superulon	super'ul'o'n
supervarmigita	super'varm'ig'it'a
supervendejoj	super'vend'ej'o'j
supervenki	super'venk'i
supervenkis	super'venk'is
superverŝas	super'verŝ'as
superverŝis	super'verŝ'is
superverŝita	super'verŝ'it'a
supervesto	super'vest'o
superveston	super'vest'o'n
supervidon	super'vid'o'n
superviro	super'vir'o
supervivas	super'viv'as
supervivi	super'viv'i
supervivis	super'viv'is
supervivo	super'viv'o
supervivoj	super'viv'o'j
supervivon	super'viv'o'n
supervivos	super'viv'os
supervivantoj	super'viv'ant'o'j
supervivintoj	super'viv'int'o'j
superba	superb'a
superbaj	superb'a'j
superban	superb'a'n
superlativo	superlativ'o
superstiĉa	superstiĉ'a
superstiĉaj	superstiĉ'a'j
superstiĉo	superstiĉ'o
superstiĉoj	superstiĉ'o'j
superstiĉojn	superstiĉ'o'j'n
superstiĉon	superstiĉ'o'n
supla	supl'a
suplementa	suplement'a
suplementaj	suplement'a'j
suplementajn	suplement'a'j'n
suplementan	suplement'a'n
suplementi	suplement'i
suplemento	suplement'o
suplementoj	suplement'o'j
suplementojn	suplement'o'j'n
suplementon	suplement'o'n
suplementado	suplement'ad'o
supoza	supoz'a
supozas	supoz'as
supoze	supoz'e
supozi	supoz'i
supozis	supoz'is
supozo	supoz'o
supozoj	supoz'o'j
supozojn	supoz'o'j'n
supozon	supoz'o'n
supozos	supoz'os
supozu	supoz'u
supozus	supoz'us
supozado	supoz'ad'o
supozanta	supoz'ant'a
supozante	supoz'ant'e
supozata	supoz'at'a
supozataj	supoz'at'a'j
supozatan	supoz'at'a'n
supozate	supoz'at'e
supozebla	supoz'ebl'a
supozeblaj	supoz'ebl'a'j
supozeblan	supoz'ebl'a'n
supozeblas	supoz'ebl'as
supozeble	supoz'ebl'e
supozigas	supoz'ig'as
supozigi	supoz'ig'i
supozigis	supoz'ig'is
supozita	supoz'it'a
supozitaj	supoz'it'a'j
supozitajn	supoz'it'a'j'n
supozitan	supoz'it'a'n
supozite	supoz'it'e
supra	supr'a
supraj	supr'a'j
suprajn	supr'a'j'n
supran	supr'a'n
supre	supr'e
supren	supr'e'n
supro	supr'o
suproj	supr'o'j
suprojn	supr'o'j'n
supron	supr'o'n
supragermanaj	supr'a'german'a'j
supramolekula	supr'a'molekul'a
supranivela	supr'a'nivel'a
supratono	supr'a'ton'o
supratonoj	supr'a'ton'o'j
supraĵa	supr'aĵ'a
supraĵaj	supr'aĵ'a'j
supraĵajn	supr'aĵ'a'j'n
supraĵan	supr'aĵ'a'n
suprajhe	supr'aĵ'e
supraĵe	supr'aĵ'e
supraĵo	supr'aĵ'o
supraĵoj	supr'aĵ'o'j
supraĵon	supr'aĵ'o'n
supremenciita	supr'e'menci'it'a
supremenciitaj	supr'e'menci'it'a'j
suprendirektita	supr'e'n'direkt'it'a
suprendirektitan	supr'e'n'direkt'it'a'n
suprenfluo	supr'e'n'flu'o
suprengrimpi	supr'e'n'grimp'i
suprengrimpis	supr'e'n'grimp'is
suprenigi	supr'e'n'ig'i
suprenigis	supr'e'n'ig'is
supreniĝas	supr'e'n'iĝ'as
supreniĝi	supr'e'n'iĝ'i
supreniĝis	supr'e'n'iĝ'is
suprenira	supr'e'n'ir'a
supreniras	supr'e'n'ir'as
supreniri	supr'e'n'ir'i
supreniris	supr'e'n'ir'is
supreniro	supr'e'n'ir'o
supreniron	supr'e'n'ir'o'n
supreniros	supr'e'n'ir'os
supreniru	supr'e'n'ir'u
suprenirado	supr'e'n'ir'ad'o
supreniranta	supr'e'n'ir'ant'a
suprenirante	supr'e'n'ir'ant'e
suprenkuris	supr'e'n'kur'is
suprenlevi	supr'e'n'lev'i
suprenlevis	supr'e'n'lev'is
suprenlevita	supr'e'n'lev'it'a
suprenrampis	supr'e'n'ramp'is
suprenrigardis	supr'e'n'rigard'is
suprensaltis	supr'e'n'salt'is
suprentiri	supr'e'n'tir'i
suprentiris	supr'e'n'tir'is
suprenmalsupren	supr'en'mal'supr'e'n
suprotono	supr'o'ton'o
suprotonoj	supr'o'ton'o'j
suprema	suprem'a
supreme	suprem'e
sur	sur
sura	sur'a
suro	sur'o
surakva	sur'akv'a
surakve	sur'akv'e
surakviĝis	sur'akv'iĝ'is
surarbe	sur'arb'e
surbaze	sur'baz'e
surbendigas	sur'bend'ig'as
surbendigi	sur'bend'ig'i
surbendigis	sur'bend'ig'is
surbendigo	sur'bend'ig'o
surbendigoj	sur'bend'ig'o'j
surbendigita	sur'bend'ig'it'a
surbendigitaj	sur'bend'ig'it'a'j
surborde	sur'bord'e
surbordiĝis	sur'bord'iĝ'is
surbrake	sur'brak'e
surbruste	sur'brust'e
surĉevala	sur'ĉeval'a
surĉevalaj	sur'ĉeval'a'j
surĉevalan	sur'ĉeval'a'n
surĉevale	sur'ĉeval'e
surĉevaliĝis	sur'ĉeval'iĝ'is
surĉiele	sur'ĉiel'e
surdiskigis	sur'disk'ig'is
surdiskigoj	sur'disk'ig'o'j
surdorse	sur'dors'e
surdorsen	sur'dors'e'n
surekrana	sur'ekran'a
surekranaj	sur'ekran'a'j
surekranan	sur'ekran'a'n
surekrane	sur'ekran'e
surfadenigita	sur'faden'ig'it'a
surfingre	sur'fingr'e
surfingrebligaj	sur'fingr'ebl'ig'a'j
surflanke	sur'flank'e
surflugis	sur'flug'is
surfone	sur'fon'e
surfrunte	sur'frunt'e
surgenue	sur'genu'e
surgenuen	sur'genu'e'n
surgenuiĝas	sur'genu'iĝ'as
surgenuiĝi	sur'genu'iĝ'i
surgenuiĝis	sur'genu'iĝ'is
surgenuiĝante	sur'genu'iĝ'ant'e
surgrimpas	sur'grimp'as
surgrimpi	sur'grimp'i
surgrimpis	sur'grimp'is
surgrimpado	sur'grimp'ad'o
surgrimpante	sur'grimp'ant'e
surgrimpita	sur'grimp'it'a
surgrimpitaj	sur'grimp'it'a'j
surgrunda	sur'grund'a
surgrunde	sur'grund'e
surgrunden	sur'grund'e'n
surgrundiĝis	sur'grund'iĝ'is
surhavas	sur'hav'as
surhavi	sur'hav'i
surhavis	sur'hav'is
surhavos	sur'hav'os
surhavu	sur'hav'u
surhavanta	sur'hav'ant'a
surhavante	sur'hav'ant'e
surhokigos	sur'hok'ig'os
suriras	sur'ir'as
suriri	sur'ir'i
suriris	sur'ir'is
suriru	sur'ir'u
surirado	sur'ir'ad'o
surirante	sur'ir'ant'e
surĵetis	sur'ĵet'is
surkampe	sur'kamp'e
surkape	sur'kap'e
surkreskaĵo	sur'kresk'aĵ'o
surkruce	sur'kruc'e
surlipe	sur'lip'e
surlite	sur'lit'e
surloka	sur'lok'a
surlokaj	sur'lok'a'j
surlokajn	sur'lok'a'j'n
surlokan	sur'lok'a'n
surloke	sur'lok'e
surluniĝis	sur'lun'iĝ'is
surmane	sur'man'e
surmape	sur'map'e
surmara	sur'mar'a
surmaraj	sur'mar'a'j
surmaran	sur'mar'a'n
surmare	sur'mar'e
surmariĝis	sur'mar'iĝ'is
surmerkatiga	sur'merkat'ig'a
surmerkatigaj	sur'merkat'ig'a'j
surmerkatigan	sur'merkat'ig'a'n
surmerkatigas	sur'merkat'ig'as
surmerkatigi	sur'merkat'ig'i
surmerkatigis	sur'merkat'ig'is
surmerkatigo	sur'merkat'ig'o
surmerkatigado	sur'merkat'ig'ad'o
surmerkatigante	sur'merkat'ig'ant'e
surmerkatigita	sur'merkat'ig'it'a
surmerkatigitaj	sur'merkat'ig'it'a'j
surmetas	sur'met'as
surmeti	sur'met'i
surmetis	sur'met'is
surmeto	sur'met'o
surmetos	sur'met'os
surmetu	sur'met'u
surmetus	sur'met'us
surmetado	sur'met'ad'o
surmetante	sur'met'ant'e
surmetiĝas	sur'met'iĝ'as
surmetinte	sur'met'int'e
surmetita	sur'met'it'a
surmetitaj	sur'met'it'a'j
surmonta	sur'mont'a
surmontras	sur'montr'as
surmura	sur'mur'a
surmuraj	sur'mur'a'j
surmure	sur'mur'e
surpapera	sur'paper'a
surpaperaj	sur'paper'a'j
surpapere	sur'paper'e
surpaperigas	sur'paper'ig'as
surpaperigi	sur'paper'ig'i
surpaperigis	sur'paper'ig'is
surpaperigita	sur'paper'ig'it'a
surpaperigitaj	sur'paper'ig'it'a'j
surpaŝi	sur'paŝ'i
surpaŝis	sur'paŝ'is
surpiede	sur'pied'e
surpiediĝis	sur'pied'iĝ'is
surplanka	sur'plank'a
surplanke	sur'plank'e
surplanken	sur'plank'e'n
surportas	sur'port'as
surporti	sur'port'i
surportis	sur'port'is
surportante	sur'port'ant'e
surprenas	sur'pren'as
surpreni	sur'pren'i
surprenis	sur'pren'is
surprenu	sur'pren'u
surpresita	sur'pres'it'a
surprovi	sur'prov'i
surprovis	sur'prov'is
surprovu	sur'prov'u
surradiado	sur'radi'ad'o
surrealismo	sur'real'ism'o
surrenaj	sur'ren'a'j
surreta	sur'ret'a
surretaj	sur'ret'a'j
surretan	sur'ret'a'n
surrete	sur'ret'e
surrokaj	sur'rok'a'j
sursaltis	sur'salt'is
sursceneja	sur'scen'ej'a
sursceneje	sur'scen'ej'e
surscenejiĝis	sur'scen'ej'iĝ'is
surscenigis	sur'scen'ig'is
surscenigo	sur'scen'ig'o
surscenigoj	sur'scen'ig'o'j
surskribi	sur'skrib'i
surskribis	sur'skrib'is
surskribo	sur'skrib'o
surskriboj	sur'skrib'o'j
surskribojn	sur'skrib'o'j'n
surskribon	sur'skrib'o'n
surskribaĵo	sur'skrib'aĵ'o
surskribita	sur'skrib'it'a
surskribitaj	sur'skrib'it'a'j
sursojle	sur'sojl'e
surstrande	sur'strand'e
surstrata	sur'strat'a
surstrataj	sur'strat'a'j
surstrate	sur'strat'e
surstraten	sur'strat'e'n
surŝipe	sur'ŝip'e
surŝipen	sur'ŝip'e'n
surŝipiĝis	sur'ŝip'iĝ'is
surŝmiras	sur'ŝmir'as
surŝmiri	sur'ŝmir'i
surŝmiris	sur'ŝmir'is
surŝmirado	sur'ŝmir'ad'o
surŝmirante	sur'ŝmir'ant'e
surŝmirita	sur'ŝmir'it'a
surŝmiritaj	sur'ŝmir'it'a'j
surŝultre	sur'ŝultr'e
surŝultrigis	sur'ŝultr'ig'is
surŝutita	sur'ŝut'it'a
surtabla	sur'tabl'a
surtablaj	sur'tabl'a'j
surtable	sur'tabl'e
surtablen	sur'tabl'e'n
surtabligas	sur'tabl'ig'as
surtabligi	sur'tabl'ig'i
surtabligis	sur'tabl'ig'is
surtabligita	sur'tabl'ig'it'a
surtabligitaj	sur'tabl'ig'it'a'j
surtera	sur'ter'a
surteraj	sur'ter'a'j
surterajn	sur'ter'a'j'n
surteran	sur'ter'a'n
surtere	sur'ter'e
surteren	sur'ter'e'n
surterema	sur'ter'em'a
surterigis	sur'ter'ig'is
surteriĝas	sur'ter'iĝ'as
surteriĝi	sur'ter'iĝ'i
surteriĝis	sur'ter'iĝ'is
surteriĝo	sur'ter'iĝ'o
surteriĝoj	sur'ter'iĝ'o'j
surteriĝon	sur'ter'iĝ'o'n
surteriĝos	sur'ter'iĝ'os
surtretas	sur'tret'as
surtreti	sur'tret'i
surtretis	sur'tret'is
surtretu	sur'tret'u
surtroniĝis	sur'tron'iĝ'is
surtroniĝo	sur'tron'iĝ'o
surtroniĝon	sur'tron'iĝ'o'n
surtrotuare	sur'trotuar'e
survange	sur'vang'e
surventre	sur'ventr'e
surverŝis	sur'verŝ'is
survestis	sur'vest'is
surveturis	sur'vetur'is
surveturita	sur'vetur'it'a
survizaĝe	sur'vizaĝ'e
survoja	sur'voj'a
survojas	sur'voj'as
survoje	sur'voj'e
survojis	sur'voj'is
surao	sura'o
surda	surd'a
surdaj	surd'a'j
surdajn	surd'a'j'n
surdan	surd'a'n
surdas	surd'as
surde	surd'e
surdo	surd'o
surdamutuloj	surd'a'mut'ul'o'j
surdeco	surd'ec'o
surdecon	surd'ec'o'n
surdiga	surd'ig'a
surdige	surd'ig'e
surdigis	surd'ig'is
surdiĝis	surd'iĝ'is
surdulo	surd'ul'o
surduloj	surd'ul'o'j
surfi	surf'i
surfo	surf'o
surfado	surf'ad'o
surfanto	surf'ant'o
surfantoj	surf'ant'o'j
surfotabuloj	surf'o'tabul'o'j
surfaca	surfac'a
surfacaj	surfac'a'j
surfacajn	surfac'a'j'n
surfacan	surfac'a'n
surface	surfac'e
surfaco	surfac'o
surfacoj	surfac'o'j
surfacojn	surfac'o'j'n
surfacon	surfac'o'n
surfacareo	surfac'are'o
surfacareon	surfac'are'o'n
surfactavolo	surfac'tavol'o
surfactemperaturo	surfac'temperatur'o
surfacunuo	surfac'unu'o
surfaktanto	surfaktant'o
surfaktantoj	surfaktant'o'j
surikatoj	surikat'o'j
surinama	surinam'a
surinamo	surinam'o
surogata	surogat'a
surogataj	surogat'a'j
surogato	surogat'o
surogatoj	surogat'o'j
surogaton	surogat'o'n
surpliso	surplis'o
surpriza	surpriz'a
surprizaj	surpriz'a'j
surprizajn	surpriz'a'j'n
surprizan	surpriz'a'n
surprizas	surpriz'as
surprize	surpriz'e
surprizi	surpriz'i
surprizis	surpriz'is
surprizo	surpriz'o
surprizoj	surpriz'o'j
surprizojn	surpriz'o'j'n
surprizon	surpriz'o'n
surprizos	surpriz'os
surprizu	surpriz'u
surprizus	surpriz'us
surprizante	surpriz'ant'e
surprizata	surpriz'at'a
surprizate	surpriz'at'e
surprizatako	surpriz'atak'o
surprizatakoj	surpriz'atak'o'j
surprizatakon	surpriz'atak'o'n
surprizegis	surpriz'eg'is
surprizego	surpriz'eg'o
surpriziga	surpriz'ig'a
surprizigis	surpriz'ig'is
surpriziĝas	surpriz'iĝ'as
surpriziĝi	surpriz'iĝ'i
surpriziĝis	surpriz'iĝ'is
surpriziĝo	surpriz'iĝ'o
surpriziĝos	surpriz'iĝ'os
surprizita	surpriz'it'a
surprizitaj	surpriz'it'a'j
surprizite	surpriz'it'e
surtuto	surtut'o
surtuton	surtut'o'n
suspekta	suspekt'a
suspektaj	suspekt'a'j
suspektas	suspekt'as
suspekte	suspekt'e
suspekti	suspekt'i
suspektis	suspekt'is
suspekto	suspekt'o
suspektoj	suspekt'o'j
suspektojn	suspekt'o'j'n
suspekton	suspekt'o'n
suspektos	suspekt'os
suspektu	suspekt'u
suspektus	suspekt'us
suspektante	suspekt'ant'e
suspektata	suspekt'at'a
suspektataj	suspekt'at'a'j
suspektato	suspekt'at'o
suspektatoj	suspekt'at'o'j
suspektatojn	suspekt'at'o'j'n
suspektaton	suspekt'at'o'n
suspektema	suspekt'em'a
suspektemaj	suspekt'em'a'j
suspekteme	suspekt'em'e
suspektemo	suspekt'em'o
suspektemon	suspekt'em'o'n
suspektigas	suspekt'ig'as
suspektinda	suspekt'ind'a
suspektindaj	suspekt'ind'a'j
suspektindajn	suspekt'ind'a'j'n
suspektindan	suspekt'ind'a'n
suspektinde	suspekt'ind'e
suspektita	suspekt'it'a
suspektitaj	suspekt'it'a'j
suspektite	suspekt'it'e
suspektito	suspekt'it'o
suspendas	suspend'as
suspendi	suspend'i
suspendis	suspend'is
suspendo	suspend'o
suspendoj	suspend'o'j
suspendon	suspend'o'n
suspendita	suspend'it'a
suspenditaj	suspend'it'a'j
suspenso	suspens'o
suspensfilmo	suspens'film'o
suspensludoj	suspens'lud'o'j
suspensio	suspensi'o
suspensiaĵo	suspensi'aĵ'o
suspiras	suspir'as
suspiri	suspir'i
suspiris	suspir'is
suspiro	suspir'o
suspiroj	suspir'o'j
suspiron	suspir'o'n
suspirante	suspir'ant'e
suspirinte	suspir'int'e
susura	susur'a
susuras	susur'as
susuris	susur'is
susuro	susur'o
susuron	susur'o'n
susurado	susur'ad'o
susuradon	susur'ad'o'n
susuranta	susur'ant'a
susurantaj	susur'ant'a'j
susurante	susur'ant'e
suŝio	suŝi'o
suŝiojn	suŝi'o'j'n
suŝion	suŝi'o'n
sutano	sutan'o
sutanon	sutan'o'n
sutra	sutr'a
sutraj	sutr'a'j
sutro	sutr'o
sutroj	sutr'o'j
sutrojn	sutr'o'j'n
sutron	sutr'o'n
suveniroj	suvenir'o'j
suvenirojn	suvenir'o'j'n
suverena	suveren'a
suverenaj	suveren'a'j
suverenajn	suveren'a'j'n
suverenan	suveren'a'n
suverene	suveren'e
suvereno	suveren'o
suverenoj	suveren'o'j
suvereneco	suveren'ec'o
suverenecon	suveren'ec'o'n
svaga	svag'a
svagaj	svag'a'j
svagajn	svag'a'j'n
svagan	svag'a'n
svage	svag'e
svarma	svarm'a
svarmaj	svarm'a'j
svarmas	svarm'as
svarme	svarm'e
svarmi	svarm'i
svarmis	svarm'is
svarmo	svarm'o
svarmoj	svarm'o'j
svarmojn	svarm'o'j'n
svarmon	svarm'o'n
svarmado	svarm'ad'o
svarmanta	svarm'ant'a
svarmantaj	svarm'ant'a'j
svastiko	svastik'o
svastikon	svastik'o'n
svatas	svat'as
svati	svat'i
svatis	svat'is
svatado	svat'ad'o
svatanto	svat'ant'o
svatantoj	svat'ant'o'j
svatisto	svat'ist'o
svatita	svat'it'a
svatitaj	svat'it'a'j
svatite	svat'it'e
svazilando	svaziland'o
sveda	sved'a
svedaj	sved'a'j
svedajn	sved'a'j'n
svedan	sved'a'n
svede	sved'e
svedo	sved'o
svedoj	sved'o'j
svedojn	sved'o'j'n
svedia	sved'i'a
svedio	sved'i'o
svedion	sved'i'o'n
svedino	sved'in'o
svedlando	sved'land'o
svedlingva	sved'lingv'a
svedlingvaj	sved'lingv'a'j
svedujo	sved'uj'o
svelta	svelt'a
sveltaj	svelt'a'j
sveltajn	svelt'a'j'n
sveltan	svelt'a'n
svelteco	svelt'ec'o
svenas	sven'as
svene	sven'e
sveni	sven'i
svenis	sven'is
sveno	sven'o
svenos	sven'os
sveninta	sven'int'a
svenonta	sven'ont'a
svetero	sveter'o
sveteron	sveter'o'n
svingas	sving'as
svinge	sving'e
svingi	sving'i
svingis	sving'is
svingo	sving'o
svingoj	sving'o'j
svingon	sving'o'n
svingu	sving'u
svingadis	sving'ad'is
svingado	sving'ad'o
svinganta	sving'ant'a
svingante	sving'ant'e
svingiĝas	sving'iĝ'as
svingiĝi	sving'iĝ'i
svingiĝis	sving'iĝ'is
svinginte	sving'int'e
svingita	sving'it'a
svisa	svis'a
svisaj	svis'a'j
svisajn	svis'a'j'n
svisan	svis'a'n
sviso	svis'o
svisoj	svis'o'j
svisgermana	svis'german'a
svisio	svis'i'o
svislanda	svis'land'a
svislando	svis'land'o
svislandon	svis'land'o'n
svisujo	svis'uj'o