taoisma	ta'o'ism'a
taoismo	ta'o'ism'o
taoisto	ta'o'ist'o
taoistoj	ta'o'ist'o'j
tabaka	tabak'a
tabakaj	tabak'a'j
tabako	tabak'o
tabakoj	tabak'o'j
tabakon	tabak'o'n
tabakfumo	tabak'fum'o
tabakfumado	tabak'fum'ad'o
tabela	tabel'a
tabelo	tabel'o
tabeloj	tabel'o'j
tabelojn	tabel'o'j'n
tabelon	tabel'o'n
tabelvorto	tabel'vort'o
tabelvortoj	tabel'vort'o'j
tabelvortojn	tabel'vort'o'j'n
tabernaklo	tabernakl'o
tabernaklon	tabernakl'o'n
tabla	tabl'a
table	tabl'e
tablo	tabl'o
tabloj	tabl'o'j
tablojn	tabl'o'j'n
tablon	tabl'o'n
tableto	tabl'et'o
tabletoj	tabl'et'o'j
tableton	tabl'et'o'n
tablokomputilo	tabl'o'komput'il'o
tablokomputiloj	tabl'o'komput'il'o'j
tablosalo	tabl'o'sal'o
tablotenisa	tabl'o'tenis'a
tabloteniso	tabl'o'tenis'o
tablotenison	tabl'o'tenis'o'n
tablotuko	tabl'o'tuk'o
tablotukoj	tabl'o'tuk'o'j
tablotukon	tabl'o'tuk'o'n
tablojdo	tablojd'o
tablojdoj	tablojd'o'j
tablojdojn	tablojd'o'j'n
tablojdon	tablojd'o'n
tabrizo	tabriz'o
tabua	tabu'a
tabuaj	tabu'a'j
tabuo	tabu'o
tabuoj	tabu'o'j
tabuojn	tabu'o'j'n
tabuon	tabu'o'n
tabula	tabul'a
tabulo	tabul'o
tabuloj	tabul'o'j
tabulojn	tabul'o'j'n
tabulon	tabul'o'n
tabuleto	tabul'et'o
tabuletoj	tabul'et'o'j
tabuleton	tabul'et'o'n
tabulkomputilo	tabul'komput'il'o
tabulludo	tabul'lud'o
tabulludoj	tabul'lud'o'j
tabureto	taburet'o
taburetoj	taburet'o'j
tabureton	taburet'o'n
taĉmento	taĉment'o
taĉmentoj	taĉment'o'j
taĉmentojn	taĉment'o'j'n
taĉmenton	taĉment'o'n
taĉmentanoj	taĉment'an'o'j
tadeo	tade'o
taga	tag'a
tagaj	tag'a'j
tagajn	tag'a'j'n
tagan	tag'a'n
tage	tag'e
tago	tag'o
tagoj	tag'o'j
tagojn	tag'o'j'n
tagon	tag'o'n
tagdeko	tag'dek'o
tagdormetos	tag'dorm'et'os
tagenokte	tag'e'nokt'e
taggazeto	tag'gazet'o
taggazetoj	tag'gazet'o'j
tagiĝas	tag'iĝ'as
tagiĝis	tag'iĝ'is
tagigho	tag'iĝ'o
tagiĝo	tag'iĝ'o
tagiĝon	tag'iĝ'o'n
tagĵurnalo	tag'ĵurnal'o
tagĵurnaloj	tag'ĵurnal'o'j
taglibro	tag'libr'o
taglibroj	tag'libr'o'j
taglibrojn	tag'libr'o'j'n
taglibron	tag'libr'o'n
taglumo	tag'lum'o
taglumon	tag'lum'o'n
taglumhoroj	tag'lum'hor'o'j
tagmanĝa	tag'manĝ'a
tagmanĝas	tag'manĝ'as
tagmanĝi	tag'manĝ'i
tagmanĝis	tag'manĝ'is
tagmangho	tag'manĝ'o
tagmanĝo	tag'manĝ'o
tagmanĝoj	tag'manĝ'o'j
tagmanĝojn	tag'manĝ'o'j'n
tagmanĝon	tag'manĝ'o'n
tagmanĝos	tag'manĝ'os
tagmanĝu	tag'manĝ'u
tagmeza	tag'mez'a
tagmezaj	tag'mez'a'j
tagmeze	tag'mez'e
tagmezo	tag'mez'o
tagmezon	tag'mez'o'n
tagnokta	tag'nokt'a
tagnokte	tag'nokt'e
tagnokto	tag'nokt'o
tagnoktoj	tag'nokt'o'j
tagnokton	tag'nokt'o'n
tagolibron	tag'o'libr'o'n
tagordo	tag'ord'o
tagordoj	tag'ord'o'j
tagordojn	tag'ord'o'j'n
tagordon	tag'ord'o'n
tagordero	tag'ord'er'o
tagtempo	tag'temp'o
tagaloga	tagalog'a
tagalogan	tagalog'a'n
taĝika	taĝik'a
taĝikoj	taĝik'o'j
taĝikio	taĝik'i'o
taja	taj'a
tajaj	taj'a'j
tajan	taj'a'n
tajo	taj'o
tajoj	taj'o'j
tajlanda	taj'land'a
tajlandaj	taj'land'a'j
tajlandan	taj'land'a'n
tajlando	taj'land'o
tajlandon	taj'land'o'n
tajda	tajd'a
tajdaj	tajd'a'j
tajdo	tajd'o
tajdoj	tajd'o'j
tajdojn	tajd'o'j'n
tajdon	tajd'o'n
tajfuno	tajfun'o
tajfunoj	tajfun'o'j
tajgo	tajg'o
tajlas	tajl'as
tajli	tajl'i
tajlis	tajl'is
tajlado	tajl'ad'o
tajladon	tajl'ad'o'n
tajlita	tajl'it'a
tajlitaj	tajl'it'a'j
tajloro	tajlor'o
tajloroj	tajlor'o'j
tajloron	tajlor'o'n
tajlorado	tajlor'ad'o
tajloreto	tajlor'et'o
tajlorita	tajlor'it'a
tajloritaj	tajlor'it'a'j
tajloritajn	tajlor'it'a'j'n
tajpas	tajp'as
tajpi	tajp'i
tajpis	tajp'is
tajpu	tajp'u
tajpado	tajp'ad'o
tajpadon	tajp'ad'o'n
tajpante	tajp'ant'e
tajperaro	tajp'erar'o
tajperaroj	tajp'erar'o'j
tajperarojn	tajp'erar'o'j'n
tajpilo	tajp'il'o
tajpiloj	tajp'il'o'j
tajpilon	tajp'il'o'n
tajpisto	tajp'ist'o
tajpistino	tajp'ist'in'o
tajpita	tajp'it'a
tajpitaj	tajp'it'a'j
tajpeo	tajpe'o
tajvana	tajvan'a
tajvanaj	tajvan'a'j
tajvanan	tajvan'a'n
tajvano	tajvan'o
tajvanon	tajvan'o'n
tajvanano	tajvan'an'o
tajvananoj	tajvan'an'o'j
taksas	taks'as
taksi	taks'i
taksis	taks'is
takso	taks'o
taksoj	taks'o'j
taksojn	taks'o'j'n
takson	taks'o'n
taksos	taks'os
taksu	taks'u
taksus	taks'us
taksado	taks'ad'o
taksadoj	taks'ad'o'j
taksadojn	taks'ad'o'j'n
taksadon	taks'ad'o'n
taksanta	taks'ant'a
taksante	taks'ant'e
taksata	taks'at'a
taksataj	taks'at'a'j
taksebla	taks'ebl'a
taksiĝas	taks'iĝ'as
taksita	taks'it'a
taksitaj	taks'it'a'j
taksite	taks'it'e
taksia	taksi'a
taksie	taksi'e
taksiis	taksi'is
taksio	taksi'o
taksioj	taksi'o'j
taksiojn	taksi'o'j'n
taksion	taksi'o'n
taksiisto	taksi'ist'o
taksiistoj	taksi'ist'o'j
taksiiston	taksi'ist'o'n
taksiŝoforo	taksi'ŝofor'o
taksono	takson'o
taksonoj	takson'o'j
taksonojn	takson'o'j'n
taksonon	takson'o'n
taksonomistoj	taksonom'ist'o'j
taksonomia	taksonomi'a
taksonomiaj	taksonomi'a'j
taksonomiajn	taksonomi'a'j'n
taksonomian	taksonomi'a'n
taksonomio	taksonomi'o
taksonomioj	taksonomi'o'j
taksonomion	taksonomi'o'n
taksuso	taksus'o
takta	takt'a
takte	takt'e
takto	takt'o
taktoj	takt'o'j
taktojn	takt'o'j'n
takton	takt'o'n
taktika	taktik'a
taktikaj	taktik'a'j
taktikajn	taktik'a'j'n
taktikan	taktik'a'n
taktike	taktik'e
taktiko	taktik'o
taktikoj	taktik'o'j
taktikojn	taktik'o'j'n
taktikon	taktik'o'n
taktikisto	taktik'ist'o
talenta	talent'a
talentaj	talent'a'j
talentajn	talent'a'j'n
talentan	talent'a'n
talentas	talent'as
talente	talent'e
talento	talent'o
talentoj	talent'o'j
talentojn	talent'o'j'n
talenton	talent'o'n
talentita	talent'it'a
talentulo	talent'ul'o
talentuloj	talent'ul'o'j
talentulojn	talent'ul'o'j'n
talentulon	talent'ul'o'n
taleso	tales'o
talia	tali'a
talio	tali'o
talion	tali'o'n
taliboj	talib'o'j
talibana	taliban'a
talibanaj	taliban'a'j
talibano	taliban'o
talibanoj	taliban'o'j
talismano	talisman'o
talismanoj	talisman'o'j
talismanon	talisman'o'n
talko	talk'o
talmuda	talmud'a
talmudaj	talmud'a'j
talmudo	talmud'o
talmudon	talmud'o'n
talpo	talp'o
talpoj	talp'o'j
tamarindo	tamarind'o
tambura	tambur'a
tamburaj	tambur'a'j
tamburan	tambur'a'n
tamburas	tambur'as
tamburi	tambur'i
tamburis	tambur'is
tamburo	tambur'o
tamburoj	tambur'o'j
tamburojn	tambur'o'j'n
tamburon	tambur'o'n
tamburado	tambur'ad'o
tamburadon	tambur'ad'o'n
tamburego	tambur'eg'o
tambureto	tambur'et'o
tamburisto	tambur'ist'o
tamburistoj	tambur'ist'o'j
tamburiston	tambur'ist'o'n
tamburmuziko	tambur'muzik'o
tamburino	tamburin'o
tamburinon	tamburin'o'n
tamen	tamen
tamtamo	tamtam'o
tana	tan'a
tani	tan'i
tanado	tan'ad'o
taninoj	tan'in'o'j
tanaĥo	tanaĥ'o
tandemo	tandem'o
tanga	tang'a
tango	tang'o
tangon	tang'o'n
tanĝas	tanĝ'as
tanĝanta	tanĝ'ant'a
tanĝantaj	tanĝ'ant'a'j
tanĝanto	tanĝ'ant'o
tanĝero	tanĝer'o
tanka	tank'a
tankaj	tank'a'j
tanko	tank'o
tankoj	tank'o'j
tankojn	tank'o'j'n
tankon	tank'o'n
tankao	tanka'o
tantalo	tantal'o
tantiemo	tantiem'o
tantiemon	tantiem'o'n
tantra	tantr'a
tantro	tantr'o
tapeto	tapet'o
tapetoj	tapet'o'j
tapetojn	tapet'o'j'n
tapiŝo	tapiŝ'o
tapiŝoj	tapiŝ'o'j
tapiŝojn	tapiŝ'o'j'n
tapiŝon	tapiŝ'o'n
tapiŝeto	tapiŝ'et'o
tapiŝetoj	tapiŝ'et'o'j
tapiŝeton	tapiŝ'et'o'n
tara	tar'a
taro	tar'o
taranto	tar'ant'o
tarantulo	tarantul'o
tarantuloj	tarantul'o'j
tarda	tard'a
tarde	tard'e
tarifo	tarif'o
tarifoj	tarif'o'j
tarifojn	tarif'o'j'n
tarifon	tarif'o'n
tarkvino	tarkvin'o
tarnovo	tarnov'o
taroko	tarok'o
tarso	tars'o
tartano	tartan'o
tartaro	tartar'o
tartaron	tartar'o'n
tartrato	tartr'at'o
taso	tas'o
tasoj	tas'o'j
tasojn	tas'o'j'n
tason	tas'o'n
tasforma	tas'form'a
tasforman	tas'form'a'n
taskas	task'as
taskis	task'is
tasko	task'o
taskoj	task'o'j
taskojn	task'o'j'n
taskon	task'o'n
taskaro	task'ar'o
taskefikeco	task'efik'ec'o
taskigas	task'ig'as
taskigis	task'ig'is
taskigita	task'ig'it'a
taskigitaj	task'ig'it'a'j
taskita	task'it'a
tasmania	tasmani'a
tasmaniaj	tasmani'a'j
tasmanio	tasmani'o
tatara	tatar'a
tataraj	tatar'a'j
tataran	tatar'a'n
tataro	tatar'o
tataroj	tatar'o'j
tatarstano	tatarstan'o
tatuas	tatu'as
tatui	tatu'i
tatuis	tatu'is
tatuo	tatu'o
tatuoj	tatu'o'j
tatuon	tatu'o'n
tatuado	tatu'ad'o
tatuaĵo	tatu'aĵ'o
tatuaĵoj	tatu'aĵ'o'j
tatuaĵojn	tatu'aĵ'o'j'n
tatuaĵon	tatu'aĵ'o'n
taŭga	taŭg'a
taŭgaj	taŭg'a'j
taŭgajn	taŭg'a'j'n
taŭgan	taŭg'a'n
taŭgas	taŭg'as
taŭge	taŭg'e
taŭgi	taŭg'i
taŭgis	taŭg'is
taŭgos	taŭg'os
taŭgu	taŭg'u
taŭgus	taŭg'us
taŭgeco	taŭg'ec'o
taŭgecon	taŭg'ec'o'n
taŭro	taŭr'o
taŭroj	taŭr'o'j
taŭron	taŭr'o'n
taŭrido	taŭr'id'o
taŭrobatalo	taŭr'o'batal'o
taŭroludo	taŭr'o'lud'o
taŭrido	taŭrid'o
taŭtologio	taŭtologi'o
taŭzis	taŭz'is
taŭzita	taŭz'it'a
taŭzitaj	taŭz'it'a'j
taverno	tavern'o
tavernoj	tavern'o'j
tavola	tavol'a
tavolaj	tavol'a'j
tavolo	tavol'o
tavoloj	tavol'o'j
tavolojn	tavol'o'j'n
tavolon	tavol'o'n
tavolaro	tavol'ar'o
tavolaroj	tavol'ar'o'j
tavoleto	tavol'et'o
tavoletoj	tavol'et'o'j
tavolgaso	tavol'gas'o
tavoligas	tavol'ig'as
tavoligi	tavol'ig'i
tavoligado	tavol'ig'ad'o
tavoligita	tavol'ig'it'a
tavoligitaj	tavol'ig'it'a'j
tavoligitan	tavol'ig'it'a'n
tavoliĝo	tavol'iĝ'o
tavoliĝon	tavol'iĝ'o'n
tavolpremo	tavol'prem'o
tea	te'a
teaj	te'a'j
tean	te'a'n
teo	te'o
teoj	te'o'j
teojn	te'o'j'n
teon	te'o'n
teakvo	te'akv'o
tearboj	te'arb'o'j
teismo	te'ism'o
teama	team'a
teamaj	team'a'j
teamo	team'o
teamoj	team'o'j
teamojn	team'o'j'n
teamon	team'o'n
teamano	team'an'o
teamanoj	team'an'o'j
teamanojn	team'an'o'j'n
teamestro	team'estr'o
teamlaboro	team'labor'o
teamlaboron	team'labor'o'n
teatra	teatr'a
teatraj	teatr'a'j
teatrajn	teatr'a'j'n
teatran	teatr'a'n
teatre	teatr'e
teatro	teatr'o
teatroj	teatr'o'j
teatrojn	teatr'o'j'n
teatron	teatr'o'n
teatraĵo	teatr'aĵ'o
teatraĵoj	teatr'aĵ'o'j
teatraĵojn	teatr'aĵ'o'j'n
teatraĵon	teatr'aĵ'o'n
teatraĵeto	teatr'aĵ'et'o
teatrejo	teatr'ej'o
teatrejoj	teatr'ej'o'j
teatrejon	teatr'ej'o'n
teatrestro	teatr'estr'o
teatrorekvizitoj	teatr'o'rekvizit'o'j
teatrorekvizitojn	teatr'o'rekvizit'o'j'n
teda	ted'a
tedaj	ted'a'j
tedajn	ted'a'j'n
tedan	ted'a'n
tedas	ted'as
tede	ted'e
tedi	ted'i
tedis	ted'is
tedo	ted'o
tedos	ted'os
tedu	ted'u
tedaĉa	ted'aĉ'a
tedaĉas	ted'aĉ'as
tedaĉi	ted'aĉ'i
tedado	ted'ad'o
tedaĵo	ted'aĵ'o
tedata	ted'at'a
tedegas	ted'eg'as
tediĝas	ted'iĝ'as
tediĝis	ted'iĝ'is
tedita	ted'it'a
tedulo	ted'ul'o
tega	teg'a
tegaj	teg'a'j
tegas	teg'as
tegi	teg'i
tegis	teg'is
tegaĵo	teg'aĵ'o
tegaĵoj	teg'aĵ'o'j
tegaĵojn	teg'aĵ'o'j'n
tegaĵon	teg'aĵ'o'n
tegita	teg'it'a
tegitaj	teg'it'a'j
tegitan	teg'it'a'n
tegmenta	tegment'a
tegmentaj	tegment'a'j
tegmentan	tegment'a'n
tegmento	tegment'o
tegmentoj	tegment'o'j
tegmentojn	tegment'o'j'n
tegmenton	tegment'o'n
tegmentita	tegment'it'a
tegmentitaj	tegment'it'a'j
tegmentofirmao	tegment'o'firma'o
tegmentrandaj	tegment'rand'a'j
tegmentrandoj	tegment'rand'o'j
tegolo	tegol'o
tegoloj	tegol'o'j
tegolojn	tegol'o'j'n
tegumento	tegument'o
tegumentoj	tegument'o'j
teĥnika	teĥnik'a
teĥnikaj	teĥnik'a'j
teĥnikajn	teĥnik'a'j'n
teĥnikan	teĥnik'a'n
teĥnike	teĥnik'e
teĥniko	teĥnik'o
teĥnikoj	teĥnik'o'j
teĥnikojn	teĥnik'o'j'n
teĥnikon	teĥnik'o'n
teĥnikaro	teĥnik'ar'o
teĥnologiaj	teĥnologi'a'j
teĥnologio	teĥnologi'o
teĥnologioj	teĥnologi'o'j
teismo	teism'o
teista	teist'a
teistoj	teist'o'j
teko	tek'o
tekon	tek'o'n
tekokomputilo	tek'o'komput'il'o
tekokomputiloj	tek'o'komput'il'o'j
tekokomputilon	tek'o'komput'il'o'n
tekilo	tekil'o
tekilon	tekil'o'n
teknecio	tekneci'o
teknika	teknik'a
teknikaj	teknik'a'j
teknikajn	teknik'a'j'n
teknikan	teknik'a'n
teknike	teknik'e
tekniko	teknik'o
teknikoj	teknik'o'j
teknikojn	teknik'o'j'n
teknikon	teknik'o'n
teknikaĵoj	teknik'aĵ'o'j
teknikaĵojn	teknik'aĵ'o'j'n
teknikisto	teknik'ist'o
teknikistoj	teknik'ist'o'j
teknikistojn	teknik'ist'o'j'n
teknikiston	teknik'ist'o'n
teknokratoj	teknokrat'o'j
teknologoj	teknolog'o'j
teknologia	teknologi'a
teknologiaj	teknologi'a'j
teknologiajn	teknologi'a'j'n
teknologian	teknologi'a'n
teknologie	teknologi'e
teknologio	teknologi'o
teknologioj	teknologi'o'j
teknologiojn	teknologi'o'j'n
teknologion	teknologi'o'n
teknologientreprenoj	teknologi'entrepren'o'j
teknologiindustrio	teknologi'industri'o
teksa	teks'a
teksaj	teks'a'j
teksas	teks'as
teksi	teks'i
teksis	teks'is
teksado	teks'ad'o
teksadon	teks'ad'o'n
teksaĵa	teks'aĵ'a
teksaĵo	teks'aĵ'o
teksaĵoj	teks'aĵ'o'j
teksaĵojn	teks'aĵ'o'j'n
teksaĵon	teks'aĵ'o'n
teksejo	teks'ej'o
teksilo	teks'il'o
teksiloj	teks'il'o'j
teksilon	teks'il'o'n
teksindustrio	teks'industri'o
teksisto	teks'ist'o
teksistoj	teks'ist'o'j
teksiston	teks'ist'o'n
teksistino	teks'ist'in'o
teksita	teks'it'a
teksitaj	teks'it'a'j
teksitajn	teks'it'a'j'n
teksitan	teks'it'a'n
teksasa	teksas'a
teksasaj	teksas'a'j
teksaso	teksas'o
teksason	teksas'o'n
teksasanoj	teksas'an'o'j
teksta	tekst'a
tekstaj	tekst'a'j
tekstajn	tekst'a'j'n
tekstan	tekst'a'n
tekstas	tekst'as
tekste	tekst'e
tekstis	tekst'is
teksto	tekst'o
tekstoj	tekst'o'j
tekstojn	tekst'o'j'n
tekston	tekst'o'n
tekstaro	tekst'ar'o
tekstaroj	tekst'ar'o'j
tekstaron	tekst'ar'o'n
tekstbazita	tekst'baz'it'a
tekstbazitaj	tekst'baz'it'a'j
tekstdosieroj	tekst'dosier'o'j
tekstero	tekst'er'o
teksteroj	tekst'er'o'j
tekstkritiko	tekst'kritik'o
tekstmesaĝo	tekst'mesaĝ'o
tekstmesaĝoj	tekst'mesaĝ'o'j
tekstmesaĝojn	tekst'mesaĝ'o'j'n
tekstmesaĝon	tekst'mesaĝ'o'n
tekstopoeto	tekst'o'poet'o
tekstoredaktilo	tekst'o'redakt'il'o
tekstospeco	tekst'o'spec'o
tekstotraktado	tekst'o'trakt'ad'o
tekstprilaborilo	tekst'pri'labor'il'o
tekstprilaboriloj	tekst'pri'labor'il'o'j
tekstrekono	tekst're'kon'o
tekstila	tekstil'a
tekstilaj	tekstil'a'j
tekstilo	tekstil'o
tekstiloj	tekstil'o'j
tekstilojn	tekstil'o'j'n
tekstilon	tekstil'o'n
tekstilaĵoj	tekstil'aĵ'o'j
tekstilindustrio	tekstil'industri'o
tekstilmueliloj	tekstil'muel'il'o'j
teksturo	tekstur'o
teksturoj	tekstur'o'j
teksturon	tekstur'o'n
teksturita	tekstur'it'a
tektona	tekton'a
tektonaj	tekton'a'j
tektono	tekton'o
tektonikaj	tekton'ik'a'j
tektoniko	tekton'ik'o
tekvondo	tekvond'o
telamono	telamon'o
telaviva	telaviv'a
telavivo	telaviv'o
teleekrano	tele'ekran'o
telefaksilo	tele'faks'il'o
telehejtado	tele'hejt'ad'o
telekomunika	tele'komunik'a
telekomunikaj	tele'komunik'a'j
telekomunikan	tele'komunik'a'n
telekomuniko	tele'komunik'o
telekomunikada	tele'komunik'ad'a
telekomunikado	tele'komunik'ad'o
telekomunikadoj	tele'komunik'ad'o'j
telekomunikadojn	tele'komunik'ad'o'j'n
teleliveranto	tele'liver'ant'o
teleliverantoj	tele'liver'ant'o'j
teleregilo	tele'reg'il'o
teleregiloj	tele'reg'il'o'j
teleregilon	tele'reg'il'o'n
teleregita	tele'reg'it'a
teleskopa	tele'skop'a
teleskopaj	tele'skop'a'j
teleskopo	tele'skop'o
teleskopoj	tele'skop'o'j
teleskopojn	tele'skop'o'j'n
teleskopon	tele'skop'o'n
teletransportas	tele'trans'port'as
teletransporti	tele'trans'port'i
teletransportita	tele'trans'port'it'a
televida	tele'vid'a
televidaj	tele'vid'a'j
televidajn	tele'vid'a'j'n
televidan	tele'vid'a'n
televidas	tele'vid'as
televide	tele'vid'e
televidi	tele'vid'i
televidis	tele'vid'is
televido	tele'vid'o
televidoj	tele'vid'o'j
televidojn	tele'vid'o'j'n
televidon	tele'vid'o'n
televidos	tele'vid'os
televidado	tele'vid'ad'o
televidanoncoj	tele'vid'anonc'o'j
televidanta	tele'vid'ant'a
televidante	tele'vid'ant'e
televiddissendado	tele'vid'dis'send'ad'o
televidekrano	tele'vid'ekran'o
televidekranoj	tele'vid'ekran'o'j
televidekspozicio	tele'vid'ekspozici'o
televidekspozicioj	tele'vid'ekspozici'o'j
televidelsendo	tele'vid'el'send'o
televidelsendoj	tele'vid'el'send'o'j
televidelsendojn	tele'vid'el'send'o'j'n
televidigita	tele'vid'ig'it'a
televidilo	tele'vid'il'o
televidiloj	tele'vid'il'o'j
televidilojn	tele'vid'il'o'j'n
televidilon	tele'vid'il'o'n
televidkanalo	tele'vid'kanal'o
televidkanaloj	tele'vid'kanal'o'j
televidkanalon	tele'vid'kanal'o'n
televidokanaloj	tele'vid'o'kanal'o'j
televidostacio	tele'vid'o'staci'o
televidostacioj	tele'vid'o'staci'o'j
televidprogramo	tele'vid'program'o
televidprogramoj	tele'vid'program'o'j
televidprogramojn	tele'vid'program'o'j'n
televidprogramon	tele'vid'program'o'n
televidprogramado	tele'vid'program'ad'o
televidreto	tele'vid'ret'o
televidretoj	tele'vid'ret'o'j
televidserio	tele'vid'seri'o
televidserioj	tele'vid'seri'o'j
televidspektaklo	tele'vid'spektakl'o
televidspektakloj	tele'vid'spektakl'o'j
televidstacio	tele'vid'staci'o
televidstacioj	tele'vid'staci'o'j
telefona	telefon'a
telefonaj	telefon'a'j
telefonajn	telefon'a'j'n
telefonan	telefon'a'n
telefonas	telefon'as
telefone	telefon'e
telefoni	telefon'i
telefonis	telefon'is
telefono	telefon'o
telefonoj	telefon'o'j
telefonojn	telefon'o'j'n
telefonon	telefon'o'n
telefonos	telefon'os
telefonu	telefon'u
telefonus	telefon'us
telefonado	telefon'ad'o
telefonadon	telefon'ad'o'n
telefonalvoko	telefon'al'vok'o
telefonalvokoj	telefon'al'vok'o'j
telefonalvokojn	telefon'al'vok'o'j'n
telefonalvokon	telefon'al'vok'o'n
telefonanta	telefon'ant'a
telefonanto	telefon'ant'o
telefonaparato	telefon'aparat'o
telefonbudo	telefon'bud'o
telefoncentralo	telefon'central'o
telefonio	telefon'i'o
telefonistoj	telefon'ist'o'j
telefonita	telefon'it'a
telefonlibro	telefon'libr'o
telefonlinio	telefon'lini'o
telefonlinioj	telefon'lini'o'j
telefonliniojn	telefon'lini'o'j'n
telefonlinion	telefon'lini'o'n
telefonnumero	telefon'numer'o
telefonnumeroj	telefon'numer'o'j
telefonnumerojn	telefon'numer'o'j'n
telefonnumeron	telefon'numer'o'n
telefontenilo	telefon'ten'il'o
telefonteniloj	telefon'ten'il'o'j
telefonvoko	telefon'vok'o
telefonvokoj	telefon'vok'o'j
telefonvokojn	telefon'vok'o'j'n
telefonvokon	telefon'vok'o'n
telegrafa	telegraf'a
telegrafe	telegraf'e
telegrafis	telegraf'is
telegrafo	telegraf'o
telegrafoj	telegraf'o'j
telegrafon	telegraf'o'n
telegrafado	telegraf'ad'o
telegrafio	telegraf'i'o
telegrafisto	telegraf'ist'o
telegramo	telegram'o
telegramoj	telegram'o'j
telegramojn	telegram'o'j'n
telegramon	telegram'o'n
telemetrio	telemetr'i'o
teleologia	teleologi'a
teleologio	teleologi'o
teleosteoj	teleoste'o'j
telepatio	telepati'o
telero	teler'o
teleroj	teler'o'j
telerojn	teler'o'j'n
teleron	teler'o'n
telereto	teler'et'o
telerlavujo	teler'lav'uj'o
telerlavujon	teler'lav'uj'o'n
televizia	televizi'a
televizio	televizi'o
telfero	telfer'o
telferoj	telfer'o'j
teluro	telur'o
tema	tem'a
temaj	tem'a'j
temajn	tem'a'j'n
teman	tem'a'n
temas	tem'as
teme	tem'e
temi	tem'i
temis	tem'is
temo	tem'o
temoj	tem'o'j
temojn	tem'o'j'n
temon	tem'o'n
temos	tem'os
temu	tem'u
temus	tem'us
temanta	tem'ant'a
temantaj	tem'ant'a'j
temante	tem'ant'e
temaro	tem'ar'o
temaroj	tem'ar'o'j
temarojn	tem'ar'o'j'n
temaron	tem'ar'o'n
temigas	tem'ig'as
temigi	tem'ig'i
temigis	tem'ig'is
temigos	tem'ig'os
temigus	tem'ig'us
temigado	tem'ig'ad'o
temiganta	tem'ig'ant'a
temigantaj	tem'ig'ant'a'j
temigantan	tem'ig'ant'a'n
temigante	tem'ig'ant'e
temlinio	tem'lini'o
tembro	tembr'o
tempa	temp'a
tempaj	temp'a'j
tempajn	temp'a'j'n
tempan	temp'a'n
tempe	temp'e
tempo	temp'o
tempoj	temp'o'j
tempojn	temp'o'j'n
tempon	temp'o'n
tempadministrado	temp'administr'ad'o
tempeto	temp'et'o
tempeton	temp'et'o'n
tempigas	temp'ig'as
tempigi	temp'ig'i
tempigo	temp'ig'o
tempigoj	temp'ig'o'j
tempigon	temp'ig'o'n
tempigado	temp'ig'ad'o
tempigilo	temp'ig'il'o
tempigiloj	temp'ig'il'o'j
tempigita	temp'ig'it'a
tempigitaj	temp'ig'it'a'j
tempintervalo	temp'interval'o
tempintervaloj	temp'interval'o'j
templimo	temp'lim'o
templimoj	temp'lim'o'j
templimojn	temp'lim'o'j'n
templimon	temp'lim'o'n
templinio	temp'lini'o
templinioj	temp'lini'o'j
templinion	temp'lini'o'n
tempodaŭro	temp'o'daŭr'o
tempodaŭroj	temp'o'daŭr'o'j
tempodaŭrojn	temp'o'daŭr'o'j'n
tempodaŭron	temp'o'daŭr'o'n
tempodiferenco	temp'o'diferenc'o
tempodilatiĝo	temp'o'dilat'iĝ'o
tempokadro	temp'o'kadr'o
tempolimo	temp'o'lim'o
tempolimoj	temp'o'lim'o'j
tempolimon	temp'o'lim'o'n
tempomalŝparo	temp'o'mal'ŝpar'o
tempomanko	temp'o'mank'o
tempomaŝino	temp'o'maŝin'o
tempomaŝinon	temp'o'maŝin'o'n
tempomezura	temp'o'mezur'a
tempopaso	temp'o'pas'o
tempopasigo	temp'o'pas'ig'o
tempopasigilo	temp'o'pas'ig'il'o
tempopaŝo	temp'o'paŝ'o
tempoperdo	temp'o'perd'o
tempoperdon	temp'o'perd'o'n
tempoperiodo	temp'o'period'o
tempoperiodoj	temp'o'period'o'j
tempopostula	temp'o'postul'a
tempopostulaj	temp'o'postul'a'j
tempopremo	temp'o'prem'o
tempoprokrasto	temp'o'prokrast'o
tempopunkto	temp'o'punkt'o
tempopunkton	temp'o'punkt'o'n
temporaba	temp'o'rab'a
temposerio	temp'o'seri'o
temposkalo	temp'o'skal'o
temposkaloj	temp'o'skal'o'j
tempospaco	temp'o'spac'o
tempounuo	temp'o'unu'o
tempovojaĝado	temp'o'vojaĝ'ad'o
tempovojaĝanto	temp'o'vojaĝ'ant'o
tempero	temper'o
temperita	temper'it'a
temperitaj	temper'it'a'j
temperitan	temper'it'a'n
temperamenta	temperament'a
temperamento	temperament'o
temperamentoj	temperament'o'j
temperamenton	temperament'o'n
temperatura	temperatur'a
temperaturaj	temperatur'a'j
temperaturan	temperatur'a'n
temperature	temperatur'e
temperaturo	temperatur'o
temperaturoj	temperatur'o'j
temperaturojn	temperatur'o'j'n
temperaturon	temperatur'o'n
temperaturdiferenco	temperatur'diferenc'o
temperaturdiferencoj	temperatur'diferenc'o'j
temperaturdiferencon	temperatur'diferenc'o'n
temperaturgradiento	temperatur'gradient'o
temperaturintervalo	temperatur'interval'o
temperaturkoeficiento	temperatur'koeficient'o
temperaturplialtigo	temperatur'pli'alt'ig'o
temperaturpliiĝoj	temperatur'pli'iĝ'o'j
temperaturŝanĝo	temperatur'ŝanĝ'o
temperaturŝanĝoj	temperatur'ŝanĝ'o'j
temperaturŝanĝiĝo	temperatur'ŝanĝ'iĝ'o
temperaturŝanĝiĝoj	temperatur'ŝanĝ'iĝ'o'j
tempesta	tempest'a
tempesto	tempest'o
tempestoj	tempest'o'j
tempeston	tempest'o'n
tempestaĵo	tempest'aĵ'o
tempio	tempi'o
tempioj	tempi'o'j
tempiojn	tempi'o'j'n
tempion	tempi'o'n
templa	templ'a
templaj	templ'a'j
templan	templ'a'n
temple	templ'e
templo	templ'o
temploj	templ'o'j
templojn	templ'o'j'n
templon	templ'o'n
templanoj	templ'an'o'j
templejo	templ'ej'o
temporala	temporal'a
temporalaj	temporal'a'j
temporalo	temporal'o
tenas	ten'as
tene	ten'e
teni	ten'i
tenis	ten'is
teno	ten'o
tenoj	ten'o'j
tenon	ten'o'n
tenos	ten'os
tenu	ten'u
tenus	ten'us
tenadas	ten'ad'as
tenadi	ten'ad'i
tenadis	ten'ad'is
tenado	ten'ad'o
tenadon	ten'ad'o'n
tenanta	ten'ant'a
tenantaj	ten'ant'a'j
tenantan	ten'ant'a'n
tenante	ten'ant'e
tenanto	ten'ant'o
tenata	ten'at'a
tenataj	ten'at'a'j
tenatan	ten'at'a'n
tenejo	ten'ej'o
tenejoj	ten'ej'o'j
tenejon	ten'ej'o'n
teniĝas	ten'iĝ'as
teniĝis	ten'iĝ'is
teniĝo	ten'iĝ'o
teniĝon	ten'iĝ'o'n
tenilo	ten'il'o
teniloj	ten'il'o'j
tenilojn	ten'il'o'j'n
tenilon	ten'il'o'n
tenita	ten'it'a
tenitaj	ten'it'a'j
tenitajn	ten'it'a'j'n
tenitan	ten'it'a'n
tenite	ten'it'e
tenaca	tenac'a
tenajlo	tenajl'o
tendo	tend'o
tendoj	tend'o'j
tendojn	tend'o'j'n
tendon	tend'o'n
tendara	tend'ar'a
tendaraj	tend'ar'a'j
tendaran	tend'ar'a'n
tendaro	tend'ar'o
tendaroj	tend'ar'o'j
tendarojn	tend'ar'o'j'n
tendaron	tend'ar'o'n
tendaranoj	tend'ar'an'o'j
tendarfajro	tend'ar'fajr'o
tendejo	tend'ej'o
tendumi	tend'um'i
tendumis	tend'um'is
tendumado	tend'um'ad'o
tendumadon	tend'um'ad'o'n
tendumejo	tend'um'ej'o
tendeno	tenden'o
tendenoj	tenden'o'j
tendenojn	tenden'o'j'n
tendenon	tenden'o'n
tendenca	tendenc'a
tendencaj	tendenc'a'j
tendencas	tendenc'as
tendence	tendenc'e
tendenci	tendenc'i
tendencis	tendenc'is
tendenco	tendenc'o
tendencoj	tendenc'o'j
tendencojn	tendenc'o'j'n
tendencon	tendenc'o'n
tendencos	tendenc'os
tendencu	tendenc'u
tendencus	tendenc'us
tendencante	tendenc'ant'e
tenebra	tenebr'a
tenebro	tenebr'o
tenera	tener'a
teneraj	tener'a'j
tenerajn	tener'a'j'n
teneran	tener'a'n
tenere	tener'e
tenero	tener'o
teneron	tener'o'n
tenerdolĉaĵojn	tener'dolĉ'aĵ'o'j'n
tenereco	tener'ec'o
tenerecon	tener'ec'o'n
tenerife	tenerif'e
tenerifo	tenerif'o
tenio	teni'o
tenisa	tenis'a
tenisaj	tenis'a'j
tenisan	tenis'a'n
tenisas	tenis'as
tenisi	tenis'i
tenisis	tenis'is
teniso	tenis'o
tenison	tenis'o'n
tenisado	tenis'ad'o
tenisejo	tenis'ej'o
tenisejoj	tenis'ej'o'j
tenisisto	tenis'ist'o
tenisistoj	tenis'ist'o'j
tenisklubo	tenis'klub'o
tenisludanto	tenis'lud'ant'o
tenono	tenon'o
tenoro	tenor'o
tenoroj	tenor'o'j
tenoron	tenor'o'n
tenortrombono	tenor'trombon'o
tensia	tensi'a
tensiaj	tensi'a'j
tensio	tensi'o
tensioj	tensi'o'j
tensiojn	tensi'o'j'n
tension	tensi'o'n
tensiofalo	tensi'o'fal'o
tenta	tent'a
tentas	tent'as
tente	tent'e
tenti	tent'i
tentis	tent'is
tento	tent'o
tentoj	tent'o'j
tentojn	tent'o'j'n
tenton	tent'o'n
tentos	tent'os
tentu	tent'u
tentado	tent'ad'o
tentata	tent'at'a
tentita	tent'it'a
tentaklo	tentakl'o
tentakloj	tentakl'o'j
tentaklojn	tentakl'o'j'n
teodora	teodor'a
teodoro	teodor'o
teodoron	teodor'o'n
teodora	teodora
teofilo	teofil'o
teokratia	teokrat'i'a
teokratio	teokrat'i'o
teologo	teolog'o
teologoj	teolog'o'j
teologojn	teolog'o'j'n
teologia	teolog'i'a
teologiaj	teolog'i'a'j
teologiajn	teolog'i'a'j'n
teologian	teolog'i'a'n
teologie	teolog'i'e
teologio	teolog'i'o
teologioj	teolog'i'o'j
teologion	teolog'i'o'n
teoremo	teorem'o
teoremoj	teorem'o'j
teoremojn	teorem'o'j'n
teoremon	teorem'o'n
teoria	teori'a
teoriaj	teori'a'j
teoriajn	teori'a'j'n
teorian	teori'a'n
teorie	teori'e
teorio	teori'o
teorioj	teori'o'j
teoriojn	teori'o'j'n
teorion	teori'o'n
teoriadas	teori'ad'as
teoriadis	teori'ad'is
teoriadita	teori'ad'it'a
teoriisto	teori'ist'o
teoriistoj	teori'ist'o'j
teoriulo	teori'ul'o
teoriuloj	teori'ul'o'j
teoriumado	teori'um'ad'o
teozofio	teozof'i'o
tera	ter'a
teraj	ter'a'j
terajn	ter'a'j'n
teran	ter'a'n
tere	ter'e
teren	ter'e'n
tero	ter'o
teroj	ter'o'j
terojn	ter'o'j'n
teron	ter'o'n
teraĵo	ter'aĵ'o
teramaso	ter'amas'o
teramasoj	ter'amas'o'j
terano	ter'an'o
teranoj	ter'an'o'j
teranojn	ter'an'o'j'n
terarmeaj	ter'arme'a'j
terarmeo	ter'arme'o
terarmeoj	ter'arme'o'j
terbazita	ter'baz'it'a
terbazitaj	ter'baz'it'a'j
terbestoj	ter'best'o'j
terbuloj	ter'bul'o'j
terebenigo	ter'eben'ig'o
tereca	ter'ec'a
teretaĝa	ter'etaĝ'a
teretaĝaj	ter'etaĝ'a'j
teretaĝe	ter'etaĝ'e
teretaĝo	ter'etaĝ'o
teretaĝon	ter'etaĝ'o'n
terformoj	ter'form'o'j
terformigo	ter'form'ig'o
tergaso	ter'gas'o
tergason	ter'gas'o'n
terglito	ter'glit'o
terglitoj	ter'glit'o'j
terglitojn	ter'glit'o'j'n
tergloba	ter'glob'a
terglobo	ter'glob'o
terglobon	ter'glob'o'n
terhundo	ter'hund'o
terkapo	ter'kap'o
terkarbo	ter'karb'o
terkerno	ter'kern'o
terkolo	ter'kol'o
terkonekto	ter'konekt'o
terkrusto	ter'krust'o
terkultivado	ter'kultiv'ad'o
terkultivadon	ter'kultiv'ad'o'n
terkultivejoj	ter'kultiv'ej'o'j
terkultivisto	ter'kultiv'ist'o
terkultivistoj	ter'kultiv'ist'o'j
terkultura	ter'kultur'a
terkulturaj	ter'kultur'a'j
terkulturan	ter'kultur'a'n
terkulturo	ter'kultur'o
terkulturado	ter'kultur'ad'o
terkulturadon	ter'kultur'ad'o'n
terkulturejoj	ter'kultur'ej'o'j
terkulturisto	ter'kultur'ist'o
terkulturistoj	ter'kultur'ist'o'j
terlango	ter'lang'o
terlito	ter'lit'o
termantelo	ter'mantel'o
termaso	ter'mas'o
termasoj	ter'mas'o'j
ternestoj	ter'nest'o'j
ternuksoj	ter'nuks'o'j
teroposedantoj	ter'o'posed'ant'o'j
terorbito	ter'orbit'o
terpeco	ter'pec'o
terpecoj	ter'pec'o'j
terpecojn	ter'pec'o'j'n
terpecon	ter'pec'o'n
terplantoj	ter'plant'o'j
terpoma	ter'pom'a
terpomaj	ter'pom'a'j
terpoman	ter'pom'a'n
terpomo	ter'pom'o
terpomoj	ter'pom'o'j
terpomojn	ter'pom'o'j'n
terpomon	ter'pom'o'n
terpomfingroj	ter'pom'fingr'o'j
terpomfingrojn	ter'pom'fingr'o'j'n
terpomkaĉo	ter'pom'kaĉ'o
terpomsalaton	ter'pom'salat'o'n
terposedado	ter'posed'ad'o
terposedaĵo	ter'posed'aĵ'o
terposedaĵoj	ter'posed'aĵ'o'j
terposedanta	ter'posed'ant'a
terposedanto	ter'posed'ant'o
terposedantoj	ter'posed'ant'o'j
terposedantojn	ter'posed'ant'o'j'n
terrenkonta	ter'renkont'a
terscienco	ter'scienc'o
tersimilaj	ter'simil'a'j
tersurfaco	ter'surfac'o
tersurfacon	ter'surfac'o'n
tertrema	ter'trem'a
tertreme	ter'trem'e
tertremo	ter'trem'o
tertremoj	ter'trem'o'j
tertremojn	ter'trem'o'j'n
tertremon	ter'trem'o'n
tertremego	ter'trem'eg'o
tertrupoj	ter'trup'o'j
tervermo	ter'verm'o
tervermoj	ter'verm'o'j
terakota	terakot'a
terakotaj	terakot'a'j
terakoto	terakot'o
terapia	terapi'a
terapiaj	terapi'a'j
terapiajn	terapi'a'j'n
terapian	terapi'a'n
terapie	terapi'e
terapio	terapi'o
terapioj	terapi'o'j
terapiojn	terapi'o'j'n
terapion	terapi'o'n
terapiisto	terapi'ist'o
terapiistoj	terapi'ist'o'j
terapiistojn	terapi'ist'o'j'n
terapiitaj	terapi'it'a'j
terasaj	teras'a'j
teraso	teras'o
terasoj	teras'o'j
terasojn	teras'o'j'n
terason	teras'o'n
teravado	teravad'o
tercio	terci'o
tercioj	terci'o'j
terciara	terciar'a
terciaraj	terciar'a'j
terciaran	terciar'a'n
terciaro	terciar'o
terena	teren'a
terenaj	teren'a'j
tereno	teren'o
terenoj	teren'o'j
terenojn	teren'o'j'n
terenon	teren'o'n
terenbati	teren'bat'i
terenbatis	teren'bat'is
terenbatita	teren'bat'it'a
terenfalis	teren'fal'is
terentia	terenti'a
terentio	terenti'o
teritoria	teritori'a
teritoriaj	teritori'a'j
teritoriajn	teritori'a'j'n
teritorian	teritori'a'n
teritorie	teritori'e
teritorio	teritori'o
teritorioj	teritori'o'j
teritoriojn	teritori'o'j'n
teritorion	teritori'o'n
teritorieco	teritori'ec'o
teritoriema	teritori'em'a
terma	term'a
terme	term'e
termo	term'o
termoj	term'o'j
termika	termik'a
termikaj	termik'a'j
termikajn	termik'a'j'n
termikan	termik'a'n
termike	termik'e
termikoj	termik'o'j
termina	termin'a
termino	termin'o
terminoj	termin'o'j
terminojn	termin'o'j'n
terminon	termin'o'n
terminaro	termin'ar'o
terminaroj	termin'ar'o'j
terminarojn	termin'ar'o'j'n
terminaron	termin'ar'o'n
terminego	termin'eg'o
terminografia	termin'o'graf'i'a
terminologia	termin'olog'i'a
terminologiaj	termin'olog'i'a'j
terminologiajn	termin'olog'i'a'j'n
terminologian	termin'olog'i'a'n
terminologio	termin'olog'i'o
terminologion	termin'olog'i'o'n
terminale	terminal'e
terminalo	terminal'o
terminaloj	terminal'o'j
terminalojn	terminal'o'j'n
terminalon	terminal'o'n
terminatoro	terminator'o
termitoj	termit'o'j
termitojn	termit'o'j'n
termoanalizo	termo'analiz'o
termobalanco	termo'balanc'o
termodinamika	termo'dinamik'a
termodinamikaj	termo'dinamik'a'j
termodinamikan	termo'dinamik'a'n
termodinamiko	termo'dinamik'o
termofonto	termo'font'o
termofontoj	termo'font'o'j
termokemio	termo'kemi'o
termometro	termo'metr'o
termometroj	termo'metr'o'j
termometrojn	termo'metr'o'j'n
termometron	termo'metr'o'n
termonuklea	termo'nukle'a
termonukleaj	termo'nukle'a'j
termoparo	termo'par'o
termoplasta	termo'plast'a
termoradiado	termo'radi'ad'o
termopiloj	termopil'o'j
termostato	termostat'o
termostatoj	termostat'o'j
ternas	tern'as
terni	tern'i
ternis	tern'is
terno	tern'o
ternado	tern'ad'o
ternara	ternar'a
ternaraj	ternar'a'j
terora	teror'a
teroraj	teror'a'j
teroran	teror'a'n
teroro	teror'o
teroron	teror'o'n
terorisma	teror'ism'a
terorismaj	teror'ism'a'j
terorismajn	teror'ism'a'j'n
terorisman	teror'ism'a'n
terorismo	teror'ism'o
terorismon	teror'ism'o'n
terorista	teror'ist'a
teroristaj	teror'ist'a'j
teroristajn	teror'ist'a'j'n
teroristan	teror'ist'a'n
teroristo	teror'ist'o
teroristoj	teror'ist'o'j
teroristojn	teror'ist'o'j'n
teroriston	teror'ist'o'n
terpenoj	terpen'o'j
terpinila	terpin'il'a
tertuliano	tertulian'o
terura	terur'a
teruraj	terur'a'j
terurajn	terur'a'j'n
teruran	terur'a'n
teruras	terur'as
terure	terur'e
teruri	terur'i
teruris	terur'is
teruro	terur'o
teruroj	terur'o'j
terurojn	terur'o'j'n
teruron	terur'o'n
teruraĵo	terur'aĵ'o
teruraĵoj	terur'aĵ'o'j
teruraĵojn	terur'aĵ'o'j'n
terurega	terur'eg'a
teruregaj	terur'eg'a'j
terurego	terur'eg'o
terurfilmojn	terur'film'o'j'n
teruriga	terur'ig'a
terurigaj	terur'ig'a'j
terurigas	terur'ig'as
terurigis	terur'ig'is
terurigita	terur'ig'it'a
terurigitaj	terur'ig'it'a'j
terurigite	terur'ig'it'e
teruriĝis	terur'iĝ'is
teruriĝo	terur'iĝ'o
terurita	terur'it'a
teruritaj	terur'it'a'j
terurite	terur'it'e
testa	test'a
testaj	test'a'j
testajn	test'a'j'n
testan	test'a'n
testas	test'as
testi	test'i
testis	test'is
testo	test'o
testoj	test'o'j
testojn	test'o'j'n
teston	test'o'n
testu	test'u
testus	test'us
testado	test'ad'o
testadon	test'ad'o'n
testanta	test'ant'a
testantaj	test'ant'a'j
testante	test'ant'e
testata	test'at'a
testataj	test'at'a'j
testita	test'it'a
testitaj	test'it'a'j
testite	test'it'e
testamentas	testament'as
testamente	testament'e
testamenti	testament'i
testamentis	testament'is
testamento	testament'o
testamentoj	testament'o'j
testamenton	testament'o'n
testika	testik'a
testiko	testik'o
testikoj	testik'o'j
testikojn	testik'o'j'n
testuda	testud'a
testudaj	testud'a'j
testudo	testud'o
testudoj	testud'o'j
testudojn	testud'o'j'n
testudon	testud'o'n
tetano	tetan'o
tetanoso	tetanos'o
tetrao	tetra'o
tetraoj	tetra'o'j
teŭtona	teŭton'a
teŭtonoj	teŭton'o'j
tia	ti'a
tiaj	ti'a'j
tiajn	ti'a'j'n
tian	ti'a'n
tio	ti'o
tion	ti'o'n
tiagrade	ti'a'grad'e
tiakaze	ti'a'kaz'e
tiamaniere	ti'a'manier'e
tiaokaze	ti'a'okaz'e
tiasence	ti'a'senc'e
tiaspeca	ti'a'spec'a
tiaspecaj	ti'a'spec'a'j
tiaspecajn	ti'a'spec'a'j'n
tiaspecan	ti'a'spec'a'n
tiatempe	ti'a'temp'e
tiaĵo	ti'aĵ'o
tiaĵoj	ti'aĵ'o'j
tiaĵojn	ti'aĵ'o'j'n
tiaĵon	ti'aĵ'o'n
timida	timid'a
timidaj	timid'a'j
timide	timid'e
tiocianato	tio'cian'at'o
tiokarbonato	tio'karbon'at'o
tiosulfato	tio'sulf'at'o
trinkas	trink'as
trinki	trink'i
trinkis	trink'is
trinko	trink'o
trinkon	trink'o'n
trinkos	trink'os
trinku	trink'u
trinkus	trink'us
trinkadis	trink'ad'is
trinkado	trink'ad'o
trinkadon	trink'ad'o'n
trinkajho	trink'aĵ'o
trinkaĵo	trink'aĵ'o
trinkaĵoj	trink'aĵ'o'j
trinkaĵojn	trink'aĵ'o'j'n
trinkaĵon	trink'aĵ'o'n
trinkakvo	trink'akv'o
trinkakvon	trink'akv'o'n
trinkanta	trink'ant'a
trinkantaj	trink'ant'a'j
trinkante	trink'ant'e
trinkata	trink'at'a
trinkebla	trink'ebl'a
trinkeblan	trink'ebl'a'n
trinkeblas	trink'ebl'as
trinkeja	trink'ej'a
trinkejo	trink'ej'o
trinkejoj	trink'ej'o'j
trinkejojn	trink'ej'o'j'n
trinkejon	trink'ej'o'n
trinketis	trink'et'is
trinketo	trink'et'o
trinkigas	trink'ig'as
trinkigi	trink'ig'i
trinkigis	trink'ig'is
trinkigos	trink'ig'os
trinkinta	trink'int'a
trinkinte	trink'int'e
trinkita	trink'it'a
trinkitaj	trink'it'a'j
trinkmono	trink'mon'o
trinkmonon	trink'mon'o'n
trinkujo	trink'uj'o
trova	trov'a
trovaj	trov'a'j
trovas	trov'as
trovi	trov'i
trovadis	trov'ad'is
trovado	trov'ad'o
trovaĵo	trov'aĵ'o
trovaĵoj	trov'aĵ'o'j
trovaĵojn	trov'aĵ'o'j'n
trovaĵon	trov'aĵ'o'n
trovanta	trov'ant'a
trovantaj	trov'ant'a'j
trovantan	trov'ant'a'n
trovante	trov'ant'e
trovanto	trov'ant'o
trovata	trov'at'a
trovataj	trov'at'a'j
trovatas	trov'at'as
trovebla	trov'ebl'a
troveblaj	trov'ebl'a'j
troveblajn	trov'ebl'a'j'n
troveblan	trov'ebl'a'n
troveblas	trov'ebl'as
troveblis	trov'ebl'is
trovejo	trov'ej'o
trovejoj	trov'ej'o'j
trovigas	trov'ig'as
turniĝas	turn'iĝ'as
turniĝi	turn'iĝ'i
turniĝis	turn'iĝ'is
turniĝo	turn'iĝ'o
turniĝoj	turn'iĝ'o'j
turniĝon	turn'iĝ'o'n
turniĝos	turn'iĝ'os
turniĝu	turn'iĝ'u
turniĝadis	turn'iĝ'ad'is
turniĝado	turn'iĝ'ad'o
turniĝanta	turn'iĝ'ant'a
turniĝantaj	turn'iĝ'ant'a'j
turniĝantan	turn'iĝ'ant'a'n
turniĝante	turn'iĝ'ant'e
turniĝinte	turn'iĝ'int'e
turnita	turn'it'a
turnitaj	turn'it'a'j
turnitajn	turn'it'a'j'n
tuŝa	tuŝ'a
tuŝas	tuŝ'as
tuŝi	tuŝ'i
tuŝis	tuŝ'is
tuŝo	tuŝ'o
tuŝoj	tuŝ'o'j
tuŝon	tuŝ'o'n
tuŝos	tuŝ'os
tuŝu	tuŝ'u
tuŝus	tuŝ'us
tuŝado	tuŝ'ad'o
tuŝanta	tuŝ'ant'a
tuŝantaj	tuŝ'ant'a'j
tuŝantajn	tuŝ'ant'a'j'n
tuŝante	tuŝ'ant'e
tuŝata	tuŝ'at'a
tuŝataj	tuŝ'at'a'j
tuŝebla	tuŝ'ebl'a
tuŝekrano	tuŝ'ekran'o
tuŝekranon	tuŝ'ekran'o'n
tuŝetas	tuŝ'et'as
tuŝeti	tuŝ'et'i
tuŝetis	tuŝ'et'is
tuŝetante	tuŝ'et'ant'e
tuŝinte	tuŝ'int'e
tuŝita	tuŝ'it'a
tuŝitaj	tuŝ'it'a'j
tuta	tut'a
tutaj	tut'a'j
tutajn	tut'a'j'n
tutan	tut'a'n
tute	tut'e
tuto	tut'o
tuton	tut'o'n
tutaĵo	tut'aĵ'o
tutaĵoj	tut'aĵ'o'j
tutaĵon	tut'aĵ'o'n
tuteca	tut'ec'a
tutecaj	tut'ec'a'j
tutecan	tut'ec'a'n
tutece	tut'ec'e
tuteco	tut'ec'o
tutecon	tut'ec'o'n
tutegale	tut'egal'e
tutesperanta	tut'esperant'a
tuteŭropa	tut'eŭrop'a
tuteŭropaj	tut'eŭrop'a'j
tuteŭropan	tut'eŭrop'a'n
tutforte	tut'fort'e
tutgloba	tut'glob'a
tutglobaj	tut'glob'a'j
tutgloban	tut'glob'a'n
tuthomara	tut'hom'ar'a
tutjara	tut'jar'a
tutjaran	tut'jar'a'n
tutjare	tut'jar'e
tutklare	tut'klar'e
tutkora	tut'kor'a
tutkore	tut'kor'e
tutkorpa	tut'korp'a
tutkorpe	tut'korp'e
tutlanda	tut'land'a
tutlandaj	tut'land'a'j
tutlandajn	tut'land'a'j'n
tutlandan	tut'land'a'n
tutlande	tut'land'e
tutmonata	tut'monat'a
tutmonda	tut'mond'a
tutmondaj	tut'mond'a'j
tutmondajn	tut'mond'a'j'n
tutmondan	tut'mond'a'n
tutmonde	tut'mond'e
tutmonden	tut'mond'e'n
tutmondo	tut'mond'o
tutmondeco	tut'mond'ec'o
tutmondigo	tut'mond'ig'o
tutmondiĝa	tut'mond'iĝ'a
tutmondigho	tut'mond'iĝ'o
tutmondiĝo	tut'mond'iĝ'o
tutmondiĝon	tut'mond'iĝ'o'n
tutnacia	tut'naci'a
tutnokta	tut'nokt'a
tutnokte	tut'nokt'e
tutnova	tut'nov'a
tutnovaj	tut'nov'a'j
tutnovan	tut'nov'a'n
tutpaĝaj	tut'paĝ'a'j
tutplaneda	tut'planed'a
tutplene	tut'plen'e
tutpopola	tut'popol'a
tutrusia	tut'rusi'a
tutsame	tut'sam'e
tutsemajna	tut'semajn'a
tutsimple	tut'simpl'e
tutsola	tut'sol'a
tutsole	tut'sol'e
tutŝtata	tut'ŝtat'a
tutŝtataj	tut'ŝtat'a'j
tutsumo	tut'sum'o
tutsumon	tut'sum'o'n
tuttaga	tut'tag'a
tuttagaj	tut'tag'a'j
tuttagan	tut'tag'a'n
tuttage	tut'tag'e
tuttempa	tut'temp'a
tuttempe	tut'temp'e
tuttera	tut'ter'a
tutteran	tut'ter'a'n
tuturba	tut'urb'a
tutviva	tut'viv'a
tutvive	tut'viv'e
tuvala	tuval'a
tuvalo	tuval'o