uverbo	u'verb'o
uea	uea
ueailei	uea'ilei
ueatejo	uea'tejo
ueaano	uea'an'o
ueaanoj	uea'an'o'j
ueaestraro	uea'estr'ar'o
ueaestrarano	uea'estr'ar'an'o
ueaestraranoj	uea'estr'ar'an'o'j
ueagvidantoj	uea'gvid'ant'o'j
ueakomitato	uea'komitat'o
ueakonto	uea'kont'o
ueamembroj	uea'membr'o'j
ueaprezidanto	uea'prezid'ant'o
uedo	ued'o
uganda	ugand'a
ugando	ugand'o
ujo	uj'o
ujoj	uj'o'j
ujojn	uj'o'j'n
ujon	uj'o'n
ukazo	ukaz'o
ukraina	ukrain'a
ukrainaj	ukrain'a'j
ukrainajn	ukrain'a'j'n
ukrainan	ukrain'a'n
ukraine	ukrain'e
ukraino	ukrain'o
ukrainoj	ukrain'o'j
ukrainanoj	ukrain'an'o'j
ukrainia	ukrain'i'a
ukrainiaj	ukrain'i'a'j
ukrainian	ukrain'i'a'n
ukrainio	ukrain'i'o
ukrainion	ukrain'i'o'n
ukrainujo	ukrain'uj'o
ukrajna	ukrajn'a
ukrajno	ukrajn'o
ula	ul'a
ulo	ul'o
uloj	ul'o'j
ulojn	ul'o'j'n
ulon	ul'o'n
ulaĉo	ul'aĉ'o
ulaĉoj	ul'aĉ'o'j
ularo	ul'ar'o
uleto	ul'et'o
ulino	ul'in'o
ulinoj	ul'in'o'j
ulinon	ul'in'o'n
ulanbatoro	ulanbator'o
ulcero	ulcer'o
ulceroj	ulcer'o'j
ulcerojn	ulcer'o'j'n
ulemo	ulem'o
uliso	ulis'o
ulmo	ulm'o
ulmoj	ulm'o'j
ulno	uln'o
ulnoj	uln'o'j
ulnojn	uln'o'j'n
ulnon	uln'o'n
ultimate	ultimat'e
ultimato	ultimat'o
ultimaton	ultimat'o'n
ultra	ultra
ultrasona	ultra'son'a
ultrasono	ultra'son'o
ultrasonon	ultra'son'o'n
ultrasonografio	ultra'son'o'graf'i'o
ultraviola	ultra'viol'a
ultraviolaj	ultra'viol'a'j
ultraviolan	ultra'viol'a'n
ululas	ulul'as
ululo	ulul'o
ululoj	ulul'o'j
umas	um'as
umi	um'i
umis	um'is
umo	um'o
umadis	um'ad'is
umado	um'ad'o
umajadoj	umajad'o'j
umbando	umband'o
umbelo	umbel'o
umbeloj	umbel'o'j
umbilika	umbilik'a
umbiliko	umbilik'o
umbilikon	umbilik'o'n
umbilikkordosango	umbilik'kord'o'sang'o
umea	ume'a
umeo	ume'o
umea	umea
umlaŭto	umlaŭt'o
uncialo	uncial'o
ungo	ung'o
ungoj	ung'o'j
ungojn	ung'o'j'n
ungon	ung'o'n
ungego	ung'eg'o
ungegoj	ung'eg'o'j
ungegojn	ung'eg'o'j'n
ungolako	ung'o'lak'o
ungvento	ungvent'o
ungventoj	ungvent'o'j
ungventon	ungvent'o'n
unia	uni'a
uniaj	uni'a'j
unio	uni'o
unioj	uni'o'j
union	uni'o'n
uniistoj	uni'ist'o'j
uniunudirekta	uni'unu'direkt'a
uniforma	uniform'a
uniformaj	uniform'a'j
uniforman	uniform'a'n
uniforme	uniform'e
uniformo	uniform'o
uniformoj	uniform'o'j
uniformojn	uniform'o'j'n
uniformon	uniform'o'n
uniformita	uniform'it'a
uniformitaj	uniform'it'a'j
unika	unik'a
unikaj	unik'a'j
unikajn	unik'a'j'n
unikan	unik'a'n
unikas	unik'as
unike	unik'e
unikaĵo	unik'aĵ'o
unikaĵojn	unik'aĵ'o'j'n
unikeco	unik'ec'o
unikecon	unik'ec'o'n
unikoda	unikod'a
unikodaj	unikod'a'j
unikodan	unikod'a'n
unikodo	unikod'o
unikodon	unikod'o'n
unikso	uniks'o
uniksosimilaj	uniks'o'simil'a'j
unisone	unison'e
unita	unit'a
unitoj	unit'o'j
unitaria	unitari'a
unitariaj	unitari'a'j
unitarian	unitari'a'n
universa	univers'a
universe	univers'e
universo	univers'o
universoj	univers'o'j
universojn	univers'o'j'n
universon	univers'o'n
universala	universal'a
universalaj	universal'a'j
universalajn	universal'a'j'n
universalan	universal'a'n
universale	universal'e
universalaĵo	universal'aĵ'o
universalaĵoj	universal'aĵ'o'j
universalaĵojn	universal'aĵ'o'j'n
universaleco	universal'ec'o
universalecon	universal'ec'o'n
universalismo	universal'ism'o
universitata	universitat'a
universitataj	universitat'a'j
universitatajn	universitat'a'j'n
universitatan	universitat'a'n
universitate	universitat'e
universitato	universitat'o
universitatoj	universitat'o'j
universitatojn	universitat'o'j'n
universitaton	universitat'o'n
universitatanoj	universitat'an'o'j
universitatejo	universitat'ej'o
universitateldonejo	universitat'el'don'ej'o
universitatnivela	universitat'nivel'a
universitatnivelaj	universitat'nivel'a'j
unu	unu
unua	unu'a
unuaj	unu'a'j
unuajn	unu'a'j'n
unuan	unu'a'n
unudu	unu'du
unue	unu'e
unun	unu'n
unuo	unu'o
unuoj	unu'o'j
unuojn	unu'o'j'n
unuon	unu'o'n
unuaflanke	unu'a'flank'e
unuafoja	unu'a'foj'a
unuafojaj	unu'a'foj'a'j
unuafoje	unu'a'foj'e
unuafojon	unu'a'foj'o'n
unuageneraciaj	unu'a'generaci'a'j
unuagrada	unu'a'grad'a
unuagradaj	unu'a'grad'a'j
unuajara	unu'a'jar'a
unuajarcenta	unu'a'jar'cent'a
unuajarulo	unu'a'jar'ul'o
unuajaruloj	unu'a'jar'ul'o'j
unuaklasa	unu'a'klas'a
unuaklasaj	unu'a'klas'a'j
unuaklasan	unu'a'klas'a'n
unualinie	unu'a'lini'e
unualoke	unu'a'lok'e
unuaorda	unu'a'ord'a
unuaordaj	unu'a'ord'a'j
unuapaŝa	unu'a'paŝ'a
unuapaŝe	unu'a'paŝ'e
unuapersona	unu'a'person'a
unuaranga	unu'a'rang'a
unuarangaj	unu'a'rang'a'j
unuarangajn	unu'a'rang'a'j'n
unuarangan	unu'a'rang'a'n
unuarange	unu'a'rang'e
unuarangeco	unu'a'rang'ec'o
unuarangecon	unu'a'rang'ec'o'n
unuarigarde	unu'a'rigard'e
unuatempe	unu'a'temp'e
unuavica	unu'a'vic'a
unuavice	unu'a'vic'e
unuavide	unu'a'vid'e
unuaĵo	unu'aĵ'o
unuajaraj	unu'ajar'a'j
unuakta	unu'akt'a
unuanima	unu'anim'a
unuanimaj	unu'anim'a'j
unuaniman	unu'anim'a'n
unuanime	unu'anim'e
unuanimeco	unu'anim'ec'o
unuanimecon	unu'anim'ec'o'n
unubaza	unu'baz'a
unuĉambra	unu'ĉambr'a
unuĉela	unu'ĉel'a
unuĉelaj	unu'ĉel'a'j
unudekono	unu'dek'on'o
unudimensia	unu'dimensi'a
unudimensiaj	unu'dimensi'a'j
unudirekta	unu'direkt'a
unudirektaj	unu'direkt'a'j
unudirektajn	unu'direkt'a'j'n
unudirektan	unu'direkt'a'n
unudirekte	unu'direkt'e
unudufoje	unu'du'foj'e
unuenaskita	unu'e'nask'it'a
unuenaskito	unu'e'nask'it'o
unuenaskiton	unu'e'nask'it'o'n
unueca	unu'ec'a
unuecaj	unu'ec'a'j
unuecajn	unu'ec'a'j'n
unuecan	unu'ec'a'n
unuece	unu'ec'e
unueco	unu'ec'o
unuecoj	unu'ec'o'j
unuecojn	unu'ec'o'j'n
unuecon	unu'ec'o'n
unueciga	unu'ec'ig'a
unuecigan	unu'ec'ig'a'n
unuecigi	unu'ec'ig'i
unuecigis	unu'ec'ig'is
unuecigo	unu'ec'ig'o
unuetaĝa	unu'etaĝ'a
unuetaĝaj	unu'etaĝ'a'j
unufamiliaj	unu'famili'a'j
unufaza	unu'faz'a
unufazaj	unu'faz'a'j
unuflanka	unu'flank'a
unuflankaj	unu'flank'a'j
unuflankan	unu'flank'a'n
unuflanke	unu'flank'e
unuflankeco	unu'flank'ec'o
unufoja	unu'foj'a
unufojaj	unu'foj'a'j
unufojan	unu'foj'a'n
unufoje	unu'foj'e
unufojon	unu'foj'o'n
unuforma	unu'form'a
unuformaj	unu'form'a'j
unuformajn	unu'form'a'j'n
unuforman	unu'form'a'n
unuforme	unu'form'e
unuformeco	unu'form'ec'o
unuformecon	unu'form'ec'o'n
unuglute	unu'glut'e
unuhora	unu'hor'a
unuhoran	unu'hor'a'n
unuiga	unu'ig'a
unuigaj	unu'ig'a'j
unuigan	unu'ig'a'n
unuigas	unu'ig'as
unuigi	unu'ig'i
unuigis	unu'ig'is
unuigo	unu'ig'o
unuigon	unu'ig'o'n
unuigos	unu'ig'os
unuigu	unu'ig'u
unuigado	unu'ig'ad'o
unuiganta	unu'ig'ant'a
unuigante	unu'ig'ant'e
unuigita	unu'ig'it'a
unuigitaj	unu'ig'it'a'j
unuigitan	unu'ig'it'a'n
unuigite	unu'ig'it'e
unuiĝa	unu'iĝ'a
unuiĝas	unu'iĝ'as
unuiĝi	unu'iĝ'i
unuiĝis	unu'iĝ'is
unuigho	unu'iĝ'o
unuiĝo	unu'iĝ'o
unuiĝoj	unu'iĝ'o'j
unuiĝojn	unu'iĝ'o'j'n
unuiĝon	unu'iĝ'o'n
unuiĝos	unu'iĝ'os
unuiĝu	unu'iĝ'u
unuiĝanta	unu'iĝ'ant'a
unuiĝinta	unu'iĝ'int'a
unuiĝintaj	unu'iĝ'int'a'j
unuiĝintajn	unu'iĝ'int'a'j'n
unuiĝintan	unu'iĝ'int'a'n
unuiĝonta	unu'iĝ'ont'a
unuinfana	unu'infan'a
unujara	unu'jar'a
unujaraj	unu'jar'a'j
unujaran	unu'jar'a'n
unujarcenta	unu'jar'cent'a
unukamera	unu'kamer'a
unukolora	unu'kolor'a
unukoloraj	unu'kolor'a'j
unukontraŭunu	unu'kontraŭ'unu
unukornulo	unu'korn'ul'o
unukornuloj	unu'korn'ul'o'j
unukornulon	unu'korn'ul'o'n
unukotiledonaj	unu'kotiledon'a'j
unukvarono	unu'kvar'on'o
unukvaronon	unu'kvar'on'o'n
unukvinono	unu'kvin'on'o
unulingva	unu'lingv'a
unulingvaj	unu'lingv'a'j
unulingvan	unu'lingv'a'n
unulingveco	unu'lingv'ec'o
unulingvismo	unu'lingv'ism'o
unulinia	unu'lini'a
unuloke	unu'lok'e
unuludanta	unu'lud'ant'a
unuminuta	unu'minut'a
unumomente	unu'moment'e
unumonata	unu'monat'a
unumondo	unu'mond'o
unumondomilito	unu'mond'o'milit'o
unumotoraj	unu'motor'a'j
ununatria	unu'natri'a
ununava	unu'nav'a
ununoma	unu'nom'a
ununombra	unu'nombr'a
ununombraj	unu'nombr'a'j
ununombran	unu'nombr'a'n
ununombre	unu'nombr'e
ununombro	unu'nombr'o
ununombron	unu'nombr'o'n
ununura	unu'nur'a
ununuraj	unu'nur'a'j
ununurajn	unu'nur'a'j'n
ununuran	unu'nur'a'n
unuoĉelo	unu'o'ĉel'o
unuolongo	unu'o'long'o
unuomaso	unu'o'mas'o
unuotempo	unu'o'temp'o
unuovolumeno	unu'o'volumen'o
unuobla	unu'obl'a
unuoksido	unu'oksid'o
unuokula	unu'okul'a
unuokuleco	unu'okul'ec'o
unuopa	unu'op'a
unuopaj	unu'op'a'j
unuopajn	unu'op'a'j'n
unuopan	unu'op'a'n
unuope	unu'op'e
unuopo	unu'op'o
unuopoj	unu'op'o'j
unuopon	unu'op'o'n
unuopaĵa	unu'op'aĵ'a
unuopaĵo	unu'op'aĵ'o
unuopaĵoj	unu'op'aĵ'o'j
unuopaĵon	unu'op'aĵ'o'n
unuopula	unu'op'ul'a
unuopulo	unu'op'ul'o
unuopuloj	unu'op'ul'o'j
unuopulojn	unu'op'ul'o'j'n
unuopulon	unu'op'ul'o'n
unuovaj	unu'ov'a'j
unupartia	unu'parti'a
unupartiaj	unu'parti'a'j
unupartiajn	unu'parti'a'j'n
unupartian	unu'parti'a'n
unupartie	unu'parti'e
unupaŝo	unu'paŝ'o
unupeca	unu'pec'a
unupersona	unu'person'a
unupersonaj	unu'person'a'j
unupolusa	unu'polus'a
unupunkta	unu'punkt'a
unureĝima	unu'reĝim'a
unusama	unu'sam'a
unuseksa	unu'seks'a
unuseksaj	unu'seks'a'j
unusemajna	unu'semajn'a
unusemajnan	unu'semajn'a'n
unusenca	unu'senc'a
unusence	unu'senc'e
unusignifa	unu'signif'a
unusignifan	unu'signif'a'n
unusignife	unu'signif'e
unusilaba	unu'silab'a
unusilabaj	unu'silab'a'j
unusilaboj	unu'silab'o'j
unusimetriaj	unu'simetri'a'j
unusola	unu'sol'a
unusolaj	unu'sol'a'j
unusolan	unu'sol'a'n
unusole	unu'sol'e
unuspire	unu'spir'e
unutaga	unu'tag'a
unutagan	unu'tag'a'n
unutavolaĵo	unu'tavol'aĵ'o
unutona	unu'ton'a
unutriono	unu'tri'on'o
unutrionon	unu'tri'on'o'n
unuuza	unu'uz'a
unuuzaj	unu'uz'a'j
unuvira	unu'vir'a
unuvoĉa	unu'voĉ'a
unuvoĉe	unu'voĉ'e
unuvorte	unu'vort'e
unuel	unuel
unuto	unut'o
upaniŝado	upaniŝad'o
upaniŝadoj	upaniŝad'o'j
uragana	uragan'a
uragano	uragan'o
uraganoj	uragan'o'j
uraganojn	uragan'o'j'n
uraganon	uragan'o'n
urala	ural'a
uralaj	ural'a'j
uralo	ural'o
urano	uran'o
uranon	uran'o'n
urania	urani'a
uranio	urani'o
uranion	urani'o'n
urba	urb'a
urbaj	urb'a'j
urbajn	urb'a'j'n
urban	urb'a'n
urbe	urb'e
urben	urb'e'n
urbi	urb'i
urbo	urb'o
urboj	urb'o'j
urbojn	urb'o'j'n
urbon	urb'o'n
urbana	urb'an'a
urbano	urb'an'o
urbanoj	urb'an'o'j
urbanojn	urb'an'o'j'n
urbanaro	urb'an'ar'o
urbanaron	urb'an'ar'o'n
urbaro	urb'ar'o
urbcentro	urb'centr'o
urbdomo	urb'dom'o
urbeca	urb'ec'a
urbego	urb'eg'o
urbegoj	urb'eg'o'j
urbegon	urb'eg'o'n
urbestra	urb'estr'a
urbestro	urb'estr'o
urbestroj	urb'estr'o'j
urbestron	urb'estr'o'n
urbestraro	urb'estr'ar'o
urbeta	urb'et'a
urbetaj	urb'et'a'j
urbeto	urb'et'o
urbetoj	urb'et'o'j
urbetojn	urb'et'o'j'n
urbeton	urb'et'o'n
urbigo	urb'ig'o
urbigon	urb'ig'o'n
urbocentra	urb'o'centr'a
urbocentraj	urb'o'centr'a'j
urbocentre	urb'o'centr'e
urbocentro	urb'o'centr'o
urbocentroj	urb'o'centr'o'j
urbocentron	urb'o'centr'o'n
urbocentrolimoj	urb'o'centr'o'lim'o'j
urbodelegitaro	urb'o'deleg'it'ar'o
urbodoma	urb'o'dom'a
urbodomo	urb'o'dom'o
urbodomoj	urb'o'dom'o'j
urbodomon	urb'o'dom'o'n
urbokerna	urb'o'kern'a
urbokernaj	urb'o'kern'a'j
urbokerno	urb'o'kern'o
urbokernon	urb'o'kern'o'n
urbokvartalo	urb'o'kvartal'o
urbomapon	urb'o'map'o'n
urbomezo	urb'o'mez'o
urbomuro	urb'o'mur'o
urbomuroj	urb'o'mur'o'j
urbomurojn	urb'o'mur'o'j'n
urbomuron	urb'o'mur'o'n
urbonomo	urb'o'nom'o
urbonomoj	urb'o'nom'o'j
urboparko	urb'o'park'o
urboparto	urb'o'part'o
urbopartoj	urb'o'part'o'j
urboparton	urb'o'part'o'n
urboplaco	urb'o'plac'o
urboplanado	urb'o'plan'ad'o
urboplanistoj	urb'o'plan'ist'o'j
urbopordegoj	urb'o'pord'eg'o'j
urborando	urb'o'rand'o
urbosilueto	urb'o'siluet'o
urbosilueton	urb'o'siluet'o'n
urboŝtato	urb'o'ŝtat'o
urboŝtatoj	urb'o'ŝtat'o'j
urboŝtatojn	urb'o'ŝtat'o'j'n
urbotipa	urb'o'tip'a
urboficistoj	urb'ofic'ist'o'j
urbaniza	urbaniz'a
urbanizado	urbaniz'ad'o
urbanizita	urbaniz'it'a
urbanizitaj	urbaniz'it'a'j
ureo	ure'o
ureon	ure'o'n
ureata	ureat'a
uretero	ureter'o
uretro	uretr'o
urĝa	urĝ'a
urĝaj	urĝ'a'j
urĝajn	urĝ'a'j'n
urĝan	urĝ'a'n
urĝas	urĝ'as
urĝe	urĝ'e
urĝi	urĝ'i
urĝis	urĝ'is
urĝo	urĝ'o
urĝon	urĝ'o'n
urĝos	urĝ'os
urĝu	urĝ'u
urĝata	urĝ'at'a
urĝeco	urĝ'ec'o
urĝecon	urĝ'ec'o'n
urĝigis	urĝ'ig'is
urĝiĝas	urĝ'iĝ'as
urĝiĝu	urĝ'iĝ'u
urina	urin'a
urinas	urin'as
urini	urin'i
urinis	urin'is
urino	urin'o
urinon	urin'o'n
urinado	urin'ad'o
urinveziko	urin'vezik'o
urno	urn'o
urnoj	urn'o'j
urnojn	urn'o'j'n
urnon	urn'o'n
ursa	urs'a
ursaj	urs'a'j
ursan	urs'a'n
urso	urs'o
ursoj	urs'o'j
ursojn	urs'o'j'n
urson	urs'o'n
urseto	urs'et'o
ursido	urs'id'o
ursino	urs'in'o
ursinon	urs'in'o'n
ursula	ursul'a
urtiko	urtik'o
urtikoj	urtik'o'j
urtikario	urtikari'o
urugvaja	urugvaj'a
urugvajo	urugvaj'o
urumĉio	urumĉi'o
usformo	us'form'o
usona	uson'a
usonaj	uson'a'j
usonajn	uson'a'j'n
usonan	uson'a'n
usone	uson'e
usono	uson'o
usonon	uson'o'n
usonano	uson'an'o
usonanoj	uson'an'o'j
usonanojn	uson'an'o'j'n
usonanino	uson'an'in'o
usonangla	uson'angl'a
usonomararmeo	uson'o'mar'arme'o
usonomilitistaro	uson'o'milit'ist'ar'o
usonoregistaro	uson'o'reg'ist'ar'o
utera	uter'a
uteran	uter'a'n
utero	uter'o
uteroj	uter'o'j
uteron	uter'o'n
utila	util'a
utilaj	util'a'j
utilajn	util'a'j'n
utilan	util'a'n
utilas	util'as
utile	util'e
utili	util'i
utilis	util'is
utilo	util'o
utiloj	util'o'j
utilojn	util'o'j'n
utilon	util'o'n
utilos	util'os
utilu	util'u
utilus	util'us
utilaĵoj	util'aĵ'o'j
utilaĵojn	util'aĵ'o'j'n
utilante	util'ant'e
utileca	util'ec'a
utileco	util'ec'o
utilecon	util'ec'o'n
utilega	util'eg'a
utilegas	util'eg'as
utiliga	util'ig'a
utiligas	util'ig'as
utiligi	util'ig'i
utiligis	util'ig'is
utiligo	util'ig'o
utiligoj	util'ig'o'j
utiligon	util'ig'o'n
utiligos	util'ig'os
utiligu	util'ig'u
utiligus	util'ig'us
utiligado	util'ig'ad'o
utiligadon	util'ig'ad'o'n
utiliganta	util'ig'ant'a
utiligantaj	util'ig'ant'a'j
utiligantajn	util'ig'ant'a'j'n
utiligantan	util'ig'ant'a'n
utiligante	util'ig'ant'e
utiligata	util'ig'at'a
utiligataj	util'ig'at'a'j
utiligebla	util'ig'ebl'a
utiligeblaj	util'ig'ebl'a'j
utiligeblan	util'ig'ebl'a'n
utiligita	util'ig'it'a
utiligitaj	util'ig'it'a'j
utiligitajn	util'ig'it'a'j'n
utiligitan	util'ig'it'a'n
utiligite	util'ig'it'e
utiliĝas	util'iĝ'as
utilisma	util'ism'a
utilismaj	util'ism'a'j
utilisman	util'ism'a'n
utilismo	util'ism'o
utilplanto	util'plant'o
utilŝarĝa	util'ŝarĝ'a
utilŝarĝan	util'ŝarĝ'a'n
utopia	utopi'a
utopiaj	utopi'a'j
utopian	utopi'a'n
utopio	utopi'o
utopioj	utopi'o'j
utopiojn	utopi'o'j'n
utopion	utopi'o'n
utopiistoj	utopi'ist'o'j
utreĥto	utreĥt'o
uverturo	uvertur'o
uverturoj	uvertur'o'j
uvula	uvul'a
uza	uz'a
uzaj	uz'a'j
uzajn	uz'a'j'n
uzan	uz'a'n
uzas	uz'as
uzi	uz'i
uzis	uz'is
uzo	uz'o
uzoj	uz'o'j
uzojn	uz'o'j'n
uzon	uz'o'n
uzos	uz'os
uzu	uz'u
uzus	uz'us
uzadas	uz'ad'as
uzadi	uz'ad'i
uzadis	uz'ad'is
uzado	uz'ad'o
uzadoj	uz'ad'o'j
uzadon	uz'ad'o'n
uzaĵoj	uz'aĵ'o'j
uzaĵojn	uz'aĵ'o'j'n
uzanta	uz'ant'a
uzantaj	uz'ant'a'j
uzantajn	uz'ant'a'j'n
uzantan	uz'ant'a'n
uzante	uz'ant'e
uzanto	uz'ant'o
uzantoj	uz'ant'o'j
uzantojn	uz'ant'o'j'n
uzanton	uz'ant'o'n
uzantaro	uz'ant'ar'o
uzantinterfaco	uz'ant'inter'fac'o
uzantinterfacoj	uz'ant'inter'fac'o'j
uzantinterfacon	uz'ant'inter'fac'o'n
uzantnomo	uz'ant'nom'o
uzantointerfaco	uz'ant'o'inter'fac'o
uzantointerfacoj	uz'ant'o'inter'fac'o'j
uzantointerfacojn	uz'ant'o'inter'fac'o'j'n
uzantointerfacon	uz'ant'o'inter'fac'o'n
uzantosperto	uz'ant'o'spert'o
uzata	uz'at'a
uzataj	uz'at'a'j
uzatajn	uz'at'a'j'n
uzatan	uz'at'a'n
uzatas	uz'at'as
uzate	uz'at'e
uzati	uz'at'i
uzatis	uz'at'is
uzebla	uz'ebl'a
uzeblaj	uz'ebl'a'j
uzeblajn	uz'ebl'a'j'n
uzeblan	uz'ebl'a'n
uzeblas	uz'ebl'as
uzeble	uz'ebl'e
uzeblis	uz'ebl'is
uzeblo	uz'ebl'o
uzeblon	uz'ebl'o'n
uzebleco	uz'ebl'ec'o
uzeblecon	uz'ebl'ec'o'n
uzenda	uz'end'a
uzendaj	uz'end'a'j
uziĝas	uz'iĝ'as
uziĝi	uz'iĝ'i
uziĝis	uz'iĝ'is
uzinda	uz'ind'a
uzindaj	uz'ind'a'j
uzinta	uz'int'a
uzintaj	uz'int'a'j
uzinte	uz'int'e
uzita	uz'it'a
uzitaj	uz'it'a'j
uzitajn	uz'it'a'j'n
uzitan	uz'it'a'n
uzite	uz'it'e
uzitis	uz'it'is
uzkazoj	uz'kaz'o'j
uzkonsumi	uz'konsum'i
uzmaniero	uz'manier'o
uzokutimo	uz'o'kutim'o
uzokutimoj	uz'o'kutim'o'j
uzokutimojn	uz'o'kutim'o'j'n
uzokutimon	uz'o'kutim'o'n
uzota	uz'ot'a
uzotaj	uz'ot'a'j
uzula	uz'ul'a
uzulo	uz'ul'o
uzulinterfaco	uz'ul'inter'fac'o
uzbeka	uzbek'a
uzbekaj	uzbek'a'j
uzbeko	uzbek'o
uzbekoj	uzbek'o'j
uzbekio	uzbek'i'o
uzbekistano	uzbek'ist'an'o
uzina	uzin'a
uzinaj	uzin'a'j
uzino	uzin'o
uzinoj	uzin'o'j
uzinojn	uzin'o'j'n
uzinon	uzin'o'n
uzinposedanto	uzin'posed'ant'o
uzuro	uzur'o
uzuron	uzur'o'n
uzurpi	uzurp'i
uzurpis	uzurp'is
uzurpanto	uzurp'ant'o
uzurpantoj	uzurp'ant'o'j
uzurpita	uzurp'it'a