vada	vad'a
vadaj	vad'a'j
vadas	vad'as
vade	vad'e
vadi	vad'i
vadis	vad'is
vado	vad'o
vadoj	vad'o'j
vadadis	vad'ad'is
vadado	vad'ad'o
vadante	vad'ant'e
vadanti	vad'ant'i
vadbaseno	vad'basen'o
vadbirdo	vad'bird'o
vadbirdoj	vad'bird'o'j
vadbirdojn	vad'bird'o'j'n
vadbotoj	vad'bot'o'j
vadejo	vad'ej'o
vadejoj	vad'ej'o'j
vadejon	vad'ej'o'n
vaditaj	vad'it'a'j
vadmaraj	vad'mar'a'j
vadmaro	vad'mar'o
vadmaroj	vad'mar'o'j
vadmigrado	vad'migr'ad'o
vadomaro	vad'omar'o
vadpantalono	vad'pantalon'o
vaduzo	vad'uz'o
vafla	vafl'a
vaflo	vafl'o
vafloj	vafl'o'j
vaflojn	vafl'o'j'n
vaflon	vafl'o'n
vafleton	vafl'et'o'n
vaflilon	vafl'il'o'n
vaflita	vafl'it'a
vaflitaj	vafl'it'a'j
vaflobakilon	vafl'o'bak'il'o'n
vaflomanĝado	vafl'o'manĝ'ad'o
vaflostrukturitaj	vafl'o'struktur'it'a'j
vaflofero	vafl'ofer'o
vafloferojn	vafl'ofer'o'j'n
vaga	vag'a
vagaj	vag'a'j
vagan	vag'a'n
vagas	vag'as
vage	vag'e
vagi	vag'i
vagis	vag'is
vago	vag'o
vagoj	vag'o'j
vagos	vag'os
vagu	vag'u
vagus	vag'us
vagaĉas	vag'aĉ'as
vagada	vag'ad'a
vagadan	vag'ad'a'n
vagadas	vag'ad'as
vagadi	vag'ad'i
vagadis	vag'ad'is
vagado	vag'ad'o
vagadoj	vag'ad'o'j
vagadojn	vag'ad'o'j'n
vagadon	vag'ad'o'n
vagados	vag'ad'os
vagadu	vag'ad'u
vagadus	vag'ad'us
vagademo	vag'ad'em'o
vagadia	vag'ad'i'a
vagalbatroso	vag'albatros'o
vagalbatrosoj	vag'albatros'o'j
vaganta	vag'ant'a
vagantaj	vag'ant'a'j
vagantajn	vag'ant'a'j'n
vagantan	vag'ant'a'n
vagante	vag'ant'e
vaganto	vag'ant'o
vagantoj	vag'ant'o'j
vagantojn	vag'ant'o'j'n
vaganton	vag'ant'o'n
vagantecan	vag'ant'ec'a'n
vaganteco	vag'ant'ec'o
vaganttrupoj	vag'ant'trup'o'j
vagbirdo	vag'bird'o
vageco	vag'ec'o
vagecon	vag'ec'o'n
vagema	vag'em'a
vagemaj	vag'em'a'j
vagemo	vag'em'o
vaghundo	vag'hund'o
vagilon	vag'il'o'n
vaginta	vag'int'a
vaginte	vag'int'e
vagisto	vag'ist'o
vagiston	vag'ist'o'n
vaglumo	vag'lum'o
vagobranĉoj	vag'o'branĉ'o'j
vagobranĉojn	vag'o'branĉ'o'j'n
vagolernantoj	vag'o'lern'ant'o'j
vagotomio	vag'o'tom'i'o
vagojaroj	vag'ojar'o'j
vagrigardi	vag'rigard'i
vagulo	vag'ul'o
vaguloj	vag'ul'o'j
vagulon	vag'ul'o'n
vagvendisto	vag'vend'ist'o
vagabonda	vagabond'a
vagabondaj	vagabond'a'j
vagabondas	vagabond'as
vagabondi	vagabond'i
vagabondis	vagabond'is
vagabondo	vagabond'o
vagabondoj	vagabond'o'j
vagabondojn	vagabond'o'j'n
vagabondon	vagabond'o'n
vagabondante	vagabond'ant'e
vagabondeco	vagabond'ec'o
vagina	vagin'a
vaginaj	vagin'a'j
vaginajn	vagin'a'j'n
vaginan	vagin'a'n
vagine	vagin'e
vagino	vagin'o
vaginoj	vagin'o'j
vaginojn	vagin'o'j'n
vaginon	vagin'o'n
vagona	vagon'a
vagonan	vagon'a'n
vagono	vagon'o
vagonoj	vagon'o'j
vagonojn	vagon'o'j'n
vagonon	vagon'o'n
vagonara	vagon'ar'a
vagonare	vagon'ar'e
vagonaro	vagon'ar'o
vagonaroj	vagon'ar'o'j
vagonarojn	vagon'ar'o'j'n
vagonaron	vagon'ar'o'n
vagonarpramo	vagon'ar'pram'o
vagoneto	vagon'et'o
vagonetoj	vagon'et'o'j
vagonetisto	vagon'et'ist'o
vagonradoj	vagon'rad'o'j
vagonŝanĝo	vagon'ŝanĝ'o
vajco	vajc'o
vajcoj	vajc'o'j
vaka	vak'a
vakaj	vak'a'j
vakajn	vak'a'j'n
vakan	vak'a'n
vakas	vak'as
vake	vak'e
vakis	vak'is
vako	vak'o
vakoj	vak'o'j
vakon	vak'o'n
vakanta	vak'ant'a
vakantaj	vak'ant'a'j
vakantajn	vak'ant'a'j'n
vakantan	vak'ant'a'n
vakantaĵo	vak'ant'aĵ'o
vakantaĵoj	vak'ant'aĵ'o'j
vakantaĵojn	vak'ant'aĵ'o'j'n
vakantaĵon	vak'ant'aĵ'o'n
vakanteco	vak'ant'ec'o
vakeco	vak'ec'o
vakejon	vak'ej'o'n
vakigas	vak'ig'as
vakigi	vak'ig'i
vakigis	vak'ig'is
vakigos	vak'ig'os
vakigita	vak'ig'it'a
vakigitaj	vak'ig'it'a'j
vakigitan	vak'ig'it'a'n
vakkapa	vak'kap'a
vakstolaj	vak'stol'a'j
vakstolo	vak'stol'o
vakstolaĵo	vak'stol'aĵ'o
vakajamo	vakajam'o
vakareso	vakares'o
vakcina	vakcin'a
vakcinan	vakcin'a'n
vakcinas	vakcin'as
vakcini	vakcin'i
vakcinis	vakcin'is
vakcino	vakcin'o
vakcinoj	vakcin'o'j
vakcinojn	vakcin'o'j'n
vakcinon	vakcin'o'n
vakcinado	vakcin'ad'o
vakcinadoj	vakcin'ad'o'j
vakcinadojn	vakcin'ad'o'j'n
vakcinadon	vakcin'ad'o'n
vakcinadkampanjo	vakcin'ad'kampanj'o
vakcinadkampanjojn	vakcin'ad'kampanj'o'j'n
vakcinadprogramo	vakcin'ad'program'o
vakcinaĵo	vakcin'aĵ'o
vakcinante	vakcin'ant'e
vakcinata	vakcin'at'a
vakcinataj	vakcin'at'a'j
vakcinigas	vakcin'ig'as
vakcinigi	vakcin'ig'i
vakcinigis	vakcin'ig'is
vakcinigus	vakcin'ig'us
vakciniĝi	vakcin'iĝ'i
vakciniĝis	vakcin'iĝ'is
vakcinita	vakcin'it'a
vakcinitaj	vakcin'it'a'j
vakcinitoj	vakcin'it'o'j
vakcinkandidatoj	vakcin'kandidat'o'j
vakcinorilata	vakcin'o'rilat'a
vakcinorilataj	vakcin'o'rilat'a'j
vakcinio	vakcini'o
vakcinioj	vakcini'o'j
vakciniojn	vakcini'o'j'n
vakera	vaker'a
vakeraj	vaker'a'j
vakerajn	vaker'a'j'n
vakeran	vaker'a'n
vakero	vaker'o
vakeroj	vaker'o'j
vakerojn	vaker'o'j'n
vakeron	vaker'o'n
vakerĉapelo	vaker'ĉapel'o
vakerĉapelon	vaker'ĉapel'o'n
vakerfilmojn	vaker'film'o'j'n
vakerfilmon	vaker'film'o'n
vaksa	vaks'a
vaksaj	vaks'a'j
vaksajn	vaks'a'j'n
vaksan	vaks'a'n
vaksas	vaks'as
vakse	vaks'e
vaksi	vaks'i
vaksis	vaks'is
vakso	vaks'o
vaksoj	vaks'o'j
vaksojn	vaks'o'j'n
vakson	vaks'o'n
vaksos	vaks'os
vaksaĵo	vaks'aĵ'o
vaksaĵoj	vaks'aĵ'o'j
vaksaĵojn	vaks'aĵ'o'j'n
vaksante	vaks'ant'e
vakseca	vaks'ec'a
vaksecaj	vaks'ec'a'j
vaksecan	vaks'ec'a'n
vaksfiguro	vaks'figur'o
vaksfigurojn	vaks'figur'o'j'n
vaksflava	vaks'flav'a
vakshaŭto	vaks'haŭt'o
vaksita	vaks'it'a
vaksitaj	vaks'it'a'j
vakskandelo	vaks'kandel'o
vakskandeloj	vaks'kandel'o'j
vakskandelojn	vaks'kandel'o'j'n
vakskandelon	vaks'kandel'o'n
vaksokandela	vaks'o'kandel'a
vaksootablojdo	vaks'o'o'tablojd'o
vaksotinkturaĵoj	vaks'o'tinktur'aĵ'o'j
vakstabelon	vaks'tabel'o'n
vakstabuloj	vaks'tabul'o'j
vakstabulon	vaks'tabul'o'n
vakua	vaku'a
vakuaj	vaku'a'j
vakuajn	vaku'a'j'n
vakuan	vaku'a'n
vakue	vaku'e
vakuo	vaku'o
vakuoj	vaku'o'j
vakuojn	vaku'o'j'n
vakuon	vaku'o'n
vakuaparatoj	vaku'aparat'o'j
vakueco	vaku'ec'o
vakuenergion	vaku'energi'o'n
vakuiga	vaku'ig'a
vakuodistilado	vaku'o'distil'ad'o
vakuofluktuoj	vaku'o'fluktu'o'j
vakuokamero	vaku'o'kamer'o
vakuokameroj	vaku'o'kamer'o'j
vakuokameron	vaku'o'kamer'o'n
vakuokaptiloj	vaku'o'kapt'il'o'j
vakuokondiĉoj	vaku'o'kondiĉ'o'j
vakuomediaj	vaku'o'medi'a'j
vakuomediajn	vaku'o'medi'a'j'n
vakuomedio	vaku'o'medi'o
vakuonivelo	vaku'o'nivel'o
vakuopipo	vaku'o'pip'o
vakuoringoj	vaku'o'ring'o'j
vakuosako	vaku'o'sak'o
vakuoŝipo	vaku'o'ŝip'o
vakuosistemo	vaku'o'sistem'o
vakuosistemoj	vaku'o'sistem'o'j
vakuoŝtato	vaku'o'ŝtat'o
vakuotanko	vaku'o'tank'o
vakuotankon	vaku'o'tank'o'n
vakuonivelon	vaku'onivel'o'n
vakupumpilo	vaku'pump'il'o
vakupumpiloj	vaku'pump'il'o'j
vakupumpilon	vaku'pump'il'o'n
vakupurigilo	vaku'pur'ig'il'o
vakutuba	vaku'tub'a
vakutubaj	vaku'tub'a'j
vakutubo	vaku'tub'o
vakutuboj	vaku'tub'o'j
vakuolo	vakuol'o
vakuoloj	vakuol'o'j
vakuolojn	vakuol'o'j'n
vakuolon	vakuol'o'n
vala	val'a
valaj	val'a'j
valajn	val'a'j'n
vale	val'e
valen	val'e'n
vali	val'i
valo	val'o
valoj	val'o'j
valojn	val'o'j'n
valon	val'o'n
valaĵo	val'aĵ'o
valbaraĵo	val'bar'aĵ'o
valbaraĵoj	val'bar'aĵ'o'j
valego	val'eg'o
valeto	val'et'o
valetoj	val'et'o'j
valeton	val'et'o'n
valabio	valabi'o
valabioj	valabi'o'j
valadolido	valadolid'o
valaĥia	valaĥi'a
valaĥio	valaĥi'o
valaĥion	valaĥi'o'n
valanginiano	valanginian'o
valara	valar'a
valaro	valar'o
valaroj	valar'o'j
valarojn	valar'o'j'n
valburgo	valburg'o
valdo	vald'o
valdana	vald'an'a
valdanoj	vald'an'o'j
valdemaro	valdemar'o
valdragone	valdragon'e
valencia	valenci'a
valenciaj	valenci'a'j
valenciajn	valenci'a'j'n
valencian	valenci'a'n
valencio	valenci'o
valencion	valenci'o'n
valenciana	valenci'an'a
valenciano	valenci'an'o
valencianoj	valenci'an'o'j
valencilando	valenci'land'o
valenlago	valenlag'o
valenta	valent'a
valentaj	valent'a'j
valentajn	valent'a'j'n
valentan	valent'a'n
valente	valent'e
valento	valent'o
valentoj	valent'o'j
valentojn	valent'o'j'n
valenton	valent'o'n
valentecon	valent'ec'o'n
valentelektronoj	valent'elektron'o'j
valentelektronojn	valent'elektron'o'j'n
valentliga	valent'lig'a
valentligoj	valent'lig'o'j
valentogrupo	valent'o'grup'o
valentogrupoj	valent'o'grup'o'j
valentoliga	valent'o'lig'a
valentoligaj	valent'o'lig'a'j
valentoŝelo	valent'o'ŝel'o
valentena	valenten'a
valenteno	valenten'o
valentenon	valenten'o'n
valentina	valentin'a
valentinan	valentin'a'n
valentine	valentin'e
valentino	valentin'o
valentinanoj	valentin'an'o'j
valentinkarto	valentin'kart'o
valentiniano	valentinian'o
valenurbo	valenurb'o
valera	valer'a
valerata	valer'at'a
valerato	valer'at'o
valeria	valeri'a
valerio	valeri'o
valida	valid'a
validaj	valid'a'j
validajn	valid'a'j'n
validan	valid'a'n
validas	valid'as
valide	valid'e
validi	valid'i
validis	valid'is
valido	valid'o
validon	valid'o'n
validos	valid'os
validu	valid'u
validus	valid'us
validante	valid'ant'e
valideco	valid'ec'o
validecon	valid'ec'o'n
validigi	valid'ig'i
validigis	valid'ig'is
validigo	valid'ig'o
validumado	valid'um'ad'o
validumadon	valid'um'ad'o'n
valizo	valiz'o
valizoj	valiz'o'j
valizojn	valiz'o'j'n
valizon	valiz'o'n
valizeton	valiz'et'o'n
valmikio	valmiki'o
valona	valon'a
valonaj	valon'a'j
valonoj	valon'o'j
valonio	valon'i'o
valora	valor'a
valoraj	valor'a'j
valorajn	valor'a'j'n
valoran	valor'a'n
valoras	valor'as
valore	valor'e
valori	valor'i
valoris	valor'is
valoro	valor'o
valoroj	valor'o'j
valorojn	valor'o'j'n
valoron	valor'o'n
valoros	valor'os
valorus	valor'us
valoraĵo	valor'aĵ'o
valoraĵoj	valor'aĵ'o'j
valoraĵojn	valor'aĵ'o'j'n
valoraĵon	valor'aĵ'o'n
valorĉeno	valor'ĉen'o
valorega	valor'eg'a
valoregaj	valor'eg'a'j
valoregajn	valor'eg'a'j'n
valoregan	valor'eg'a'n
valorigas	valor'ig'as
valorigi	valor'ig'i
valorigo	valor'ig'o
valorjuĝoj	valor'juĝ'o'j
valormetalo	valor'metal'o
valormetaloj	valor'metal'o'j
valorpapera	valor'paper'a
valorpaperoj	valor'paper'o'j
valorpaperojn	valor'paper'o'j'n
valorsistemo	valor'sistem'o
valortakso	valor'taks'o
valortakson	valor'taks'o'n
valorizo	valoriz'o
valso	vals'o
valson	vals'o'n
valsita	vals'it'a
valuta	valut'a
valutaj	valut'a'j
valuto	valut'o
valutoj	valut'o'j
valutojn	valut'o'j'n
valuton	valut'o'n
valve	valv'e
valvo	valv'o
valvoj	valv'o'j
valvojn	valv'o'j'n
valvon	valv'o'n
vampiro	vampir'o
vampiroj	vampir'o'j
vana	van'a
vanaj	van'a'j
vanajn	van'a'j'n
vanan	van'a'n
vanas	van'as
vane	van'e
vanis	van'is
vanado	van'ad'o
vaneco	van'ec'o
vanecon	van'ec'o'n
vanigis	van'ig'is
vanado	vanad'o
vanda	vand'a
vando	vand'o
vandoj	vand'o'j
vandojn	vand'o'j'n
vandon	vand'o'n
vandalo	vandal'o
vandaloj	vandal'o'j
vandalaĵoj	vandal'aĵ'o'j
vandaligita	vandal'ig'it'a
vandalismo	vandal'ism'o
vandalismon	vandal'ism'o'n
vanga	vang'a
vango	vang'o
vangoj	vang'o'j
vangojn	vang'o'j'n
vangon	vang'o'n
vangharoj	vang'har'o'j
vangofrapas	vang'o'frap'as
vangofrapis	vang'o'frap'is
vangofrapo	vang'o'frap'o
vangofrapon	vang'o'frap'o'n
vangostoj	vang'ost'o'j
vanila	vanil'a
vanilan	vanil'a'n
vanilo	vanil'o
vanilino	vanilin'o
vankuvera	vankuver'a
vankuvero	vankuver'o
vanta	vant'a
vantaj	vant'a'j
vantajn	vant'a'j'n
vantan	vant'a'n
vantas	vant'as
vante	vant'e
vanto	vant'o
vantaĵo	vant'aĵ'o
vantaĵoj	vant'aĵ'o'j
vanteco	vant'ec'o
vantecon	vant'ec'o'n
vantemo	vant'em'o
vanuis	vanu'is
vanuatuo	vanuatu'o
vapora	vapor'a
vaporaj	vapor'a'j
vaporas	vapor'as
vapori	vapor'i
vaporis	vapor'is
vaporo	vapor'o
vaporoj	vapor'o'j
vaporojn	vapor'o'j'n
vaporon	vapor'o'n
vaporado	vapor'ad'o
vaporanta	vapor'ant'a
vapordemetado	vapor'de'met'ad'o
vaporforto	vapor'fort'o
vaporigas	vapor'ig'as
vaporigi	vapor'ig'i
vaporigo	vapor'ig'o
vaporigilo	vapor'ig'il'o
vaporigita	vapor'ig'it'a
vaporigitaj	vapor'ig'it'a'j
vaporiĝas	vapor'iĝ'as
vaporiĝi	vapor'iĝ'i
vaporiĝis	vapor'iĝ'is
vaporiĝo	vapor'iĝ'o
vaporiĝon	vapor'iĝ'o'n
vaporiĝema	vapor'iĝ'em'a
vaporiĝemaj	vapor'iĝ'em'a'j
vaporita	vapor'it'a
vaporitaj	vapor'it'a'j
vaporkaldrono	vapor'kaldron'o
vaporkaldronoj	vapor'kaldron'o'j
vaporlokomotivo	vapor'lokomotiv'o
vaporlokomotivoj	vapor'lokomotiv'o'j
vapormaŝino	vapor'maŝin'o
vapormaŝinoj	vapor'maŝin'o'j
vaporpremo	vapor'prem'o
vaporpremon	vapor'prem'o'n
vaporŝipo	vapor'ŝip'o
vaporŝipoj	vapor'ŝip'o'j
vaporŝipon	vapor'ŝip'o'n
vaporturbino	vapor'turbin'o
vaporturbinoj	vapor'turbin'o'j
vaporumas	vapor'um'as
vaporumita	vapor'um'it'a
vara	var'a
varo	var'o
varoj	var'o'j
varojn	var'o'j'n
varon	var'o'n
varmarko	var'mark'o
varmarkoj	var'mark'o'j
varmarkon	var'mark'o'n
varmarkita	var'mark'it'a
varomarko	var'o'mark'o
varprezoj	var'prez'o'j
varano	varan'o
varanasio	varanasi'o
varba	varb'a
varbaj	varb'a'j
varbajn	varb'a'j'n
varban	varb'a'n
varbas	varb'as
varbi	varb'i
varbis	varb'is
varbo	varb'o
varbu	varb'u
varbado	varb'ad'o
varbadon	varb'ad'o'n
varbante	varb'ant'e
varbilo	varb'il'o
varbiloj	varb'il'o'j
varbistoj	varb'ist'o'j
varbita	varb'it'a
varbitaj	varb'it'a'j
varbitoj	varb'it'o'j
varfo	varf'o
varfon	varf'o'n
varia	vari'a
variaj	vari'a'j
variajn	vari'a'j'n
varian	vari'a'n
varias	vari'as
varie	vari'e
varii	vari'i
variis	vari'is
vario	vari'o
varioj	vari'o'j
variojn	vari'o'j'n
varion	vari'o'n
varios	vari'os
varius	vari'us
variadas	vari'ad'as
variadi	vari'ad'i
variadis	vari'ad'is
variado	vari'ad'o
variadoj	vari'ad'o'j
variadojn	vari'ad'o'j'n
variadon	vari'ad'o'n
variaĵo	vari'aĵ'o
variaĵoj	vari'aĵ'o'j
variaĵojn	vari'aĵ'o'j'n
variaĵon	vari'aĵ'o'n
varieco	vari'ec'o
variecon	vari'ec'o'n
variema	vari'em'a
variigas	vari'ig'as
variigi	vari'ig'i
variigis	vari'ig'is
variigado	vari'ig'ad'o
variigante	vari'ig'ant'e
variigita	vari'ig'it'a
variigitaj	vari'ig'it'a'j
variablo	variabl'o
variabloj	variabl'o'j
variablojn	variabl'o'j'n
variablon	variabl'o'n
varianco	varianc'o
variancoj	varianc'o'j
variancon	varianc'o'n
varianta	variant'a
variantaj	variant'a'j
variantajn	variant'a'j'n
variante	variant'e
varianto	variant'o
variantoj	variant'o'j
variantojn	variant'o'j'n
varianton	variant'o'n
varicelo	varicel'o
varieteo	variete'o
variolo	variol'o
variolon	variol'o'n
varleto	varlet'o
varma	varm'a
varmaj	varm'a'j
varmajn	varm'a'j'n
varman	varm'a'n
varmas	varm'as
varme	varm'e
varmis	varm'is
varmo	varm'o
varmoj	varm'o'j
varmon	varm'o'n
varmos	varm'os
varmaerbalonoj	varm'aer'balon'o'j
varmakva	varm'akv'a
varmeca	varm'ec'a
varmeco	varm'ec'o
varmecon	varm'ec'o'n
varmeckapacito	varm'ec'kapacit'o
varmeclavujo	varm'ec'lav'uj'o
varmecotraktado	varm'ec'o'trakt'ad'o
varmega	varm'eg'a
varmegaj	varm'eg'a'j
varmegajn	varm'eg'a'j'n
varmegan	varm'eg'a'n
varmegas	varm'eg'as
varmege	varm'eg'e
varmegis	varm'eg'is
varmego	varm'eg'o
varmegon	varm'eg'o'n
varmenergio	varm'energi'o
varmenergion	varm'energi'o'n
varmeta	varm'et'a
varmetaj	varm'et'a'j
varmetan	varm'et'a'n
varmete	varm'et'e
varmiga	varm'ig'a
varmigaj	varm'ig'a'j
varmigan	varm'ig'a'n
varmigas	varm'ig'as
varmigi	varm'ig'i
varmigis	varm'ig'is
varmigo	varm'ig'o
varmigos	varm'ig'os
varmigu	varm'ig'u
varmigado	varm'ig'ad'o
varmiganta	varm'ig'ant'a
varmigante	varm'ig'ant'e
varmigata	varm'ig'at'a
varmigataj	varm'ig'at'a'j
varmigilo	varm'ig'il'o
varmigita	varm'ig'it'a
varmigitaj	varm'ig'it'a'j
varmigitan	varm'ig'it'a'n
varmigite	varm'ig'it'e
varmiĝas	varm'iĝ'as
varmiĝi	varm'iĝ'i
varmiĝis	varm'iĝ'is
varmiĝo	varm'iĝ'o
varmiĝon	varm'iĝ'o'n
varmiĝos	varm'iĝ'os
varmkora	varm'kor'a
varmofluo	varm'o'flu'o
varmofluon	varm'o'flu'o'n
varmofonto	varm'o'font'o
varmointerŝanĝilo	varm'o'inter'ŝanĝ'il'o
varmointerŝanĝiloj	varm'o'inter'ŝanĝ'il'o'j
varmointerŝanĝilon	varm'o'inter'ŝanĝ'il'o'n
varmokondukteco	varm'o'kondukt'ec'o
varmokonduktecon	varm'o'kondukt'ec'o'n
varmoperdo	varm'o'perd'o
varmoperdon	varm'o'perd'o'n
varmoproduktado	varm'o'produkt'ad'o
varmopumpilo	varm'o'pump'il'o
varmopumpiloj	varm'o'pump'il'o'j
varmotransigo	varm'o'trans'ig'o
varmotransigon	varm'o'trans'ig'o'n
varmondoj	varm'ond'o'j
varmsangaj	varm'sang'a'j
varpo	varp'o
varpoj	varp'o'j
varsovia	varsovi'a
varsoviaj	varsovi'a'j
varsovian	varsovi'a'n
varsovio	varsovi'o
varsovion	varsovi'o'n
varsovianoj	varsovi'an'o'j
vartas	vart'as
varti	vart'i
vartis	vart'is
vartos	vart'os
vartu	vart'u
vartado	vart'ad'o
vartadon	vart'ad'o'n
vartejo	vart'ej'o
vartisto	vart'ist'o
vartistino	vart'ist'in'o
vartistinoj	vart'ist'in'o'j
vartistinon	vart'ist'in'o'n
vasalo	vasal'o
vasaloj	vasal'o'j
vasalojn	vasal'o'j'n
vasaleco	vasal'ec'o
vaŝintono	vaŝinton'o
vaska	vask'a
vaskaj	vask'a'j
vasko	vask'o
vaskula	vaskul'a
vaskulaj	vaskul'a'j
vaskulo	vaskul'o
vaskuloj	vaskul'o'j
vaskulojn	vaskul'o'j'n
vasta	vast'a
vastaj	vast'a'j
vastajn	vast'a'j'n
vastan	vast'a'n
vastas	vast'as
vaste	vast'e
vasto	vast'o
vastaĵo	vast'aĵ'o
vastaĵoj	vast'aĵ'o'j
vastaĵon	vast'aĵ'o'n
vasteco	vast'ec'o
vastecon	vast'ec'o'n
vastega	vast'eg'a
vastegaj	vast'eg'a'j
vastegan	vast'eg'a'n
vastiga	vast'ig'a
vastigaj	vast'ig'a'j
vastigas	vast'ig'as
vastigi	vast'ig'i
vastigis	vast'ig'is
vastigo	vast'ig'o
vastigon	vast'ig'o'n
vastigos	vast'ig'os
vastigu	vast'ig'u
vastigado	vast'ig'ad'o
vastigaĵo	vast'ig'aĵ'o
vastiganta	vast'ig'ant'a
vastigante	vast'ig'ant'e
vastigita	vast'ig'it'a
vastigitaj	vast'ig'it'a'j
vastigitan	vast'ig'it'a'n
vastigite	vast'ig'it'e
vastiĝas	vast'iĝ'as
vastiĝis	vast'iĝ'is
vastiĝo	vast'iĝ'o
vastiĝoj	vast'iĝ'o'j
vastiĝon	vast'iĝ'o'n
vastiĝos	vast'iĝ'os
vastiĝanta	vast'iĝ'ant'a
vata	vat'a
vato	vat'o
vatoj	vat'o'j
vaton	vat'o'n
vatita	vat'it'a
vatitaj	vat'it'a'j
vatitan	vat'it'a'n
vatikana	vatikan'a
vatikanaj	vatikan'a'j
vatikanan	vatikan'a'n
vatikano	vatikan'o
vatikanon	vatikan'o'n
vatikanurbo	vatikan'urb'o
vazo	vaz'o
vazoj	vaz'o'j
vazojn	vaz'o'j'n
vazon	vaz'o'n
vazaro	vaz'ar'o
vazaron	vaz'ar'o'n
vazlavilo	vaz'lav'il'o
vazlaviloj	vaz'lav'il'o'j
ve	ve
vea	ve'a
veas	ve'as
vee	ve'e
vei	ve'i
veis	ve'is
veo	ve'o
veoj	ve'o'j
veado	ve'ad'o
veante	ve'ant'e
vekriado	ve'kri'ad'o
vespiris	ve'spir'is
vebero	veber'o
veda	ved'a
vedaj	ved'a'j
vedajn	ved'a'j'n
vedan	ved'a'n
vedoj	ved'o'j
vedanto	vedant'o
vefto	veft'o
veftoj	veft'o'j
vegana	vegan'a
veganaj	vegan'a'j
vegano	vegan'o
veganoj	vegan'o'j
veganismo	vegan'ism'o
veganistoj	vegan'ist'o'j
vegeta	veget'a
vegetas	veget'as
vegeti	veget'i
vegetado	veget'ad'o
vegetaĵa	veget'aĵ'a
vegetaĵaj	veget'aĵ'a'j
vegetaĵo	veget'aĵ'o
vegetaĵoj	veget'aĵ'o'j
vegetaĵojn	veget'aĵ'o'j'n
vegetaĵaraj	veget'aĵ'ar'a'j
vegetaĵaro	veget'aĵ'ar'o
vegetaĵaron	veget'aĵ'ar'o'n
vegetala	vegetal'a
vegetalaj	vegetal'a'j
vegetalajn	vegetal'a'j'n
vegetalan	vegetal'a'n
vegetalo	vegetal'o
vegetaloj	vegetal'o'j
vegetalojn	vegetal'o'j'n
vegetalaro	vegetal'ar'o
vegetara	vegetar'a
vegetaraj	vegetar'a'j
vegetarajn	vegetar'a'j'n
vegetaran	vegetar'a'n
vegetarana	vegetar'an'a
vegetarano	vegetar'an'o
vegetaranoj	vegetar'an'o'j
vegetaranojn	vegetar'an'o'j'n
vegetarismo	vegetar'ism'o
vegetarismon	vegetar'ism'o'n
vejna	vejn'a
vejnaj	vejn'a'j
vejnan	vejn'a'n
vejno	vejn'o
vejnoj	vejn'o'j
vejnojn	vejn'o'j'n
vejnon	vejn'o'n
vejnetoj	vejn'et'o'j
vejnpordetoj	vejn'pord'et'o'j
veka	vek'a
vekaj	vek'a'j
vekas	vek'as
veki	vek'i
vekis	vek'is
veko	vek'o
vekos	vek'os
veku	vek'u
vekus	vek'us
vekado	vek'ad'o
vekanta	vek'ant'a
vekante	vek'ant'e
vekhorloĝo	vek'horloĝ'o
vekhorloĝon	vek'horloĝ'o'n
vekigi	vek'ig'i
vekigis	vek'ig'is
vekiĝas	vek'iĝ'as
vekiĝi	vek'iĝ'i
vekiĝis	vek'iĝ'is
vekiĝo	vek'iĝ'o
vekiĝon	vek'iĝ'o'n
vekiĝos	vek'iĝ'os
vekiĝu	vek'iĝ'u
vekiĝus	vek'iĝ'us
vekiĝanta	vek'iĝ'ant'a
vekiĝante	vek'iĝ'ant'e
vekiĝinta	vek'iĝ'int'a
vekiĝinte	vek'iĝ'int'e
vekilo	vek'il'o
vekita	vek'it'a
vekitaj	vek'it'a'j
veksignalo	vek'signal'o
vekto	vekt'o
vektora	vektor'a
vektoraj	vektor'a'j
vektoran	vektor'a'n
vektoro	vektor'o
vektoroj	vektor'o'j
vektorojn	vektor'o'j'n
vektoron	vektor'o'n
vela	vel'a
velas	vel'as
veli	vel'i
velis	vel'is
velo	vel'o
veloj	vel'o'j
velojn	vel'o'j'n
velon	vel'o'n
velado	vel'ad'o
velara	vel'ar'a
velaraj	vel'ar'a'j
velaro	vel'ar'o
velaroj	vel'ar'o'j
velboato	vel'boat'o
velboatoj	vel'boat'o'j
velisto	vel'ist'o
velŝipo	vel'ŝip'o
velŝipoj	vel'ŝip'o'j
velstango	vel'stang'o
velda	veld'a
veldas	veld'as
veldi	veld'i
veldis	veld'is
veldo	veld'o
veldado	veld'ad'o
veldisto	veld'ist'o
veldistoj	veld'ist'o'j
veldita	veld'it'a
velditaj	veld'it'a'j
velka	velk'a
velkaj	velk'a'j
velkas	velk'as
velke	velk'e
velki	velk'i
velkis	velk'is
velko	velk'o
velkos	velk'os
velkanta	velk'ant'a
velkinta	velk'int'a
velkintaj	velk'int'a'j
velura	velur'a
veluraj	velur'a'j
veluran	velur'a'n
veluro	velur'o
vena	ven'a
venas	ven'as
veni	ven'i
venis	ven'is
veno	ven'o
venon	ven'o'n
venos	ven'os
venu	ven'u
venadas	ven'ad'as
venadi	ven'ad'i
venadis	ven'ad'is
venado	ven'ad'o
venanta	ven'ant'a
venantaj	ven'ant'a'j
venantajn	ven'ant'a'j'n
venantan	ven'ant'a'n
venante	ven'ant'e
venigas	ven'ig'as
venigi	ven'ig'i
venigis	ven'ig'is
venigos	ven'ig'os
venigu	ven'ig'u
venigus	ven'ig'us
venigita	ven'ig'it'a
veninta	ven'int'a
venintaj	ven'int'a'j
venintajn	ven'int'a'j'n
venintan	ven'int'a'n
veninte	ven'int'e
veninto	ven'int'o
venintoj	ven'int'o'j
venintojn	ven'int'o'j'n
venintus	ven'int'us
venita	ven'it'a
venitaj	ven'it'a'j
venite	ven'it'e
venonta	ven'ont'a
venontaj	ven'ont'a'j
venontajn	ven'ont'a'j'n
venontan	ven'ont'a'n
venonte	ven'ont'e
venontajare	ven'ont'a'jar'e
venontece	ven'ont'ec'e
venonteco	ven'ont'ec'o
venontfoje	ven'ont'foj'e
venontgeneracia	ven'ont'generaci'a
venontjara	ven'ont'jar'a
venontjaraj	ven'ont'jar'a'j
venontjaran	ven'ont'jar'a'n
venontjare	ven'ont'jar'e
venontmonate	ven'ont'monat'e
venontsemajne	ven'ont'semajn'e
venontsomere	ven'ont'somer'e
venda	vend'a
vendas	vend'as
vendi	vend'i
vendis	vend'is
vendo	vend'o
vendoj	vend'o'j
vendojn	vend'o'j'n
vendon	vend'o'n
vendos	vend'os
vendu	vend'u
vendus	vend'us
vendadis	vend'ad'is
vendado	vend'ad'o
vendadon	vend'ad'o'n
vendanta	vend'ant'a
vendantaj	vend'ant'a'j
vendante	vend'ant'e
vendanto	vend'ant'o
vendantoj	vend'ant'o'j
vendata	vend'at'a
vendataj	vend'at'a'j
vendatas	vend'at'as
vendebla	vend'ebl'a
vendeblaj	vend'ebl'a'j
vendeblajn	vend'ebl'a'j'n
vendeblas	vend'ebl'as
vendeja	vend'ej'a
vendejaj	vend'ej'a'j
vendejo	vend'ej'o
vendejoj	vend'ej'o'j
vendejojn	vend'ej'o'j'n
vendejon	vend'ej'o'n
vendejaro	vend'ej'ar'o
vendejego	vend'ej'eg'o
vendiĝas	vend'iĝ'as
vendiĝi	vend'iĝ'i
vendiĝis	vend'iĝ'is
vendiĝos	vend'iĝ'os
vendiloj	vend'il'o'j
vendinta	vend'int'a
vendinte	vend'int'e
vendisto	vend'ist'o
vendistoj	vend'ist'o'j
vendistojn	vend'ist'o'j'n
vendiston	vend'ist'o'n
vendistino	vend'ist'in'o
vendistinoj	vend'ist'in'o'j
vendistinon	vend'ist'in'o'n
vendita	vend'it'a
venditaj	vend'it'a'j
venditajn	vend'it'a'j'n
vendite	vend'it'e
vendoplaco	vend'o'plac'o
vendoprezo	vend'o'prez'o
vendotablo	vend'o'tabl'o
vendotablon	vend'o'tabl'o'n
vendota	vend'ot'a
vendotaj	vend'ot'a'j
vendreda	vendred'a
vendredan	vendred'a'n
vendrede	vendred'e
vendredo	vendred'o
vendredoj	vendred'o'j
vendredon	vendred'o'n
venecia	veneci'a
veneciaj	veneci'a'j
venecian	veneci'a'n
venecio	veneci'o
venecion	veneci'o'n
veneciano	veneci'an'o
venecianoj	veneci'an'o'j
venena	venen'a
venenaj	venen'a'j
venenajn	venen'a'j'n
venenan	venen'a'n
venenas	venen'as
veneni	venen'i
venenis	venen'is
veneno	venen'o
venenoj	venen'o'j
venenojn	venen'o'j'n
venenon	venen'o'n
venenos	venen'os
venenado	venen'ad'o
veneneco	venen'ec'o
venenigas	venen'ig'as
venenigi	venen'ig'i
venenigis	venen'ig'is
venenigo	venen'ig'o
venenigita	venen'ig'it'a
venenigitan	venen'ig'it'a'n
veneniĝo	venen'iĝ'o
veneniĝon	venen'iĝ'o'n
venenita	venen'it'a
venenitaj	venen'it'a'j
venera	vener'a
venero	vener'o
venereaj	venere'a'j
veneto	venet'o
venezuela	venezuel'a
venezuelaj	venezuel'a'j
venezuelo	venezuel'o
venezuelon	venezuel'o'n
venezuelanoj	venezuel'an'o'j
venĝa	venĝ'a
venĝaj	venĝ'a'j
venĝas	venĝ'as
venĝe	venĝ'e
venĝi	venĝ'i
venĝis	venĝ'is
venĝo	venĝ'o
venĝoj	venĝ'o'j
venĝon	venĝ'o'n
venĝos	venĝ'os
venĝu	venĝ'u
venĝantoj	venĝ'ant'o'j
venĝema	venĝ'em'a
venĝeme	venĝ'em'e
venĝemo	venĝ'em'o
venĝemon	venĝ'em'o'n
venka	venk'a
venkaj	venk'a'j
venkajn	venk'a'j'n
venkan	venk'a'n
venkas	venk'as
venke	venk'e
venki	venk'i
venkis	venk'is
venko	venk'o
venkoj	venk'o'j
venkojn	venk'o'j'n
venkon	venk'o'n
venkos	venk'os
venku	venk'u
venkus	venk'us
venkado	venk'ad'o
venkanta	venk'ant'a
venkantaj	venk'ant'a'j
venkante	venk'ant'e
venkanto	venk'ant'o
venkantoj	venk'ant'o'j
venkata	venk'at'a
venkebla	venk'ebl'a
venkigi	venk'ig'i
venkiĝas	venk'iĝ'as
venkiĝis	venk'iĝ'is
venkinta	venk'int'a
venkintaj	venk'int'a'j
venkinte	venk'int'e
venkinto	venk'int'o
venkintoj	venk'int'o'j
venkintojn	venk'int'o'j'n
venkinton	venk'int'o'n
venkita	venk'it'a
venkitaj	venk'it'a'j
venkitajn	venk'it'a'j'n
venkitan	venk'it'a'n
venkite	venk'it'e
venkito	venk'it'o
venkitoj	venk'it'o'j
venta	vent'a
ventaj	vent'a'j
ventan	vent'a'n
ventas	vent'as
vente	vent'e
ventis	vent'is
vento	vent'o
ventoj	vent'o'j
ventojn	vent'o'j'n
venton	vent'o'n
ventbatoj	vent'bat'o'j
ventega	vent'eg'a
ventego	vent'eg'o
ventegoj	vent'eg'o'j
ventegon	vent'eg'o'n
venteto	vent'et'o
venteton	vent'et'o'n
ventflanko	vent'flank'o
ventkondiĉoj	vent'kondiĉ'o'j
ventoblovo	vent'o'blov'o
ventodirekto	vent'o'direkt'o
ventoenergio	vent'o'energi'o
ventoenergion	vent'o'energi'o'n
ventomuelejo	vent'o'muel'ej'o
ventomuelejoj	vent'o'muel'ej'o'j
ventoturbinoj	vent'o'turbin'o'j
ventoturbinaro	vent'o'turbin'ar'o
ventoturbinaroj	vent'o'turbin'ar'o'j
ventrapideco	vent'rapid'ec'o
ventrapidecoj	vent'rapid'ec'o'j
ventumis	vent'um'is
ventumilo	vent'um'il'o
ventumiloj	vent'um'il'o'j
ventumilojn	vent'um'il'o'j'n
ventumilon	vent'um'il'o'n
ventoli	ventol'i
ventolado	ventol'ad'o
ventoladon	ventol'ad'o'n
ventolilo	ventol'il'o
ventolilon	ventol'il'o'n
ventra	ventr'a
ventraj	ventr'a'j
ventran	ventr'a'n
ventre	ventr'e
ventro	ventr'o
ventroj	ventr'o'j
ventron	ventr'o'n
ventrodoloron	ventr'o'dolor'o'n
ventromuskoloj	ventr'o'muskol'o'j
ventroparolisto	ventr'o'parol'ist'o
ventrikla	ventrikl'a
ventriklo	ventrikl'o
ventrikloj	ventrikl'o'j
venusa	venus'a
venuso	venus'o
venuson	venus'o'n
venusrenkonta	venus'renkont'a
vepro	vepr'o
veproj	vepr'o'j
veprejo	vepr'ej'o
veprejoj	vepr'ej'o'j
vera	ver'a
veraj	ver'a'j
verajn	ver'a'j'n
veran	ver'a'n
veras	ver'as
vere	ver'e
veris	ver'is
vero	ver'o
veroj	ver'o'j
verojn	ver'o'j'n
veron	ver'o'n
veraĵo	ver'aĵ'o
veraĵoj	ver'aĵ'o'j
veraĵojn	ver'aĵ'o'j'n
veraĵon	ver'aĵ'o'n
verama	ver'am'a
verdira	ver'dir'a
verdire	ver'dir'e
vereco	ver'ec'o
verecoj	ver'ec'o'j
verecon	ver'ec'o'n
verema	ver'em'a
veremaj	ver'em'a'j
veremo	ver'em'o
verigi	ver'ig'i
vernoma	ver'nom'a
verŝajna	ver'ŝajn'a
verŝajnaj	ver'ŝajn'a'j
verŝajnajn	ver'ŝajn'a'j'n
verŝajnan	ver'ŝajn'a'n
verŝajnas	ver'ŝajn'as
verŝajne	ver'ŝajn'e
verŝajno	ver'ŝajn'o
verŝajneca	ver'ŝajn'ec'a
verŝajneco	ver'ŝajn'ec'o
verŝajnecoj	ver'ŝajn'ec'o'j
verŝajnecojn	ver'ŝajn'ec'o'j'n
verŝajnecon	ver'ŝajn'ec'o'n
versimila	ver'simil'a
versimilaj	ver'simil'a'j
versimilajn	ver'simil'a'j'n
versimile	ver'simil'e
verando	verand'o
verandoj	verand'o'j
verandon	verand'o'n
verba	verb'a
verbaj	verb'a'j
verbajn	verb'a'j'n
verban	verb'a'n
verbe	verb'e
verbo	verb'o
verboj	verb'o'j
verbojn	verb'o'j'n
verbon	verb'o'n
verbformo	verb'form'o
verbformoj	verb'form'o'j
verbigi	verb'ig'i
verboformo	verb'o'form'o
verboformoj	verb'o'form'o'j
verboformojn	verb'o'form'o'j'n
verboformon	verb'o'form'o'n
verbofrazo	verb'o'fraz'o
verbofrazoj	verb'o'fraz'o'j
verbradikoj	verb'radik'o'j
verbtigo	verb'tig'o
verda	verd'a
verdaj	verd'a'j
verdajn	verd'a'j'n
verdan	verd'a'n
verdas	verd'as
verde	verd'e
verdi	verd'i
verdis	verd'is
verdo	verd'o
verdoj	verd'o'j
verdon	verd'o'n
verdaĵo	verd'aĵ'o
verdaĵoj	verd'aĵ'o'j
verdaĵojn	verd'aĵ'o'j'n
verdaĵon	verd'aĵ'o'n
verdanoj	verd'an'o'j
verdeca	verd'ec'a
verdecaj	verd'ec'a'j
verdecajn	verd'ec'a'j'n
verdece	verd'ec'e
verdeco	verd'ec'o
verdejo	verd'ej'o
verdejoj	verd'ej'o'j
verdeskaj	verd'esk'a'j
verdeta	verd'et'a
verdetaj	verd'et'a'j
verdetan	verd'et'a'n
verdglacioj	verd'glaci'o'j
verdglaciojn	verd'glaci'o'j'n
verdigi	verd'ig'i
verdigo	verd'ig'o
verdiĝas	verd'iĝ'as
verdiĝis	verd'iĝ'is
verdkolora	verd'kolor'a
verdstelanoj	verd'stel'an'o'j
verdula	verd'ul'a
verdulo	verd'ul'o
verduloj	verd'ul'o'j
verdiktas	verdikt'as
verdikti	verdikt'i
verdiktis	verdikt'is
verdikto	verdikt'o
verdiktoj	verdikt'o'j
verdiktojn	verdikt'o'j'n
verdikton	verdikt'o'n
verdiktos	verdikt'os
verduno	verdun'o
vergo	verg'o
vergoj	verg'o'j
vergojn	verg'o'j'n
vergon	verg'o'n
vergara	verg'ar'a
vergeto	verg'et'o
vergilio	vergili'o
verka	verk'a
verkas	verk'as
verke	verk'e
verki	verk'i
verkis	verk'is
verko	verk'o
verkoj	verk'o'j
verkojn	verk'o'j'n
verkon	verk'o'n
verkos	verk'os
verku	verk'u
verkus	verk'us
verkadis	verk'ad'is
verkado	verk'ad'o
verkadoj	verk'ad'o'j
verkadon	verk'ad'o'n
verkaĵo	verk'aĵ'o
verkaĵoj	verk'aĵ'o'j
verkaĵojn	verk'aĵ'o'j'n
verkaĵon	verk'aĵ'o'n
verkanta	verk'ant'a
verkante	verk'ant'e
verkanto	verk'ant'o
verkantoj	verk'ant'o'j
verkaro	verk'ar'o
verkaron	verk'ar'o'n
verkata	verk'at'a
verkataj	verk'at'a'j
verketo	verk'et'o
verketoj	verk'et'o'j
verketojn	verk'et'o'j'n
verketon	verk'et'o'n
verkiĝis	verk'iĝ'is
verkinta	verk'int'a
verkinte	verk'int'e
verkinto	verk'int'o
verkintoj	verk'int'o'j
verkintojn	verk'int'o'j'n
verkinton	verk'int'o'n
verkista	verk'ist'a
verkistan	verk'ist'a'n
verkisto	verk'ist'o
verkistoj	verk'ist'o'j
verkistojn	verk'ist'o'j'n
verkiston	verk'ist'o'n
verkistino	verk'ist'in'o
verkistinoj	verk'ist'in'o'j
verkita	verk'it'a
verkitaj	verk'it'a'j
verkitajn	verk'it'a'j'n
verkitan	verk'it'a'n
vermo	verm'o
vermoj	verm'o'j
vermojn	verm'o'j'n
vermon	verm'o'n
vermtruo	verm'tru'o
vermiĉelo	vermiĉel'o
vermiĉeloj	vermiĉel'o'j
vermiĉelojn	vermiĉel'o'j'n
vermlando	vermland'o
vermonto	vermont'o
verniso	vernis'o
vernisoj	vernis'o'j
verona	veron'a
verono	veron'o
veronika	veronik'a
veroniko	veronik'o
versa	vers'a
versaj	vers'a'j
versas	vers'as
verse	vers'e
versi	vers'i
versis	vers'is
verso	vers'o
versoj	vers'o'j
versojn	vers'o'j'n
verson	vers'o'n
versaĵo	vers'aĵ'o
versaĵoj	vers'aĵ'o'j
versaĵojn	vers'aĵ'o'j'n
versaĵon	vers'aĵ'o'n
versfarado	vers'far'ad'o
versparo	vers'par'o
verŝas	verŝ'as
verŝi	verŝ'i
verŝis	verŝ'is
verŝos	verŝ'os
verŝu	verŝ'u
verŝado	verŝ'ad'o
verŝante	verŝ'ant'e
verŝata	verŝ'at'a
verŝiĝas	verŝ'iĝ'as
verŝiĝis	verŝ'iĝ'is
verŝita	verŝ'it'a
verŝitaj	verŝ'it'a'j
verŝitan	verŝ'it'a'n
verŝotablo	verŝ'o'tabl'o
versajlo	versajl'o
versio	versi'o
versioj	versi'o'j
versiojn	versi'o'j'n
version	versi'o'n
verstoj	verst'o'j
verto	vert'o
verton	vert'o'n
vertoĉapo	vert'o'ĉap'o
vertebra	vertebr'a
vertebro	vertebr'o
vertebroj	vertebr'o'j
vertebrojn	vertebr'o'j'n
vertebraro	vertebr'ar'o
vertebrulo	vertebr'ul'o
vertebruloj	vertebr'ul'o'j
vertebrulojn	vertebr'ul'o'j'n
vertica	vertic'a
vertico	vertic'o
verticoj	vertic'o'j
verticojn	vertic'o'j'n
verticon	vertic'o'n
verticilo	verticil'o
vertiĝo	vertiĝ'o
vertiĝojn	vertiĝ'o'j'n
vertiĝon	vertiĝ'o'n
vertikala	vertikal'a
vertikalaj	vertikal'a'j
vertikalajn	vertikal'a'j'n
vertikalan	vertikal'a'n
vertikale	vertikal'e
vertikalo	vertikal'o
vertikalon	vertikal'o'n
verukoj	veruk'o'j
verva	verv'a
vervaj	verv'a'j
vervan	verv'a'n
verve	verv'e
vervo	verv'o
vervon	verv'o'n
vespo	vesp'o
vespoj	vesp'o'j
vespojn	vesp'o'j'n
vespera	vesper'a
vesperaj	vesper'a'j
vesperajn	vesper'a'j'n
vesperan	vesper'a'n
vesperas	vesper'as
vespere	vesper'e
vespero	vesper'o
vesperoj	vesper'o'j
vesperojn	vesper'o'j'n
vesperon	vesper'o'n
vesperfesto	vesper'fest'o
vesperiĝas	vesper'iĝ'as
vesperiĝis	vesper'iĝ'is
vesperiĝo	vesper'iĝ'o
vesperkrepusko	vesper'krepusk'o
vespermanĝa	vesper'manĝ'a
vespermanĝas	vesper'manĝ'as
vespermanĝi	vesper'manĝ'i
vespermanĝis	vesper'manĝ'is
vespermangho	vesper'manĝ'o
vespermanĝo	vesper'manĝ'o
vespermanĝoj	vesper'manĝ'o'j
vespermanĝojn	vesper'manĝ'o'j'n
vespermanĝon	vesper'manĝ'o'n
vespermanĝos	vesper'manĝ'os
vespermanĝu	vesper'manĝ'u
vesperruĝo	vesper'ruĝ'o
vesperuloj	vesper'ul'o'j
vesperto	vespert'o
vespertoj	vespert'o'j
vespertojn	vespert'o'j'n
vesperton	vespert'o'n
vesproj	vespr'o'j
vesta	vest'a
vestaj	vest'a'j
vestas	vest'as
vesti	vest'i
vestis	vest'is
vesto	vest'o
vestoj	vest'o'j
vestojn	vest'o'j'n
veston	vest'o'n
vestos	vest'os
vestu	vest'u
vestado	vest'ad'o
vestajho	vest'aĵ'o
vestaĵo	vest'aĵ'o
vestaĵoj	vest'aĵ'o'j
vestaĵojn	vest'aĵ'o'j'n
vestaĵon	vest'aĵ'o'n
vestaĵindustrio	vest'aĵ'industri'o
vestanta	vest'ant'a
vestante	vest'ant'e
vestaro	vest'ar'o
vestaron	vest'ar'o'n
vestata	vest'at'a
vestejo	vest'ej'o
vestiĝas	vest'iĝ'as
vestiĝi	vest'iĝ'i
vestiĝis	vest'iĝ'is
vestinte	vest'int'e
vestita	vest'it'a
vestitaj	vest'it'a'j
vestitajn	vest'it'a'j'n
vestitan	vest'it'a'n
vestite	vest'it'e
vestmaniero	vest'manier'o
vestokompleto	vest'o'komplet'o
vestokompletoj	vest'o'komplet'o'j
vestokompletojn	vest'o'komplet'o'j'n
vestokompleton	vest'o'komplet'o'n
vestoŝranko	vest'o'ŝrank'o
vestregularo	vest'regul'ar'o
veŝto	veŝt'o
veŝtoj	veŝt'o'j
veŝton	veŝt'o'n
vestalo	vestal'o
vestaloj	vestal'o'j
vestfalia	vestfali'a
vestfalio	vestfali'o
vestiblo	vestibl'o
vestibloj	vestibl'o'j
vestiblon	vestibl'o'n
vetas	vet'as
vete	vet'e
veti	vet'i
vetis	vet'is
veto	vet'o
vetoj	vet'o'j
vetojn	vet'o'j'n
veton	vet'o'n
vetos	vet'os
vetu	vet'u
vetus	vet'us
vetado	vet'ad'o
vetarmado	vet'arm'ad'o
vetarmadon	vet'arm'ad'o'n
vetkura	vet'kur'a
vetkuris	vet'kur'is
vetkuro	vet'kur'o
vetkuroj	vet'kur'o'j
vetkurojn	vet'kur'o'j'n
vetkuron	vet'kur'o'n
vetkurado	vet'kur'ad'o
vetludi	vet'lud'i
vetludis	vet'lud'is
vetludo	vet'lud'o
vetludon	vet'lud'o'n
vetludado	vet'lud'ad'o
vetera	veter'a
veteraj	veter'a'j
vetero	veter'o
veteroj	veter'o'j
veteron	veter'o'n
veteraĉo	veter'aĉ'o
veteraĝado	veter'aĝ'ad'o
veteraĝintaj	veter'aĝ'int'a'j
vetercirkonstancoj	veter'cirkonstanc'o'j
vetercirkonstancojn	veter'cirkonstanc'o'j'n
veterdisfalo	veter'dis'fal'o
veterkondiĉoj	veter'kondiĉ'o'j
veterokazaĵoj	veter'okaz'aĵ'o'j
veterprognozo	veter'prognoz'o
veterprognozoj	veter'prognoz'o'j
vetersistemoj	veter'sistem'o'j
veterana	veteran'a
veteranaj	veteran'a'j
veterano	veteran'o
veteranoj	veteran'o'j
veteranojn	veteran'o'j'n
veterinara	veterinar'a
veterinaraj	veterinar'a'j
veterinaran	veterinar'a'n
veterinaro	veterinar'o
vetoi	veto'i
vetois	veto'is
vetoo	veto'o
vetoon	veto'o'n
vetoita	veto'it'a
veturas	vetur'as
veturi	vetur'i
veturis	vetur'is
veturo	vetur'o
veturoj	vetur'o'j
veturojn	vetur'o'j'n
veturon	vetur'o'n
veturos	vetur'os
veturu	vetur'u
veturus	vetur'us
veturadas	vetur'ad'as
veturadis	vetur'ad'is
veturado	vetur'ad'o
veturadoj	vetur'ad'o'j
veturadojn	vetur'ad'o'j'n
veturadon	vetur'ad'o'n
veturadotrajno	vetur'ad'o'trajn'o
veturanta	vetur'ant'a
veturantaj	vetur'ant'a'j
veturantajn	vetur'ant'a'j'n
veturantan	vetur'ant'a'n
veturante	vetur'ant'e
veturanto	vetur'ant'o
veturantoj	vetur'ant'o'j
veturantojn	vetur'ant'o'j'n
veturebla	vetur'ebl'a
veturejo	vetur'ej'o
veturigas	vetur'ig'as
veturigi	vetur'ig'i
veturigis	vetur'ig'is
veturigo	vetur'ig'o
veturigos	vetur'ig'os
veturigu	vetur'ig'u
veturigata	vetur'ig'at'a
veturigisto	vetur'ig'ist'o
veturigistoj	vetur'ig'ist'o'j
veturigiston	vetur'ig'ist'o'n
veturigita	vetur'ig'it'a
veturila	vetur'il'a
veturilaj	vetur'il'a'j
veturilan	vetur'il'a'n
veturilo	vetur'il'o
veturiloj	vetur'il'o'j
veturilojn	vetur'il'o'j'n
veturilon	vetur'il'o'n
veturinta	vetur'int'a
veturita	vetur'it'a
veturitaj	vetur'it'a'j
veturonta	vetur'ont'a
veturprioritato	vetur'prioritat'o
veturtempo	vetur'temp'o
veturvojo	vetur'voj'o
veziko	vezik'o
vezikoj	vezik'o'j
vezikojn	vezik'o'j'n
vezikon	vezik'o'n
veziketo	vezik'et'o
veziketoj	vezik'et'o'j
veziro	vezir'o
veziroj	vezir'o'j
vezuvio	vezuvi'o
vi	vi
via	vi'a
viaj	vi'a'j
viajn	vi'a'j'n
vian	vi'a'n
vin	vi'n
viaflanke	vi'a'flank'e
viahejme	vi'a'hejm'e
viahejmen	vi'a'hejm'e'n
viaopinie	vi'a'opini'e
viadukto	viadukt'o
vianda	viand'a
viandaj	viand'a'j
viandan	viand'a'n
viando	viand'o
viandoj	viand'o'j
viandojn	viand'o'j'n
viandon	viand'o'n
viandaĵo	viand'aĵ'o
viandaĵoj	viand'aĵ'o'j
viandaĵojn	viand'aĵ'o'j'n
viandaĵon	viand'aĵ'o'n
viandbuloj	viand'bul'o'j
viandejo	viand'ej'o
viandindustrio	viand'industri'o
viandisto	viand'ist'o
viandistoj	viand'ist'o'j
viandkonsumo	viand'konsum'o
viandoproduktado	viand'o'produkt'ad'o
vibra	vibr'a
vibraj	vibr'a'j
vibras	vibr'as
vibri	vibr'i
vibris	vibr'is
vibro	vibr'o
vibroj	vibr'o'j
vibrado	vibr'ad'o
vibradoj	vibr'ad'o'j
vibradojn	vibr'ad'o'j'n
vibradon	vibr'ad'o'n
vibranta	vibr'ant'a
vibrantaj	vibr'ant'a'j
vibrigas	vibr'ig'as
vibrigis	vibr'ig'is
vica	vic'a
vicaj	vic'a'j
vican	vic'a'n
vicas	vic'as
vice	vic'e
vici	vic'i
vicis	vic'is
vico	vic'o
vicoj	vic'o'j
vicojn	vic'o'j'n
vicon	vic'o'n
vicus	vic'us
vicante	vic'ant'e
vicaro	vic'ar'o
vicĉefministro	vic'ĉef'ministr'o
vicdekano	vic'dekan'o
vicdirektoro	vic'direktor'o
vicestro	vic'estr'o
vicfilo	vic'fil'o
vicĝenerala	vic'ĝeneral'a
vicgrafo	vic'graf'o
vicgubernatoro	vic'gubernator'o
vicigas	vic'ig'as
vicigi	vic'ig'i
vicigis	vic'ig'is
vicigo	vic'ig'o
vicigado	vic'ig'ad'o
vicigante	vic'ig'ant'e
vicigita	vic'ig'it'a
vicigitaj	vic'ig'it'a'j
vicigite	vic'ig'it'e
viciĝas	vic'iĝ'as
viciĝi	vic'iĝ'i
viciĝis	vic'iĝ'is
vicita	vic'it'a
vicitaj	vic'it'a'j
vickanceliero	vic'kancelier'o
vickomandanto	vic'komand'ant'o
vickonsulo	vic'konsul'o
vicministro	vic'ministr'o
vicministroprezidento	vic'ministr'o'prezident'o
vicorda	vic'ord'a
vicordan	vic'ord'a'n
vicordo	vic'ord'o
vicordon	vic'ord'o'n
vicpatro	vic'patr'o
vicpatrino	vic'patr'in'o
vicprezidanto	vic'prezid'ant'o
vicprezidantoj	vic'prezid'ant'o'j
vicprezidantojn	vic'prezid'ant'o'j'n
vicprezidanton	vic'prezid'ant'o'n
vicprezidantino	vic'prezid'ant'in'o
vicprezidento	vic'prezident'o
vicredaktoro	vic'redaktor'o
vicregistaro	vic'reg'ist'ar'o
vicreĝo	vic'reĝ'o
vicreĝoj	vic'reĝ'o'j
vicreĝlando	vic'reĝ'land'o
vicrektoro	vic'rektor'o
vicsekretario	vic'sekretari'o
vicurbestro	vic'urb'estr'o
vida	vid'a
vidaj	vid'a'j
vidajn	vid'a'j'n
vidan	vid'a'n
vidas	vid'as
vide	vid'e
vidi	vid'i
vidis	vid'is
vido	vid'o
vidoj	vid'o'j
vidojn	vid'o'j'n
vidon	vid'o'n
vidos	vid'os
vidu	vid'u
vidus	vid'us
vidadis	vid'ad'is
vidado	vid'ad'o
vidadon	vid'ad'o'n
vidajho	vid'aĵ'o
vidaĵo	vid'aĵ'o
vidaĵoj	vid'aĵ'o'j
vidaĵojn	vid'aĵ'o'j'n
vidaĵon	vid'aĵ'o'n
vidakreco	vid'akr'ec'o
vidalvida	vid'al'vid'a
vidalvidan	vid'al'vid'a'n
vidalvide	vid'al'vid'e
vidangulo	vid'angul'o
vidanta	vid'ant'a
vidantaj	vid'ant'a'j
vidantan	vid'ant'a'n
vidante	vid'ant'e
vidanto	vid'ant'o
vidantoj	vid'ant'o'j
vidata	vid'at'a
vidataj	vid'at'a'j
vidate	vid'at'e
vidbenda	vid'bend'a
vidbendaj	vid'bend'a'j
vidbendan	vid'bend'a'n
vidbendo	vid'bend'o
vidbendoj	vid'bend'o'j
vidbendojn	vid'bend'o'j'n
vidbendon	vid'bend'o'n
videbla	vid'ebl'a
videblaj	vid'ebl'a'j
videblajn	vid'ebl'a'j'n
videblan	vid'ebl'a'n
videblas	vid'ebl'as
videble	vid'ebl'e
videblis	vid'ebl'is
videblo	vid'ebl'o
videbloj	vid'ebl'o'j
videblojn	vid'ebl'o'j'n
videblon	vid'ebl'o'n
videblos	vid'ebl'os
videbleco	vid'ebl'ec'o
videblecon	vid'ebl'ec'o'n
videbligas	vid'ebl'ig'as
videbligi	vid'ebl'ig'i
videbligis	vid'ebl'ig'is
videbligo	vid'ebl'ig'o
videbliĝas	vid'ebl'iĝ'as
videbliĝis	vid'ebl'iĝ'is
videti	vid'et'i
videtis	vid'et'is
vidhandikapuloj	vid'handikap'ul'o'j
vidigas	vid'ig'as
vidigi	vid'ig'i
vidigis	vid'ig'is
vidigu	vid'ig'u
vidigante	vid'ig'ant'e
vidigilo	vid'ig'il'o
vidiĝas	vid'iĝ'as
vidiĝi	vid'iĝ'i
vidiĝis	vid'iĝ'is
vidiĝos	vid'iĝ'os
vidinda	vid'ind'a
vidindaj	vid'ind'a'j
vidindas	vid'ind'as
vidindaĵo	vid'ind'aĵ'o
vidindaĵoj	vid'ind'aĵ'o'j
vidindaĵojn	vid'ind'aĵ'o'j'n
vidindaĵon	vid'ind'aĵ'o'n
vidindejo	vid'ind'ej'o
vidindejoj	vid'ind'ej'o'j
vidinta	vid'int'a
vidintaj	vid'int'a'j
vidinte	vid'int'e
vidinto	vid'int'o
vidintus	vid'int'us
vidita	vid'it'a
viditaj	vid'it'a'j
viditajn	vid'it'a'j'n
viditan	vid'it'a'n
vidite	vid'it'e
vidkampo	vid'kamp'o
vidkampon	vid'kamp'o'n
vidkapablaj	vid'kapabl'a'j
vidkapablo	vid'kapabl'o
vidkapablon	vid'kapabl'o'n
vidkarto	vid'kart'o
vidkartoj	vid'kart'o'j
vidkortekso	vid'korteks'o
vidlinio	vid'lini'o
vidlinion	vid'lini'o'n
vidmaniero	vid'manier'o
vidnervo	vid'nerv'o
vidokapablon	vid'o'kapabl'o'n
vidpovo	vid'pov'o
vidpovon	vid'pov'o'n
vidpunkte	vid'punkt'e
vidpunkto	vid'punkt'o
vidpunktoj	vid'punkt'o'j
vidpunktojn	vid'punkt'o'j'n
vidpunkton	vid'punkt'o'n
vidsenso	vid'sens'o
videa	vide'a
video	vide'o
videoj	vide'o'j
videojn	vide'o'j'n
videon	vide'o'n
videaĵo	vide'aĵ'o
videaĵoj	vide'aĵ'o'j
videaĵojn	vide'aĵ'o'j'n
videaĵon	vide'aĵ'o'n
videenhavo	vide'en'hav'o
videkasediloj	vide'kased'il'o'j
videofilmas	vide'o'film'as
videofilmo	vide'o'film'o
videofilmoj	vide'o'film'o'j
videofilmon	vide'o'film'o'n
videoluda	vide'o'lud'a
videoludo	vide'o'lud'o
videoludoj	vide'o'lud'o'j
videoludojn	vide'o'lud'o'j'n
videoludon	vide'o'lud'o'n
videoludado	vide'o'lud'ad'o
videsignalo	vide'signal'o
videsignaloj	vide'signal'o'j
vidvo	vidv'o
vidvigita	vidv'ig'it'a
vidvino	vidv'in'o
vidvinoj	vidv'in'o'j
vidvinojn	vidv'in'o'j'n
vidvinon	vidv'in'o'n
viena	vien'a
vienaj	vien'a'j
vienan	vien'a'n
vieno	vien'o
vienon	vien'o'n
vienanoj	vien'an'o'j
vigla	vigl'a
viglaj	vigl'a'j
viglajn	vigl'a'j'n
viglan	vigl'a'n
viglas	vigl'as
vigle	vigl'e
viglis	vigl'is
viglo	vigl'o
viglon	vigl'o'n
viglu	vigl'u
viglado	vigl'ad'o
vigleco	vigl'ec'o
viglecon	vigl'ec'o'n
viglega	vigl'eg'a
vigligas	vigl'ig'as
vigligi	vigl'ig'i
vigligis	vigl'ig'is
vigligo	vigl'ig'o
vigligistoj	vigl'ig'ist'o'j
vigligita	vigl'ig'it'a
vigliĝas	vigl'iĝ'as
vigliĝis	vigl'iĝ'is
vikario	vikari'o
vikarioj	vikari'o'j
vikia	viki'a
vikio	viki'o
vikioj	viki'o'j
vikion	viki'o'n
vikicitaro	viki'citar'o
vikifontaro	viki'font'ar'o
vikimedia	viki'medi'a
vikimedio	viki'medi'o
vikivortaro	viki'vort'ar'o
vikinga	viking'a
vikingaj	viking'a'j
vikingo	viking'o
vikingoj	viking'o'j
vikingedzino	viking'edz'in'o
vikipedia	vikipedi'a
vikipediaj	vikipedi'a'j
vikipedian	vikipedi'a'n
vikipedio	vikipedi'o
vikipedioj	vikipedi'o'j
vikipedion	vikipedi'o'n
vikipediisto	vikipedi'ist'o
vikipediistoj	vikipedi'ist'o'j
vikipedioartikolo	vikipedi'o'artikol'o
vikipedioartikoloj	vikipedi'o'artikol'o'j
viktimo	viktim'o
viktimoj	viktim'o'j
viktimojn	viktim'o'j'n
viktimon	viktim'o'n
viktimiĝis	viktim'iĝ'is
viktoro	viktor'o
viktoria	viktori'a
viktoriaj	viktori'a'j
viktorio	viktori'o
vila	vil'a
vilaj	vil'a'j
vilajn	vil'a'j'n
vilan	vil'a'n
viloj	vil'o'j
vilojn	vil'o'j'n
vilaa	vila'a
vilao	vila'o
vilaoj	vila'o'j
vilaojn	vila'o'j'n
vilaon	vila'o'n
vilaano	vila'an'o
vilaanoj	vila'an'o'j
vilaĝa	vilaĝ'a
vilagha	vilaĝ'a
vilaĝaj	vilaĝ'a'j
vilaĝajn	vilaĝ'a'j'n
vilaĝan	vilaĝ'a'n
vilagho	vilaĝ'o
vilaĝo	vilaĝ'o
vilaĝoj	vilaĝ'o'j
vilaĝojn	vilaĝ'o'j'n
vilaĝon	vilaĝ'o'n
vilaĝano	vilaĝ'an'o
vilaĝanoj	vilaĝ'an'o'j
vilaĝanojn	vilaĝ'an'o'j'n
vilaĝanaro	vilaĝ'an'ar'o
vilaĝanino	vilaĝ'an'in'o
vilaĝestro	vilaĝ'estr'o
vilaghestro	vilaĝ'estr'o
vilaĝeto	vilaĝ'et'o
vilaĝetoj	vilaĝ'et'o'j
vilaĝetojn	vilaĝ'et'o'j'n
vilaĝeton	vilaĝ'et'o'n
vilaĝplaco	vilaĝ'plac'o
vilhelmo	vilhelm'o
vilhelmon	vilhelm'o'n
vilna	viln'a
vilno	viln'o
vimenaĵa	vimen'aĵ'a
vina	vin'a
vinan	vin'a'n
vino	vin'o
vinoj	vin'o'j
vinojn	vin'o'j'n
vinon	vin'o'n
vinbera	vin'ber'a
vinberan	vin'ber'a'n
vinbero	vin'ber'o
vinberoj	vin'ber'o'j
vinberojn	vin'ber'o'j'n
vinberon	vin'ber'o'n
vinberejo	vin'ber'ej'o
vinberejoj	vin'ber'ej'o'j
vinberĝardenoj	vin'ber'ĝarden'o'j
vinberujo	vin'ber'uj'o
vinberujoj	vin'ber'uj'o'j
vinbotelon	vin'botel'o'n
vinfarado	vin'far'ad'o
vinfarejo	vin'far'ej'o
vinfarejoj	vin'far'ej'o'j
vingustumado	vin'gust'um'ad'o
vinindustrio	vin'industri'o
vinkelo	vin'kel'o
vinkeloj	vin'kel'o'j
vinkultivado	vin'kultiv'ad'o
vinkulturo	vin'kultur'o
vinproduktado	vin'produkt'ad'o
vinproduktantoj	vin'produkt'ant'o'j
vinregiono	vin'region'o
vinregionoj	vin'region'o'j
vinagra	vinagr'a
vinagro	vinagr'o
vinagron	vinagr'o'n
vinĉo	vinĉ'o
vincento	vincent'o
vindis	vind'is
vindita	vind'it'a
vindoza	vindoz'a
vindozaj	vindoz'a'j
vindozo	vindoz'o
vindozon	vindoz'o'n
vinila	vinil'a
vinilo	vinil'o
vinilkosmo	vinilkosm'o
vinipego	vinipeg'o
vinjeto	vinjet'o
vinjetoj	vinjet'o'j
vinko	vink'o
vinterturo	vintertur'o
vintra	vintr'a
vintraj	vintr'a'j
vintrajn	vintr'a'j'n
vintran	vintr'a'n
vintras	vintr'as
vintre	vintr'e
vintro	vintr'o
vintroj	vintr'o'j
vintrojn	vintr'o'j'n
vintron	vintr'o'n
vintrejoj	vintr'ej'o'j
vintrodormo	vintr'o'dorm'o
vintromonatoj	vintr'o'monat'o'j
vintrosezono	vintr'o'sezon'o
vintrumas	vintr'um'as
viola	viol'a
violaj	viol'a'j
violajn	viol'a'j'n
violan	viol'a'n
violo	viol'o
violoj	viol'o'j
violkolora	viol'kolor'a
violkoloraj	viol'kolor'a'j
violkoloran	viol'kolor'a'n
violenta	violent'a
violentaj	violent'a'j
violente	violent'e
violento	violent'o
violentoj	violent'o'j
violenton	violent'o'n
violona	violon'a
violonan	violon'a'n
violonas	violon'as
violoni	violon'i
violono	violon'o
violonoj	violon'o'j
violonojn	violon'o'j'n
violonon	violon'o'n
violonisto	violon'ist'o
violonistoj	violon'ist'o'j
violonĉelo	violonĉel'o
violonĉeloj	violonĉel'o'j
violonĉelon	violonĉel'o'n
violonĉelisto	violonĉel'ist'o
vipas	vip'as
vipi	vip'i
vipis	vip'is
vipo	vip'o
vipoj	vip'o'j
vipojn	vip'o'j'n
vipon	vip'o'n
vipado	vip'ad'o
vipita	vip'it'a
vipobatoj	vip'o'bat'o'j
vipero	viper'o
vipuro	vipur'o
vipuroj	vipur'o'j
vira	vir'a
viraj	vir'a'j
virajn	vir'a'j'n
viran	vir'a'n
vire	vir'e
viro	vir'o
viroj	vir'o'j
virojn	vir'o'j'n
viron	vir'o'n
virabelo	vir'abel'o
virabeloj	vir'abel'o'j
virabelojn	vir'abel'o'j'n
viranaso	vir'anas'o
viraro	vir'ar'o
virbesto	vir'best'o
virbirdo	vir'bird'o
virbirdoj	vir'bird'o'j
virbovo	vir'bov'o
virbovoj	vir'bov'o'j
virbovojn	vir'bov'o'j'n
virbovon	vir'bov'o'n
vircervo	vir'cerv'o
vircervoj	vir'cerv'o'j
virĉevalo	vir'ĉeval'o
virĉevaloj	vir'ĉeval'o'j
vircigno	vir'cign'o
vireca	vir'ec'a
virece	vir'ec'e
vireco	vir'ec'o
virecon	vir'ec'o'n
vireto	vir'et'o
vireton	vir'et'o'n
virfiguroj	vir'figur'o'j
virgenra	vir'genr'a
virgenraj	vir'genr'a'j
virhomo	vir'hom'o
virhundo	vir'hund'o
virina	vir'in'a
virinaj	vir'in'a'j
virinajn	vir'in'a'j'n
virinan	vir'in'a'n
virine	vir'in'e
virino	vir'in'o
virinoj	vir'in'o'j
virinojn	vir'in'o'j'n
virinon	vir'in'o'n
virinaĉo	vir'in'aĉ'o
virinaro	vir'in'ar'o
virineca	vir'in'ec'a
virinecaj	vir'in'ec'a'j
virinecajn	vir'in'ec'a'j'n
virinecan	vir'in'ec'a'n
virineco	vir'in'ec'o
virineto	vir'in'et'o
virinfiguro	vir'in'figur'o
virinfiguroj	vir'in'figur'o'j
virkapro	vir'kapr'o
virkato	vir'kat'o
virkatoj	vir'kat'o'j
virkaton	vir'kat'o'n
virkoko	vir'kok'o
virkokoj	vir'kok'o'j
virkokon	vir'kok'o'n
virlinio	vir'lini'o
virporko	vir'pork'o
virŝafo	vir'ŝaf'o
virŝafoj	vir'ŝaf'o'j
virŝafon	vir'ŝaf'o'n
virseksa	vir'seks'a
virseksaj	vir'seks'a'j
virseksan	vir'seks'a'n
virsekso	vir'seks'o
virga	virg'a
virgaj	virg'a'j
virgan	virg'a'n
virgo	virg'o
virgeco	virg'ec'o
virgecon	virg'ec'o'n
virgulo	virg'ul'o
virgulina	virg'ul'in'a
virgulino	virg'ul'in'o
virgulinoj	virg'ul'in'o'j
virgulinojn	virg'ul'in'o'j'n
virgulinon	virg'ul'in'o'n
virgulininsuloj	virg'ul'in'insul'o'j
virginia	virgini'a
virginio	virgini'o
virginion	virgini'o'n
virta	virt'a
virtaj	virt'a'j
virtan	virt'a'n
virte	virt'e
virto	virt'o
virtoj	virt'o'j
virtojn	virt'o'j'n
virton	virt'o'n
virteco	virt'ec'o
virtulo	virt'ul'o
virtuloj	virt'ul'o'j
virtulojn	virt'ul'o'j'n
virtuala	virtual'a
virtualaj	virtual'a'j
virtualajn	virtual'a'j'n
virtualan	virtual'a'n
virtuale	virtual'e
virtualigo	virtual'ig'o
virtualrealeca	virtual'real'ec'a
virtuoza	virtuoz'a
virtuozaj	virtuoz'a'j
virtuozo	virtuoz'o
virtuozeco	virtuoz'ec'o
virtuozecon	virtuoz'ec'o'n
virulenta	virulent'a
virulentaj	virulent'a'j
virusa	virus'a
virusaj	virus'a'j
virusan	virus'a'n
viruso	virus'o
virusoj	virus'o'j
virusojn	virus'o'j'n
viruson	virus'o'n
virusinfektoj	virus'infekt'o'j
virusvektoroj	virus'vektor'o'j
viŝas	viŝ'as
viŝi	viŝ'i
viŝis	viŝ'is
viŝu	viŝ'u
viŝado	viŝ'ad'o
viŝante	viŝ'ant'e
viŝiloj	viŝ'il'o'j
viŝtuko	viŝ'tuk'o
viŝtukon	viŝ'tuk'o'n
viscera	viscer'a
visigota	visigot'a
visigotoj	visigot'o'j
visko	visk'o
viskio	viski'o
viskioj	viski'o'j
viskion	viski'o'n
viskonsina	viskonsin'a
viskonsino	viskonsin'o
viskoza	viskoz'a
viskozaj	viskoz'a'j
viskozan	viskoz'a'n
viskozeco	viskoz'ec'o
viskozecon	viskoz'ec'o'n
viŝnuo	viŝnu'o
vista	vist'a
visto	vist'o
visterioj	visteri'o'j
vistulo	vistul'o
vita	vit'a
vito	vit'o
vitoj	vit'o'j
vitojn	vit'o'j'n
viton	vit'o'n
vitejo	vit'ej'o
vitejoj	vit'ej'o'j
vitejojn	vit'ej'o'j'n
vitoplena	vit'o'plen'a
vitala	vital'a
vitalaj	vital'a'j
vitalan	vital'a'n
vitale	vital'e
vitali	vital'i
vitalo	vital'o
vitalismo	vital'ism'o
vitamino	vitamin'o
vitaminoj	vitamin'o'j
vitaminojn	vitamin'o'j'n
vitaminon	vitamin'o'n
vitra	vitr'a
vitraj	vitr'a'j
vitrajn	vitr'a'j'n
vitran	vitr'a'n
vitro	vitr'o
vitroj	vitr'o'j
vitrojn	vitr'o'j'n
vitron	vitr'o'n
vitraĵo	vitr'aĵ'o
vitraĵoj	vitr'aĵ'o'j
vitraĵojn	vitr'aĵ'o'j'n
vitraĵon	vitr'aĵ'o'n
vitreca	vitr'ec'a
vitrecaj	vitr'ec'a'j
vitrecan	vitr'ec'a'n
vitrigo	vitr'ig'o
vitrodomo	vitr'o'dom'o
vitrofarejo	vitr'o'far'ej'o
vitrofibro	vitr'o'fibr'o
vitrotransiro	vitr'o'trans'ir'o
vitrovaro	vitr'o'var'o
vitralo	vitral'o
vitraloj	vitral'o'j
vitrino	vitrin'o
vitrinoj	vitrin'o'j
vitriolo	vitriol'o
vitruvio	vitruvi'o
viva	viv'a
vivaj	viv'a'j
vivajn	viv'a'j'n
vivan	viv'a'n
vivas	viv'as
vive	viv'e
vivi	viv'i
vivis	viv'is
vivo	viv'o
vivoj	viv'o'j
vivojn	viv'o'j'n
vivon	viv'o'n
vivos	viv'os
vivu	viv'u
vivus	viv'us
vivadas	viv'ad'as
vivadi	viv'ad'i
vivadis	viv'ad'is
vivado	viv'ad'o
vivadon	viv'ad'o'n
vivaĵo	viv'aĵ'o
vivaĵoj	viv'aĵ'o'j
vivaĵojn	viv'aĵ'o'j'n
vivanta	viv'ant'a
vivantaj	viv'ant'a'j
vivantajn	viv'ant'a'j'n
vivantan	viv'ant'a'n
vivante	viv'ant'e
vivanto	viv'ant'o
vivantoj	viv'ant'o'j
vivantojn	viv'ant'o'j'n
vivanton	viv'ant'o'n
vivantaĵo	viv'ant'aĵ'o
vivanteco	viv'ant'ec'o
vivantecon	viv'ant'ec'o'n
vivarbo	viv'arb'o
vivasekuro	viv'asekur'o
vivasekuron	viv'asekur'o'n
vivata	viv'at'a
vivcelo	viv'cel'o
vivciklo	viv'cikl'o
vivcirkonstancoj	viv'cirkonstanc'o'j
vivdaŭra	viv'daŭr'a
vivdaŭro	viv'daŭr'o
vivdaŭroj	viv'daŭr'o'j
vivdaŭrojn	viv'daŭr'o'j'n
vivdaŭron	viv'daŭr'o'n
vivebla	viv'ebl'a
viveca	viv'ec'a
vivecaj	viv'ec'a'j
vivecan	viv'ec'a'n
vivece	viv'ec'e
viveco	viv'ec'o
vivecon	viv'ec'o'n
vivejo	viv'ej'o
vivejoj	viv'ej'o'j
vivejojn	viv'ej'o'j'n
vivejon	viv'ej'o'n
vivejodetruado	viv'ej'o'detru'ad'o
vivenergio	viv'energi'o
vivestaĵoj	viv'est'aĵ'o'j
vivformo	viv'form'o
vivforton	viv'fort'o'n
vivgranda	viv'grand'a
vivgrandaj	viv'grand'a'j
vivhistorio	viv'histori'o
vivhistorion	viv'histori'o'n
vivipova	viv'i'pov'a
vivipovon	viv'i'pov'o'n
viviga	viv'ig'a
vivigan	viv'ig'a'n
vivigas	viv'ig'as
vivigi	viv'ig'i
vivigis	viv'ig'is
vivigu	viv'ig'u
viviĝis	viv'iĝ'is
vivinda	viv'ind'a
vivinta	viv'int'a
vivintaj	viv'int'a'j
vivinte	viv'int'e
vivita	viv'it'a
vivitaj	viv'it'a'j
vivjaro	viv'jar'o
vivjaroj	viv'jar'o'j
vivkapabla	viv'kapabl'a
vivkapablaj	viv'kapabl'a'j
vivkapablo	viv'kapabl'o
vivkoncepto	viv'koncept'o
vivkonceptoj	viv'koncept'o'j
vivkondiĉo	viv'kondiĉ'o
vivkondiĉoj	viv'kondiĉ'o'j
vivkondiĉojn	viv'kondiĉ'o'j'n
vivkosto	viv'kost'o
vivkostoj	viv'kost'o'j
vivkunulo	viv'kun'ul'o
vivkutimoj	viv'kutim'o'j
vivkutimojn	viv'kutim'o'j'n
vivkvalito	viv'kvalit'o
vivkvaliton	viv'kvalit'o'n
vivloko	viv'lok'o
vivlongigo	viv'long'ig'o
vivmaniero	viv'manier'o
vivmanieroj	viv'manier'o'j
vivmanierojn	viv'manier'o'j'n
vivmanieron	viv'manier'o'n
vivmediaj	viv'medi'a'j
vivmedio	viv'medi'o
vivmedioj	viv'medi'o'j
vivmedion	viv'medi'o'n
vivminaca	viv'minac'a
vivminacaj	viv'minac'a'j
vivnecesa	viv'neces'a
vivnivelo	viv'nivel'o
vivniveloj	viv'nivel'o'j
vivnivelojn	viv'nivel'o'j'n
vivnivelon	viv'nivel'o'n
vivoĉambro	viv'o'ĉambr'o
vivocelo	viv'o'cel'o
vivociklo	viv'o'cikl'o
vivocikloj	viv'o'cikl'o'j
vivociklon	viv'o'cikl'o'n
vivodaŭro	viv'o'daŭr'o
vivodaŭron	viv'o'daŭr'o'n
vivofino	viv'o'fin'o
vivoformo	viv'o'form'o
vivoformoj	viv'o'form'o'j
vivoforto	viv'o'fort'o
vivoforton	viv'o'fort'o'n
vivoĝojo	viv'o'ĝoj'o
vivoĝojon	viv'o'ĝoj'o'n
vivojaro	viv'o'jar'o
vivokondiĉoj	viv'o'kondiĉ'o'j
vivokondiĉojn	viv'o'kondiĉ'o'j'n
vivokvalito	viv'o'kvalit'o
vivokvaliton	viv'o'kvalit'o'n
vivomaniero	viv'o'manier'o
vivoplena	viv'o'plen'a
vivoplenaj	viv'o'plen'a'j
vivoscienco	viv'o'scienc'o
vivosignojn	viv'o'sign'o'j'n
vivosignon	viv'o'sign'o'n
vivosperto	viv'o'spert'o
vivospertoj	viv'o'spert'o'j
vivostilo	viv'o'stil'o
vivostilon	viv'o'stil'o'n
vivotempo	viv'o'temp'o
vivotempoj	viv'o'temp'o'j
vivotempon	viv'o'temp'o'n
vivoverko	viv'o'verk'o
vivovojo	viv'o'voj'o
vivovojon	viv'o'voj'o'n
vivojaroj	viv'ojar'o'j
vivokupo	viv'okup'o
vivokupon	viv'okup'o'n
vivperiodo	viv'period'o
vivplena	viv'plen'a
vivrimedo	viv'rimed'o
vivrimedoj	viv'rimed'o'j
vivrimedojn	viv'rimed'o'j'n
vivrimedon	viv'rimed'o'n
vivritmo	viv'ritm'o
vivsava	viv'sav'a
vivsciencoj	viv'scienc'o'j
vivsignon	viv'sign'o'n
vivsperto	viv'spert'o
vivspertoj	viv'spert'o'j
vivstato	viv'stat'o
vivstaton	viv'stat'o'n
vivstilo	viv'stil'o
vivstiloj	viv'stil'o'j
vivstilojn	viv'stil'o'j'n
vivstilon	viv'stil'o'n
vivsubteno	viv'sub'ten'o
vivtempo	viv'temp'o
vivtempoj	viv'temp'o'j
vivtempon	viv'temp'o'n
vivtena	viv'ten'a
vivtenaj	viv'ten'a'j
vivtenas	viv'ten'as
vivteni	viv'ten'i
vivtenis	viv'ten'is
vivteno	viv'ten'o
vivtenon	viv'ten'o'n
vivtenos	viv'ten'os
vivtenu	viv'ten'u
vivtenado	viv'ten'ad'o
vivtenadon	viv'ten'ad'o'n
vivtenataj	viv'ten'at'a'j
vivteniga	viv'ten'ig'a
vivulo	viv'ul'o
vivuloj	viv'ul'o'j
vivulojn	viv'ul'o'j'n
viveroj	viver'o'j
vizaj	viz'a'j
vizo	viz'o
vizoj	viz'o'j
vizojn	viz'o'j'n
vizon	viz'o'n
vizaĝa	vizaĝ'a
vizaĝaj	vizaĝ'a'j
vizaĝajn	vizaĝ'a'j'n
vizaĝan	vizaĝ'a'n
vizaĝas	vizaĝ'as
vizaĝe	vizaĝ'e
vizaĝi	vizaĝ'i
vizagho	vizaĝ'o
vizaĝo	vizaĝ'o
vizaĝoj	vizaĝ'o'j
vizaĝojn	vizaĝ'o'j'n
vizaĝon	vizaĝ'o'n
vizaĝos	vizaĝ'os
vizaĝaltere	vizaĝ'al'ter'e
vizaĝalvizaĝa	vizaĝ'al'vizaĝ'a
vizaĝalvizaĝaj	vizaĝ'al'vizaĝ'a'j
vizaĝalvizaĝe	vizaĝ'al'vizaĝ'e
vizaĝante	vizaĝ'ant'e
vizaĝecoj	vizaĝ'ec'o'j
vizaĝesprimo	vizaĝ'esprim'o
vizaĝesprimon	vizaĝ'esprim'o'n
vizaĝeto	vizaĝ'et'o
vizaĝeton	vizaĝ'et'o'n
vizaĝkoloro	vizaĝ'kolor'o
vizaĝkoloron	vizaĝ'kolor'o'n
vizaĝlibro	vizaĝ'libr'o
vizaĝrekono	vizaĝ're'kon'o
vizaĝtrajtoj	vizaĝ'trajt'o'j
vizia	vizi'a
viziaj	vizi'a'j
vizio	vizi'o
vizioj	vizi'o'j
viziojn	vizi'o'j'n
vizion	vizi'o'n
viziulo	vizi'ul'o
viziuloj	vizi'ul'o'j
viziero	vizier'o
vizieron	vizier'o'n
vizita	vizit'a
vizitas	vizit'as
vizite	vizit'e
viziti	vizit'i
vizitis	vizit'is
vizito	vizit'o
vizitoj	vizit'o'j
vizitojn	vizit'o'j'n
viziton	vizit'o'n
vizitos	vizit'os
vizitu	vizit'u
vizitus	vizit'us
vizitadas	vizit'ad'as
vizitadi	vizit'ad'i
vizitadis	vizit'ad'is
vizitado	vizit'ad'o
vizitadon	vizit'ad'o'n
vizitanta	vizit'ant'a
vizitantaj	vizit'ant'a'j
vizitante	vizit'ant'e
vizitanto	vizit'ant'o
vizitantoj	vizit'ant'o'j
vizitantojn	vizit'ant'o'j'n
vizitanton	vizit'ant'o'n
vizitantino	vizit'ant'in'o
vizitata	vizit'at'a
vizitataj	vizit'at'a'j
vizitebla	vizit'ebl'a
viziteblaj	vizit'ebl'a'j
viziteblas	vizit'ebl'as
vizitinda	vizit'ind'a
vizitindaj	vizit'ind'a'j
vizitindas	vizit'ind'as
vizitindaĵoj	vizit'ind'aĵ'o'j
vizitindejo	vizit'ind'ej'o
vizitindejoj	vizit'ind'ej'o'j
vizitinta	vizit'int'a
vizitintaj	vizit'int'a'j
vizitinte	vizit'int'e
vizitinto	vizit'int'o
vizitintoj	vizit'int'o'j
vizitita	vizit'it'a
vizititaj	vizit'it'a'j
vizititajn	vizit'it'a'j'n
vizitkarto	vizit'kart'o
vizitkarton	vizit'kart'o'n
vizitonta	vizit'ont'a
vizono	vizon'o
vjetnama	vjetnam'a
vjetnamaj	vjetnam'a'j
vjetnamajn	vjetnam'a'j'n
vjetnaman	vjetnam'a'n
vjetnamo	vjetnam'o
vjetnamoj	vjetnam'o'j
vjetnamano	vjetnam'an'o
vjetnamanoj	vjetnam'an'o'j
vjetnamujo	vjetnam'uj'o
vjetnamia	vjetnami'a
vietnamio	vjetnami'o
vjetnamio	vjetnami'o
vjetnamion	vjetnami'o'n
vjolo	vjol'o
vladimiro	vladimir'o
voĉa	voĉ'a
voĉaj	voĉ'a'j
voĉajn	voĉ'a'j'n
voĉan	voĉ'a'n
voĉe	voĉ'e
voĉis	voĉ'is
voĉo	voĉ'o
voĉoj	voĉ'o'j
voĉojn	voĉ'o'j'n
voĉon	voĉ'o'n
voĉaktoro	voĉ'aktor'o
voĉaktoroj	voĉ'aktor'o'j
voĉdona	voĉ'don'a
voĉdonaj	voĉ'don'a'j
voĉdonan	voĉ'don'a'n
voĉdonas	voĉ'don'as
voĉdone	voĉ'don'e
voĉdoni	voĉ'don'i
voĉdonis	voĉ'don'is
voĉdono	voĉ'don'o
voĉdonoj	voĉ'don'o'j
voĉdonojn	voĉ'don'o'j'n
voĉdonon	voĉ'don'o'n
voĉdonos	voĉ'don'os
voĉdonu	voĉ'don'u
voĉdonus	voĉ'don'us
voĉdonado	voĉ'don'ad'o
voĉdonadoj	voĉ'don'ad'o'j
voĉdonadon	voĉ'don'ad'o'n
voĉdonanta	voĉ'don'ant'a
voĉdonantaj	voĉ'don'ant'a'j
voĉdonante	voĉ'don'ant'e
voĉdonanto	voĉ'don'ant'o
voĉdonantoj	voĉ'don'ant'o'j
voĉdonilon	voĉ'don'il'o'n
voĉdonintoj	voĉ'don'int'o'j
voĉdonita	voĉ'don'it'a
voĉdonitaj	voĉ'don'it'a'j
voĉdonrajto	voĉ'don'rajt'o
voĉdonrajtoj	voĉ'don'rajt'o'j
voĉdonrajtojn	voĉ'don'rajt'o'j'n
voĉdonrajton	voĉ'don'rajt'o'n
voĉemaj	voĉ'em'a'j
voĉeto	voĉ'et'o
voĉigas	voĉ'ig'as
voĉigis	voĉ'ig'is
voĉigitaj	voĉ'ig'it'a'j
voĉkordoj	voĉ'kord'o'j
voĉlegas	voĉ'leg'as
voĉlegi	voĉ'leg'i
voĉlegis	voĉ'leg'is
voĉlegu	voĉ'leg'u
voĉlegita	voĉ'leg'it'a
voĉlegitaj	voĉ'leg'it'a'j
voĉmuzika	voĉ'muzik'a
voĉnombrado	voĉ'nombr'ad'o
voĉoaktoro	voĉ'o'aktor'o
voĉoaktorado	voĉ'o'aktor'ad'o
voĉtono	voĉ'ton'o
vodevilo	vodevil'o
vodko	vodk'o
vodkon	vodk'o'n
voduo	vodu'o
voduismo	vodu'ism'o
voja	voj'a
vojaj	voj'a'j
vojan	voj'a'n
vojas	voj'as
voje	voj'e
vojo	voj'o
vojoj	voj'o'j
vojojn	voj'o'j'n
vojon	voj'o'n
vojaro	voj'ar'o
vojeraris	voj'erar'is
vojeto	voj'et'o
vojetoj	voj'et'o'j
vojetojn	voj'et'o'j'n
vojeton	voj'et'o'n
vojflanko	voj'flank'o
vojigo	voj'ig'o
vojinfrastrukturo	voj'infrastruktur'o
vojiro	voj'ir'o
vojirado	voj'ir'ad'o
vojkonstruado	voj'konstru'ad'o
vojkruco	voj'kruc'o
vojkruciĝo	voj'kruc'iĝ'o
vojkruciĝoj	voj'kruc'iĝ'o'j
vojkuruloj	voj'kur'ul'o'j
vojmapo	voj'map'o
vojmapon	voj'map'o'n
vojmontrilo	voj'montr'il'o
vojmontriloj	voj'montr'il'o'j
vojnodo	voj'nod'o
vojnodoj	voj'nod'o'j
vojrando	voj'rand'o
vojreto	voj'ret'o
vojsignoj	voj'sign'o'j
vojsurfaco	voj'surfac'o
vojaĝa	vojaĝ'a
vojaĝaj	vojaĝ'a'j
vojaĝajn	vojaĝ'a'j'n
vojaĝas	vojaĝ'as
vojaĝi	vojaĝ'i
vojaĝis	vojaĝ'is
vojagho	vojaĝ'o
vojaĝo	vojaĝ'o
vojaĝoj	vojaĝ'o'j
vojaĝojn	vojaĝ'o'j'n
vojaĝon	vojaĝ'o'n
vojaĝos	vojaĝ'os
vojaĝu	vojaĝ'u
vojaĝus	vojaĝ'us
vojaĝadi	vojaĝ'ad'i
vojaĝadis	vojaĝ'ad'is
vojaĝado	vojaĝ'ad'o
vojaĝadon	vojaĝ'ad'o'n
vojaĝagentejo	vojaĝ'agent'ej'o
vojaĝagentejoj	vojaĝ'agent'ej'o'j
vojaĝanta	vojaĝ'ant'a
vojaĝantaj	vojaĝ'ant'a'j
vojaĝantajn	vojaĝ'ant'a'j'n
vojaĝantan	vojaĝ'ant'a'n
vojaĝante	vojaĝ'ant'e
vojaĝanto	vojaĝ'ant'o
vojaĝantoj	vojaĝ'ant'o'j
vojaĝantojn	vojaĝ'ant'o'j'n
vojaĝanton	vojaĝ'ant'o'n
vojaĝdaŭro	vojaĝ'daŭr'o
vojaĝinta	vojaĝ'int'a
vojaĝinto	vojaĝ'int'o
vojaĝintoj	vojaĝ'int'o'j
vojaĝisto	vojaĝ'ist'o
vojaĝkostoj	vojaĝ'kost'o'j
vojaĝkostojn	vojaĝ'kost'o'j'n
vojaĝraporto	vojaĝ'raport'o
vojevodo	vojevod'o
voka	vok'a
vokas	vok'as
voki	vok'i
vokis	vok'is
voko	vok'o
vokoj	vok'o'j
vokojn	vok'o'j'n
vokon	vok'o'n
vokos	vok'os
voku	vok'u
vokus	vok'us
vokadis	vok'ad'is
vokado	vok'ad'o
vokadon	vok'ad'o'n
vokanta	vok'ant'a
vokante	vok'ant'e
vokanto	vok'ant'o
vokata	vok'at'a
vokataj	vok'at'a'j
vokiĝo	vok'iĝ'o
vokiĝoj	vok'iĝ'o'j
vokiĝon	vok'iĝ'o'n
vokinta	vok'int'a
vokinte	vok'int'e
vokita	vok'it'a
vokitaj	vok'it'a'j
vokite	vok'it'e
vokito	vok'it'o
vokitoj	vok'it'o'j
vokiteco	vok'it'ec'o
voksigno	vok'sign'o
vokala	vokal'a
vokalaj	vokal'a'j
vokalan	vokal'a'n
vokalo	vokal'o
vokaloj	vokal'o'j
vokalojn	vokal'o'j'n
vokalon	vokal'o'n
vokalfonemoj	vokal'fonem'o'j
vokaligo	vokal'ig'o
vokaligoj	vokal'ig'o'j
vokaligojn	vokal'ig'o'j'n
vokalkvalito	vokal'kvalit'o
vokalleteroj	vokal'leter'o'j
vokallongo	vokal'long'o
vokalŝanĝo	vokal'ŝanĝ'o
vokalŝanĝigo	vokal'ŝanĝ'ig'o
vokalsistemo	vokal'sistem'o
vokalsono	vokal'son'o
vokalsonoj	vokal'son'o'j
vokalsonojn	vokal'son'o'j'n
vokativo	vokativ'o
vokto	vokt'o
voktoj	vokt'o'j
voktejo	vokt'ej'o
vola	vol'a
volaj	vol'a'j
volan	vol'a'n
volas	vol'as
vole	vol'e
voli	vol'i
volis	vol'is
volo	vol'o
voloj	vol'o'j
volojn	vol'o'j'n
volon	vol'o'n
volos	vol'os
volu	vol'u
volus	vol'us
volado	vol'ad'o
volanta	vol'ant'a
volantaj	vol'ant'a'j
volante	vol'ant'e
volata	vol'at'a
volenevole	vol'e'ne'vol'e
volegas	vol'eg'as
volegis	vol'eg'is
volemo	vol'em'o
volemon	vol'em'o'n
volforto	vol'fort'o
volfortoj	vol'fort'o'j
volforton	vol'fort'o'n
volinta	vol'int'a
volintus	vol'int'us
volita	vol'it'a
volitaj	vol'it'a'j
volonta	vol'ont'a
volontaj	vol'ont'a'j
volontan	vol'ont'a'n
volontas	vol'ont'as
volonte	vol'ont'e
volonti	vol'ont'i
volontis	vol'ont'is
volapuka	volapuk'a
volapukan	volapuk'a'n
volapuko	volapuk'o
volapukon	volapuk'o'n
volapukaĵo	volapuk'aĵ'o
volapukisto	volapuk'ist'o
volapukistoj	volapuk'ist'o'j
volatila	volatil'a
volatilaj	volatil'a'j
volatilajn	volatil'a'j'n
volatilan	volatil'a'n
volatileco	volatil'ec'o
volba	volb'a
volbaj	volb'a'j
volbis	volb'is
volbo	volb'o
volboj	volb'o'j
volbojn	volb'o'j'n
volbon	volb'o'n
volbita	volb'it'a
volbitaj	volb'it'a'j
volejbala	volejbal'a
volframo	volfram'o
volga	volg'a
volgo	volg'o
volitivo	volitiv'o
volonta	volont'a
volontaj	volont'a'j
volontan	volont'a'n
volontas	volont'as
volonte	volont'e
volonti	volont'i
volontis	volont'is
volontado	volont'ad'o
volontege	volont'eg'e
volontula	volont'ul'a
volontulaj	volont'ul'a'j
volontulajn	volont'ul'a'j'n
volontulan	volont'ul'a'n
volontulas	volont'ul'as
volontule	volont'ul'e
volontuli	volont'ul'i
volontulis	volont'ul'is
volontulo	volont'ul'o
volontuloj	volont'ul'o'j
volontulojn	volont'ul'o'j'n
volontulon	volont'ul'o'n
volontulado	volont'ul'ad'o
volontularo	volont'ul'ar'o
volontulino	volont'ul'in'o
volta	volt'a
volto	volt'o
voltoj	volt'o'j
voltao	volta'o
voltero	volter'o
voltmetro	voltmetr'o
volume	volum'e
volumo	volum'o
volumoj	volum'o'j
volumojn	volum'o'j'n
volumon	volum'o'n
volumeto	volum'et'o
volumena	volumen'a
volumenaj	volumen'a'j
volumeno	volumen'o
volumenoj	volumen'o'j
volumenon	volumen'o'n
volupta	volupt'a
volupte	volupt'e
volupto	volupt'o
voluptoj	volupt'o'j
volupton	volupt'o'n
voluptema	volupt'em'a
voluptemaj	volupt'em'a'j
volvas	volv'as
volvi	volv'i
volvis	volv'is
volvo	volv'o
volvado	volv'ad'o
volvaĵo	volv'aĵ'o
volvaĵoj	volv'aĵ'o'j
volvaĵojn	volv'aĵ'o'j'n
volvaĵon	volv'aĵ'o'n
volvanta	volv'ant'a
volviĝas	volv'iĝ'as
volviĝis	volv'iĝ'is
volvita	volv'it'a
volvitaj	volv'it'a'j
volvitan	volv'it'a'n
volvlibro	volv'libr'o
volvlibroj	volv'libr'o'j
vomas	vom'as
vomi	vom'i
vomis	vom'is
vomado	vom'ad'o
vomadon	vom'ad'o'n
vomaĵo	vom'aĵ'o
vomemo	vom'em'o
vomemon	vom'em'o'n
voras	vor'as
vori	vor'i
voris	vor'is
vorado	vor'ad'o
vorante	vor'ant'e
voregas	vor'eg'as
vorema	vor'em'a
vorta	vort'a
vortaj	vort'a'j
vortajn	vort'a'j'n
vortan	vort'a'n
vorte	vort'e
vorto	vort'o
vortoj	vort'o'j
vortojn	vort'o'j'n
vorton	vort'o'n
vortara	vort'ar'a
vortaraj	vort'ar'a'j
vortaro	vort'ar'o
vortaroj	vort'ar'o'j
vortarojn	vort'ar'o'j'n
vortaron	vort'ar'o'n
vortarego	vort'ar'eg'o
vortareto	vort'ar'et'o
vortareton	vort'ar'et'o'n
vortaristo	vort'ar'ist'o
vortaristoj	vort'ar'ist'o'j
vorteco	vort'ec'o
vortelekto	vort'elekt'o
vortelementoj	vort'element'o'j
vortero	vort'er'o
vorteroj	vort'er'o'j
vorteto	vort'et'o
vortetoj	vort'et'o'j
vortetojn	vort'et'o'j'n
vorteton	vort'et'o'n
vortfaraj	vort'far'a'j
vortfarada	vort'far'ad'a
vortfaradaj	vort'far'ad'a'j
vortfaradajn	vort'far'ad'a'j'n
vortfaradan	vort'far'ad'a'n
vortfarade	vort'far'ad'e
vortfarado	vort'far'ad'o
vortfaradon	vort'far'ad'o'n
vortfina	vort'fin'a
vortfinaj	vort'fin'a'j
vortfinfine	vort'fin'fin'e
vortformo	vort'form'o
vortgrupo	vort'grup'o
vortgrupoj	vort'grup'o'j
vortigas	vort'ig'as
vortigi	vort'ig'i
vortigis	vort'ig'is
vortigo	vort'ig'o
vortigoj	vort'ig'o'j
vortigon	vort'ig'o'n
vortigita	vort'ig'it'a
vortigitaj	vort'ig'it'a'j
vortinicialo	vort'inicial'o
vortklasaj	vort'klas'a'j
vortklase	vort'klas'e
vortklaso	vort'klas'o
vortklasoj	vort'klas'o'j
vortklasojn	vort'klas'o'j'n
vortkombino	vort'kombin'o
vortkomenca	vort'komenc'a
vortlisto	vort'list'o
vortlistoj	vort'list'o'j
vortlistojn	vort'list'o'j'n
vortliston	vort'list'o'n
vortludo	vort'lud'o
vortludoj	vort'lud'o'j
vortludojn	vort'lud'o'j'n
vortludon	vort'lud'o'n
vortoprovizo	vort'o'proviz'o
vortostoko	vort'o'stok'o
vortostokon	vort'o'stok'o'n
vortotrezoro	vort'o'trezor'o
vortotrezoron	vort'o'trezor'o'n
vortorda	vort'ord'a
vortordo	vort'ord'o
vortordoj	vort'ord'o'j
vortordon	vort'ord'o'n
vortprovizo	vort'proviz'o
vortprovizoj	vort'proviz'o'j
vortprovizojn	vort'proviz'o'j'n
vortprovizon	vort'proviz'o'n
vortradiko	vort'radik'o
vortradikoj	vort'radik'o'j
vortsignifo	vort'signif'o
vorttrezoro	vort'trezor'o
vorttrezoron	vort'trezor'o'n
vortumas	vort'um'as
vortumi	vort'um'i
vortumis	vort'um'is
vortumo	vort'um'o
vortumoj	vort'um'o'j
vortumon	vort'um'o'n
vortumado	vort'um'ad'o
vortumita	vort'um'it'a
vortuzo	vort'uz'o
vortuzado	vort'uz'ad'o
vortico	vortic'o
vorticoj	vortic'o'j
vorticon	vortic'o'n
vosta	vost'a
vostaj	vost'a'j
vosto	vost'o
vostoj	vost'o'j
vostojn	vost'o'j'n
voston	vost'o'n
vostebeno	vost'eben'o
vosteto	vost'et'o
vostgaso	vost'gas'o
vostobazo	vost'o'baz'o
vostokovriloj	vost'o'kovr'il'o'j
vostopinto	vost'o'pint'o
vostoplumoj	vost'o'plum'o'j
vostoplumojn	vost'o'plum'o'j'n
vota	vot'a
votas	vot'as
votis	vot'is
voto	vot'o
votoj	vot'o'j
votojn	vot'o'j'n
voton	vot'o'n
vrako	vrak'o
vrakoj	vrak'o'j
vrakon	vrak'o'n
vrakita	vrak'it'a
vualas	vual'as
vuali	vual'i
vualis	vual'is
vualo	vual'o
vualoj	vual'o'j
vualojn	vual'o'j'n
vualon	vual'o'n
vualado	vual'ad'o
vualita	vual'it'a
vualitaj	vual'it'a'j
vulgara	vulgar'a
vulgaraj	vulgar'a'j
vulgarajn	vulgar'a'j'n
vulgaran	vulgar'a'n
vulgare	vulgar'e
vulgareco	vulgar'ec'o
vulgato	vulgat'o
vulkana	vulkan'a
vulkanaj	vulkan'a'j
vulkanajn	vulkan'a'j'n
vulkanan	vulkan'a'n
vulkano	vulkan'o
vulkanoj	vulkan'o'j
vulkanojn	vulkan'o'j'n
vulkanon	vulkan'o'n
vulkanismo	vulkan'ism'o
vulpa	vulp'a
vulpo	vulp'o
vulpoj	vulp'o'j
vulpojn	vulp'o'j'n
vulpon	vulp'o'n
vulpino	vulp'in'o
vulturo	vultur'o
vulturoj	vultur'o'j
vulva	vulv'a
vulvaj	vulv'a'j
vulvo	vulv'o
vunda	vund'a
vundan	vund'a'n
vundas	vund'as
vundi	vund'i
vundis	vund'is
vundo	vund'o
vundoj	vund'o'j
vundojn	vund'o'j'n
vundon	vund'o'n
vundos	vund'os
vundu	vund'u
vundus	vund'us
vundado	vund'ad'o
vundante	vund'ant'e
vundebla	vund'ebl'a
vundeblaj	vund'ebl'a'j
vundeblajn	vund'ebl'a'j'n
vundeblan	vund'ebl'a'n
vundebleco	vund'ebl'ec'o
vundeblecoj	vund'ebl'ec'o'j
vundeblecojn	vund'ebl'ec'o'j'n
vundeblecon	vund'ebl'ec'o'n
vundeto	vund'et'o
vundetoj	vund'et'o'j
vundetojn	vund'et'o'j'n
vundiĝas	vund'iĝ'as
vundiĝi	vund'iĝ'i
vundiĝis	vund'iĝ'is
vundiĝo	vund'iĝ'o
vundiĝoj	vund'iĝ'o'j
vundiĝojn	vund'iĝ'o'j'n
vundiĝon	vund'iĝ'o'n
vundiĝu	vund'iĝ'u
vundita	vund'it'a
vunditaj	vund'it'a'j
vunditajn	vund'it'a'j'n
vunditan	vund'it'a'n
vundite	vund'it'e
vundito	vund'it'o
vunditoj	vund'it'o'j
vunditojn	vund'it'o'j'n
vunditon	vund'it'o'n