zagreba	zagreb'a
zagrebaj	zagreb'a'j
zagreban	zagreb'a'n
zagrebo	zagreb'o
zagrebon	zagreb'o'n
zagrebmetoda	zagreb'metod'a
zamenhofa	zamenhof'a
zamenhofaj	zamenhof'a'j
zamenhofajn	zamenhof'a'j'n
zamenhofan	zamenhof'a'n
zamenhofe	zamenhof'e
zamenhofo	zamenhof'o
zamenhofoj	zamenhof'o'j
zamenhofon	zamenhof'o'n
zamenhofaĵo	zamenhof'aĵ'o
zamenhofaĵoj	zamenhof'aĵ'o'j
zamenhofaĵon	zamenhof'aĵ'o'n
zamenhofano	zamenhof'an'o
zamenhofanoj	zamenhof'an'o'j
zamenhofbiografio	zamenhof'biograf'i'o
zamenhofbiografion	zamenhof'biograf'i'o'n
zamenhofcentro	zamenhof'centr'o
zamenhofcentron	zamenhof'centr'o'n
zamenhofeca	zamenhof'ec'a
zamenhofesperantoobjektoj	zamenhof'esperant'o'objekt'o'j
zamenhofesperantoobjektojn	zamenhof'esperant'o'objekt'o'j'n
zamenhoffamilio	zamenhof'famili'o
zamenhoffesto	zamenhof'fest'o
zamenhoffestoj	zamenhof'fest'o'j
zamenhoffeston	zamenhof'fest'o'n
zamenhofismo	zamenhof'ism'o
zamenhofjaro	zamenhof'jar'o
zamenhofjubilea	zamenhof'jubile'a
zamenhofkliniko	zamenhof'klinik'o
zamenhofmonumento	zamenhof'monument'o
zamenhofofesto	zamenhof'o'fest'o
zamenhofologo	zamenhof'olog'o
zamenhofologoj	zamenhof'olog'o'j
zamenhofologojn	zamenhof'olog'o'j'n
zamenhofologia	zamenhof'olog'i'a
zamenhofologiaj	zamenhof'olog'i'a'j
zamenhofologio	zamenhof'olog'i'o
zamenhofparko	zamenhof'park'o
zamenhofstatuo	zamenhof'statu'o
zamenhofstrato	zamenhof'strat'o
zamenhofstratoj	zamenhof'strat'o'j
zamenhoftaga	zamenhof'tag'a
zamenhoftago	zamenhof'tag'o
zamenhoftagoj	zamenhof'tag'o'j
zamenhoftagon	zamenhof'tag'o'n
zamenhoftrafikcirklo	zamenhof'trafik'cirkl'o
zaratuŝtra	zaratuŝtr'a
zaratuŝtraj	zaratuŝtr'a'j
zaratuŝtro	zaratuŝtr'o
zaratuŝtron	zaratuŝtr'o'n
zaratuŝtrisma	zaratuŝtr'ism'a
zaratuŝtrismo	zaratuŝtr'ism'o
zarzuela	zarzuel'a
zebra	zebr'a
zebraj	zebr'a'j
zebro	zebr'o
zebroj	zebr'o'j
zebrojn	zebr'o'j'n
zebron	zebr'o'n
zebranaso	zebr'anas'o
zebrofiŝo	zebr'o'fiŝ'o
zebrokolombo	zebr'o'kolomb'o
zebrokonkoj	zebr'o'konk'o'j
zebuo	zebu'o
zebuoj	zebu'o'j
zebuidoj	zebu'id'o'j
zefiro	zefir'o
zefiron	zefir'o'n
zelanda	zeland'a
zelando	zeland'o
zelandia	zeland'i'a
zelandio	zeland'i'o
zelota	zelot'a
zelotaj	zelot'a'j
zeloto	zelot'o
zelotoj	zelot'o'j
zelotojn	zelot'o'j'n
zelotismo	zelot'ism'o
zena	zen'a
zenan	zen'a'n
zeno	zen'o
zenbuddanoj	zen'budd'an'o'j
zendoktrino	zen'doktrin'o
zenĝardenoj	zen'ĝarden'o'j
zenĝardenon	zen'ĝarden'o'n
zeninstruistoj	zen'instru'ist'o'j
zenismo	zen'ism'o
zenisto	zen'ist'o
zenlernejo	zen'lern'ej'o
zenmajstro	zen'majstr'o
zenmajstroj	zen'majstr'o'j
zenmeditado	zen'medit'ad'o
zenmonaĥo	zen'monaĥ'o
zenmonaĥejoj	zen'monaĥ'ej'o'j
zenpastroj	zen'pastr'o'j
zenpraktiko	zen'praktik'o
zenpreĝo	zen'preĝ'o
zentajkostumoj	zen'taj'kostum'o'j
zentradicio	zen'tradici'o
zentrejnado	zen'trejn'ad'o
zenita	zenit'a
zenitaj	zenit'a'j
zenite	zenit'e
zenito	zenit'o
zenitoj	zenit'o'j
zeniton	zenit'o'n
zenono	zenon'o
zepelino	zepelin'o
zepelinoj	zepelin'o'j
zepelinon	zepelin'o'n
zeŭsa	zeŭs'a
zeŭsajn	zeŭs'a'j'n
zeŭsan	zeŭs'a'n
zeŭso	zeŭs'o
zeŭson	zeŭs'o'n
zibela	zibel'a
zibelaj	zibel'a'j
zibelo	zibel'o
zibeloj	zibel'o'j
zibelon	zibel'o'n
zibeto	zibet'o
zigurato	zigurat'o
ziguratoj	zigurat'o'j
zigzaga	zigzag'a
zigzagaj	zigzag'a'j
zigzagan	zigzag'a'n
zigzagas	zigzag'as
zigzage	zigzag'e
zigzagi	zigzag'i
zigzagis	zigzag'is
zigzago	zigzag'o
zigzagoj	zigzag'o'j
zigzagojn	zigzag'o'j'n
zigzagon	zigzag'o'n
zigzagado	zigzag'ad'o
zigzaganta	zigzag'ant'a
zigzagantajn	zigzag'ant'a'j'n
zigzagante	zigzag'ant'e
zigzagita	zigzag'it'a
zigzagkongrue	zigzag'kongru'e
zigzagrandoj	zigzag'rand'o'j
zigzagskemo	zigzag'skem'o
zimbabva	zimbabv'a
zimbabvaj	zimbabv'a'j
zimbabvan	zimbabv'a'n
zimbabve	zimbabv'e
zimbabvo	zimbabv'o
zimbabvon	zimbabv'o'n
zimbabvano	zimbabv'an'o
zimbabvanoj	zimbabv'an'o'j
zimbabvanojn	zimbabv'an'o'j'n
zimbalono	zimbalon'o
zimbalonoj	zimbalon'o'j
zingibra	zingibr'a
zingibraj	zingibr'a'j
zingibran	zingibr'a'n
zingibro	zingibr'o
zingibron	zingibr'o'n
zingibracoj	zingibr'ac'o'j
zingibrokuka	zingibr'o'kuk'a
zingibrokukan	zingibr'o'kuk'a'n
zingibrokuko	zingibr'o'kuk'o
zinka	zink'a
zinkaj	zink'a'j
zinkajn	zink'a'j'n
zinko	zink'o
zinkon	zink'o'n
zinkaeraj	zink'aer'a'j
zinkaldonoj	zink'al'don'o'j
zinkamalgamo	zink'amalgam'o
zinkanodo	zink'anod'o
zinkblendo	zink'blend'o
zinkelektrodo	zink'elektrod'o
zinkfingro	zink'fingr'o
zinkfingroj	zink'fingr'o'j
zinkfingrojn	zink'fingr'o'j'n
zinkita	zink'it'a
zinkkarbona	zink'karbon'a
zinkkarbonaj	zink'karbon'a'j
zinkkazo	zink'kaz'o
zinklada	zink'lad'a
zinkladoj	zink'lad'o'j
zinkmanko	zink'mank'o
zinkoklorido	zink'o'klorid'o
zinkomanko	zink'o'mank'o
zinkominejo	zink'o'min'ej'o
zinkoksido	zink'oksid'o
zinkoksidon	zink'oksid'o'n
zinksulfido	zink'sulfid'o
zinksuplementado	zink'suplement'ad'o
zinktegaĵo	zink'teg'aĵ'o
zipa	zip'a
zipi	zip'i
zipo	zip'o
zipoj	zip'o'j
zipojn	zip'o'j'n
zipon	zip'o'n
ziparkivo	zip'arkiv'o
ziparkivoj	zip'arkiv'o'j
zipdosiero	zip'dosier'o
zipdosierojn	zip'dosier'o'j'n
zipdosieron	zip'dosier'o'n
zipita	zip'it'a
zipitaj	zip'it'a'j
zipojuntojn	zip'o'junt'o'j'n
ziprasidono	ziprasidon'o
zirkonia	zirkoni'a
zirkoniaj	zirkoni'a'j
zirkonio	zirkoni'o
zirkoniodioksido	zirkoni'o'di'oksid'o
zirkoniohidrido	zirkoni'o'hidrid'o
zirkoniohidridoj	zirkoni'o'hidrid'o'j
zizelo	zizel'o
zizeloj	zizel'o'j
zizelon	zizel'o'n
zloto	zlot'o
zoa	zo'a
zoe	zo'e
zoo	zo'o
zooj	zo'o'j
zoojn	zo'o'j'n
zoon	zo'o'n
zobredado	zo'bred'ad'o
zoobestoj	zo'o'best'o'j
zoodirektoro	zo'o'direktor'o
zoofilio	zo'o'fili'o
zoofilion	zo'o'fili'o'n
zooĝardenoj	zo'o'ĝarden'o'j
zooĝardenon	zo'o'ĝarden'o'n
zoogeografiaj	zo'o'geograf'i'a'j
zoogeografio	zo'o'geograf'i'o
zooidoj	zo'o'id'o'j
zoolanda	zo'o'land'a
zoolandan	zo'o'land'a'n
zoolando	zo'o'land'o
zooparko	zo'o'park'o
zooplanktono	zo'o'plankton'o
zooplanktonoj	zo'o'plankton'o'j
zooplanktonon	zo'o'plankton'o'n
zoosporoj	zo'o'spor'o'j
zootropo	zo'o'trop'o
zoologo	zo'olog'o
zoologoj	zo'olog'o'j
zoologia	zo'olog'i'a
zoologiaj	zo'olog'i'a'j
zoologiajn	zo'olog'i'a'j'n
zoologian	zo'olog'i'a'n
zoologio	zo'olog'i'o
zoologion	zo'olog'i'o'n
zoologiejo	zo'olog'i'ej'o
zodiaka	zodiak'a
zodiakaj	zodiak'a'j
zodiakajn	zodiak'a'j'n
zodiakan	zodiak'a'n
zodiako	zodiak'o
zodiakon	zodiak'o'n
zodiaksigno	zodiak'sign'o
zodiaksignoj	zodiak'sign'o'j
zoharo	zohar'o
zomas	zom'as
zomi	zom'i
zomis	zom'is
zomo	zom'o
zomoj	zom'o'j
zomojn	zom'o'j'n
zomon	zom'o'n
zomado	zom'ad'o
zomite	zom'it'e
zomlensoj	zom'lens'o'j
zomnivelo	zom'nivel'o
zombia	zombi'a
zombio	zombi'o
zombioj	zombi'o'j
zombiojn	zombi'o'j'n
zombiigi	zombi'ig'i
zona	zon'a
zonaj	zon'a'j
zonajn	zon'a'j'n
zonan	zon'a'n
zonas	zon'as
zone	zon'e
zoni	zon'i
zonis	zon'is
zono	zon'o
zonoj	zon'o'j
zonojn	zon'o'j'n
zonon	zon'o'n
zonos	zon'os
zonu	zon'u
zonaro	zon'ar'o
zonata	zon'at'a
zonbluzo	zon'bluz'o
zonenplantaĵon	zon'en'plant'aĵ'o'n
zoneto	zon'et'o
zonetoj	zon'et'o'j
zoneton	zon'et'o'n
zonigo	zon'ig'o
zonigon	zon'ig'o'n
zoninte	zon'int'e
zoniston	zon'ist'o'n
zonita	zon'it'a
zonitaj	zon'it'a'j
zonitan	zon'it'a'n
zonite	zon'it'e
zonkontrolo	zon'kontrol'o
zonofanda	zon'o'fand'a
zonopluredro	zon'o'plur'edr'o
zonopluredroj	zon'o'plur'edr'o'j
zonoficojn	zon'ofic'o'j'n
zonplato	zon'plat'o
zonplatoj	zon'plat'o'j
zonsciigo	zon'sci'ig'o
zonsurfaco	zon'surfac'o
zontuko	zon'tuk'o
zontukoj	zon'tuk'o'j
zontukojn	zon'tuk'o'j'n
zontukon	zon'tuk'o'n
zonumita	zon'um'it'a
zonumitajn	zon'um'it'a'j'n
zonvosta	zon'vost'a
zooĥorio	zooĥori'o
zooĥorion	zooĥori'o'n
zoonozo	zoonoz'o
zorga	zorg'a
zorgaj	zorg'a'j
zorgajn	zorg'a'j'n
zorgan	zorg'a'n
zorgas	zorg'as
zorge	zorg'e
zorgi	zorg'i
zorgis	zorg'is
zorgo	zorg'o
zorgoj	zorg'o'j
zorgojn	zorg'o'j'n
zorgon	zorg'o'n
zorgos	zorg'os
zorgu	zorg'u
zorgus	zorg'us
zorgaĉas	zorg'aĉ'as
zorgadas	zorg'ad'as
zorgadi	zorg'ad'i
zorgadis	zorg'ad'is
zorgado	zorg'ad'o
zorgadon	zorg'ad'o'n
zorgaĵo	zorg'aĵ'o
zorgaĵon	zorg'aĵ'o'n
zorganta	zorg'ant'a
zorgantaj	zorg'ant'a'j
zorgante	zorg'ant'e
zorganto	zorg'ant'o
zorgantoj	zorg'ant'o'j
zorganton	zorg'ant'o'n
zorgata	zorg'at'a
zorgataj	zorg'at'a'j
zorgatajn	zorg'at'a'j'n
zorgate	zorg'at'e
zorgato	zorg'at'o
zorgatino	zorg'at'in'o
zorgatinon	zorg'at'in'o'n
zorgatakita	zorg'atak'it'a
zorgatakitaj	zorg'atak'it'a'j
zorgatakite	zorg'atak'it'e
zorgebla	zorg'ebl'a
zorgeco	zorg'ec'o
zorgegas	zorg'eg'as
zorgege	zorg'eg'e
zorgegis	zorg'eg'is
zorgegema	zorg'eg'em'a
zorgema	zorg'em'a
zorgemaj	zorg'em'a'j
zorgemajn	zorg'em'a'j'n
zorgeman	zorg'em'a'n
zorgemas	zorg'em'as
zorgeme	zorg'em'e
zorgemo	zorg'em'o
zorgemon	zorg'em'o'n
zorgemu	zorg'em'u
zorgiga	zorg'ig'a
zorgigaj	zorg'ig'a'j
zorgigas	zorg'ig'as
zorgige	zorg'ig'e
zorgigi	zorg'ig'i
zorgigis	zorg'ig'is
zorgigu	zorg'ig'u
zorgigita	zorg'ig'it'a
zorgigitaj	zorg'ig'it'a'j
zorgiĝas	zorg'iĝ'as
zorgiĝis	zorg'iĝ'is
zorgiĝon	zorg'iĝ'o'n
zorgilo	zorg'il'o
zorginda	zorg'ind'a
zorgindaj	zorg'ind'a'j
zorgindaĵoj	zorg'ind'aĵ'o'j
zorginta	zorg'int'a
zorginte	zorg'int'e
zorgisto	zorg'ist'o
zorgistoj	zorg'ist'o'j
zorgita	zorg'it'a
zorgitaj	zorg'it'a'j
zorgite	zorg'it'e
zorgoplena	zorg'o'plen'a
zorgoplenaj	zorg'o'plen'a'j
zorgoplenajn	zorg'o'plen'a'j'n
zorgoplenan	zorg'o'plen'a'n
zorgoplene	zorg'o'plen'e
zorgplena	zorg'plen'a
zorgplenaj	zorg'plen'a'j
zorgplenan	zorg'plen'a'n
zorgrobotan	zorg'robot'a'n
zorgrobotoj	zorg'robot'o'j
zorgumas	zorg'um'as
zorgumi	zorg'um'i
zorgumis	zorg'um'is
zorgumu	zorg'um'u
zorgumado	zorg'um'ad'o
zorgumigas	zorg'um'ig'as
zorioj	zori'o'j
zuavo	zuav'o
zulua	zulu'a
zuluaj	zulu'a'j
zuluan	zulu'a'n
zuluoj	zulu'o'j
zululando	zulu'land'o
zulutradicia	zulu'tradici'a
zuma	zum'a
zumaj	zum'a'j
zumajn	zum'a'j'n
zuman	zum'a'n
zumas	zum'as
zume	zum'e
zumi	zum'i
zumis	zum'is
zumo	zum'o
zumojn	zum'o'j'n
zumon	zum'o'n
zumos	zum'os
zumu	zum'u
zumadas	zum'ad'as
zumadis	zum'ad'is
zumado	zum'ad'o
zumadon	zum'ad'o'n
zumanta	zum'ant'a
zumantaj	zum'ant'a'j
zumantajn	zum'ant'a'j'n
zumantan	zum'ant'a'n
zumante	zum'ant'e
zumbicikloj	zum'bicikl'o'j
zumbuŝa	zum'buŝ'a
zumbuŝan	zum'buŝ'a'n
zumegas	zum'eg'as
zumilo	zum'il'o
zumiloj	zum'il'o'j
zumilon	zum'il'o'n
zumita	zum'it'a
zumkantas	zum'kant'as
zumkanti	zum'kant'i
zumkantis	zum'kant'is
zumkantankantikan	zum'kant'an'kantik'a'n
zumsono	zum'son'o
zumturbon	zum'turb'o'n
zumzumis	zum'zum'is