ĉada	ĉad'a
ĉado	ĉad'o
ĉadio	ĉad'i'o
ĉagrena	ĉagren'a
ĉagrenas	ĉagren'as
ĉagrene	ĉagren'e
ĉagreni	ĉagren'i
ĉagrenis	ĉagren'is
ĉagreno	ĉagren'o
ĉagrenoj	ĉagren'o'j
ĉagrenojn	ĉagren'o'j'n
ĉagrenon	ĉagren'o'n
ĉagrenu	ĉagren'u
ĉagreniĝas	ĉagren'iĝ'as
ĉagreniĝi	ĉagren'iĝ'i
ĉagreniĝis	ĉagren'iĝ'is
ĉagreniĝo	ĉagren'iĝ'o
ĉagreniĝon	ĉagren'iĝ'o'n
ĉagreniĝu	ĉagren'iĝ'u
ĉagrenita	ĉagren'it'a
ĉagrenitaj	ĉagren'it'a'j
ĉagrenite	ĉagren'it'e
ĉaka	ĉak'a
ĉako	ĉak'o
ĉakro	ĉakr'o
ĉamo	ĉam'o
ĉambelano	ĉambelan'o
ĉambra	ĉambr'a
ĉambraj	ĉambr'a'j
ĉambran	ĉambr'a'n
ĉambro	ĉambr'o
ĉambroj	ĉambr'o'j
ĉambrojn	ĉambr'o'j'n
ĉambron	ĉambr'o'n
ĉambraro	ĉambr'ar'o
ĉambrego	ĉambr'eg'o
ĉambregoj	ĉambr'eg'o'j
ĉambregon	ĉambr'eg'o'n
ĉambreto	ĉambr'et'o
ĉambretoj	ĉambr'et'o'j
ĉambreton	ĉambr'et'o'n
ĉambristo	ĉambr'ist'o
ĉambristoj	ĉambr'ist'o'j
ĉambristino	ĉambr'ist'in'o
ĉambristinon	ĉambr'ist'in'o'n
ĉambrohejtado	ĉambr'o'hejt'ad'o
ĉambromuzikaj	ĉambr'o'muzik'a'j
ĉambromuziko	ĉambr'o'muzik'o
ĉambroplanto	ĉambr'o'plant'o
ĉambroplantoj	ĉambr'o'plant'o'j
ĉampano	ĉampan'o
ĉampanon	ĉampan'o'n
ĉampiono	ĉampion'o
ĉampionoj	ĉampion'o'j
ĉampionojn	ĉampion'o'j'n
ĉampionon	ĉampion'o'n
ĉampionado	ĉampion'ad'o
ĉampionadon	ĉampion'ad'o'n
ĉampioneco	ĉampion'ec'o
ĉampionecoj	ĉampion'ec'o'j
ĉampionecojn	ĉampion'ec'o'j'n
ĉampionecon	ĉampion'ec'o'n
ĉampioniĝis	ĉampion'iĝ'is
ĉampionino	ĉampion'in'o
ĉanon	ĉan'o'n
ĉantaĝas	ĉantaĝ'as
ĉantaĝi	ĉantaĝ'i
ĉantaĝis	ĉantaĝ'is
ĉantaĝo	ĉantaĝ'o
ĉantaĝoj	ĉantaĝ'o'j
ĉapo	ĉap'o
ĉapoj	ĉap'o'j
ĉapojn	ĉap'o'j'n
ĉapon	ĉap'o'n
ĉapeto	ĉap'et'o
ĉapeton	ĉap'et'o'n
ĉapela	ĉapel'a
ĉapelo	ĉapel'o
ĉapeloj	ĉapel'o'j
ĉapelojn	ĉapel'o'j'n
ĉapelon	ĉapel'o'n
ĉapelilo	ĉapel'il'o
ĉapelisto	ĉapel'ist'o
ĉapelitaj	ĉapel'it'a'j
ĉapelitajn	ĉapel'it'a'j'n
ĉapitro	ĉapitr'o
ĉapitroj	ĉapitr'o'j
ĉapitrojn	ĉapitr'o'j'n
ĉapitron	ĉapitr'o'n
ĉar	ĉar
ĉara	ĉar'a
ĉaro	ĉar'o
ĉaroj	ĉar'o'j
ĉarojn	ĉar'o'j'n
ĉaron	ĉar'o'n
ĉarego	ĉar'eg'o
ĉaregon	ĉar'eg'o'n
ĉareto	ĉar'et'o
ĉaretoj	ĉar'et'o'j
ĉareton	ĉar'et'o'n
ĉaristo	ĉar'ist'o
ĉarumo	ĉar'um'o
ĉarlatano	ĉarlatan'o
ĉarlatanoj	ĉarlatan'o'j
ĉarlatanaĵo	ĉarlatan'aĵ'o
ĉarma	ĉarm'a
ĉarmaj	ĉarm'a'j
ĉarmajn	ĉarm'a'j'n
ĉarman	ĉarm'a'n
ĉarmas	ĉarm'as
ĉarme	ĉarm'e
ĉarmi	ĉarm'i
ĉarmis	ĉarm'is
ĉarmo	ĉarm'o
ĉarmoj	ĉarm'o'j
ĉarmojn	ĉarm'o'j'n
ĉarmon	ĉarm'o'n
ĉarmeco	ĉarm'ec'o
ĉarmecon	ĉarm'ec'o'n
ĉarmega	ĉarm'eg'a
ĉarmegaj	ĉarm'eg'a'j
ĉarmita	ĉarm'it'a
ĉarniras	ĉarnir'as
ĉarniro	ĉarnir'o
ĉarniroj	ĉarnir'o'j
ĉarnirumitaj	ĉarnir'um'it'a'j
ĉarpentado	ĉarpent'ad'o
ĉarpentisto	ĉarpent'ist'o
ĉarpentistoj	ĉarpent'ist'o'j
ĉarto	ĉart'o
ĉartoj	ĉart'o'j
ĉartojn	ĉart'o'j'n
ĉarton	ĉart'o'n
ĉasa	ĉas'a
ĉasaj	ĉas'a'j
ĉasas	ĉas'as
ĉasi	ĉas'i
ĉasis	ĉas'is
ĉaso	ĉas'o
ĉasoj	ĉas'o'j
ĉason	ĉas'o'n
ĉasos	ĉas'os
ĉasadi	ĉas'ad'i
ĉasadis	ĉas'ad'is
ĉasado	ĉas'ad'o
ĉasadoj	ĉas'ad'o'j
ĉasadon	ĉas'ad'o'n
ĉasaĵo	ĉas'aĵ'o
ĉasaĵon	ĉas'aĵ'o'n
ĉasanta	ĉas'ant'a
ĉasantaj	ĉas'ant'a'j
ĉasante	ĉas'ant'e
ĉasanto	ĉas'ant'o
ĉasantoj	ĉas'ant'o'j
ĉasata	ĉas'at'a
ĉasataj	ĉas'at'a'j
ĉasaviadilo	ĉas'aviad'il'o
ĉasaviadiloj	ĉas'aviad'il'o'j
ĉasbestoj	ĉas'best'o'j
ĉasbirdoj	ĉas'bird'o'j
ĉasejo	ĉas'ej'o
ĉasestro	ĉas'estr'o
ĉashundo	ĉas'hund'o
ĉashundoj	ĉas'hund'o'j
ĉasista	ĉas'ist'a
ĉasisto	ĉas'ist'o
ĉasistoj	ĉas'ist'o'j
ĉasistojn	ĉas'ist'o'j'n
ĉasiston	ĉas'ist'o'n
ĉasistino	ĉas'ist'in'o
ĉasistojkolektistoj	ĉas'ist'oj'kolekt'ist'o'j
ĉasita	ĉas'it'a
ĉasitaj	ĉas'it'a'j
ĉaskaptistoj	ĉas'kapt'ist'o'j
ĉaspafiloj	ĉas'paf'il'o'j
ĉasputoroj	ĉas'putor'o'j
ĉastranĉilo	ĉas'tranĉ'il'o
ĉasio	ĉasi'o
ĉasioj	ĉasi'o'j
ĉasion	ĉasi'o'n
ĉasta	ĉast'a
ĉastaj	ĉast'a'j
ĉasteco	ĉast'ec'o
ĉastecon	ĉast'ec'o'n
ĉatnio	ĉatni'o
ĉe	ĉe
ĉea	ĉe'a
ĉeantarktaj	ĉe'antarkt'a'j
ĉebaze	ĉe'baz'e
ĉeborda	ĉe'bord'a
ĉebordaj	ĉe'bord'a'j
ĉeesta	ĉe'est'a
ĉeestaj	ĉe'est'a'j
ĉeestajn	ĉe'est'a'j'n
ĉeestan	ĉe'est'a'n
ĉeestas	ĉe'est'as
ĉestas	ĉe'est'as
ĉeeste	ĉe'est'e
ĉeesti	ĉe'est'i
ĉeestis	ĉe'est'is
ĉeesto	ĉe'est'o
ĉeeston	ĉe'est'o'n
ĉeestos	ĉe'est'os
ĉeestu	ĉe'est'u
ĉeestus	ĉe'est'us
ĉeestado	ĉe'est'ad'o
ĉeestanta	ĉe'est'ant'a
ĉeestantaj	ĉe'est'ant'a'j
ĉeestantajn	ĉe'est'ant'a'j'n
ĉeestantan	ĉe'est'ant'a'n
ĉeestante	ĉe'est'ant'e
ĉeestanto	ĉe'est'ant'o
ĉeestantoj	ĉe'est'ant'o'j
ĉeestantojn	ĉe'est'ant'o'j'n
ĉeestantaro	ĉe'est'ant'ar'o
ĉeestantaron	ĉe'est'ant'ar'o'n
ĉeestintaj	ĉe'est'int'a'j
ĉeestinto	ĉe'est'int'o
ĉeestintoj	ĉe'est'int'o'j
ĉeflanke	ĉe'flank'e
ĉehavas	ĉe'hav'as
ĉehejme	ĉe'hejm'e
ĉekape	ĉe'kap'e
ĉelimaj	ĉe'lim'a'j
ĉeloka	ĉe'lok'a
ĉelokan	ĉe'lok'a'n
ĉeloke	ĉe'lok'e
ĉemane	ĉe'man'e
ĉemara	ĉe'mar'a
ĉemaraj	ĉe'mar'a'j
ĉemare	ĉe'mar'e
ĉemetaĵo	ĉe'met'aĵ'o
ĉemetaĵoj	ĉe'met'aĵ'o'j
ĉemetita	ĉe'met'it'a
ĉemetitaj	ĉe'met'it'a'j
ĉeneste	ĉe'nest'e
ĉeokaze	ĉe'okaz'e
ĉepiede	ĉe'pied'e
ĉepinte	ĉe'pint'e
ĉerande	ĉe'rand'e
ĉerivera	ĉe'river'a
ĉeriveraj	ĉe'river'a'j
ĉetable	ĉe'tabl'e
ĉeurbaj	ĉe'urb'a'j
ĉeĉena	ĉeĉen'a
ĉeĉenaj	ĉeĉen'a'j
ĉeĉeno	ĉeĉen'o
ĉeĉenoj	ĉeĉen'o'j
ĉeĉenia	ĉeĉen'i'a
ĉeĉenio	ĉeĉen'i'o
ĉefa	ĉef'a
ĉefaj	ĉef'a'j
ĉefajn	ĉef'a'j'n
ĉefan	ĉef'a'n
ĉefas	ĉef'as
ĉefe	ĉef'e
ĉefis	ĉef'is
ĉefo	ĉef'o
ĉefoj	ĉef'o'j
ĉefojn	ĉef'o'j'n
ĉefon	ĉef'o'n
ĉefaĵo	ĉef'aĵ'o
ĉefaĵoj	ĉef'aĵ'o'j
ĉefakso	ĉef'aks'o
ĉefaktivulo	ĉef'aktiv'ul'o
ĉefaltara	ĉef'altar'a
ĉefaltaro	ĉef'altar'o
ĉefanĝelo	ĉef'anĝel'o
ĉefapogilo	ĉef'apog'il'o
ĉefargumento	ĉef'argument'o
ĉefarkitekto	ĉef'arkitekt'o
ĉefartikolo	ĉef'artikol'o
ĉefartikoloj	ĉef'artikol'o'j
ĉefartikolon	ĉef'artikol'o'n
ĉefavantaĝo	ĉef'avantaĝ'o
ĉefavantaĝoj	ĉef'avantaĝ'o'j
ĉefbiblioteko	ĉef'bibliotek'o
ĉefĉambro	ĉef'ĉambr'o
ĉefcelo	ĉef'cel'o
ĉefceloj	ĉef'cel'o'j
ĉefcelebranto	ĉef'celebr'ant'o
ĉefdelegito	ĉef'deleg'it'o
ĉefdio	ĉef'di'o
ĉefdiferenco	ĉef'diferenc'o
ĉefdiferencoj	ĉef'diferenc'o'j
ĉefdiocezo	ĉef'diocez'o
ĉefdirektilisto	ĉef'direkt'il'ist'o
ĉefdirektoro	ĉef'direktor'o
ĉefdomo	ĉef'dom'o
ĉefeco	ĉef'ec'o
ĉefekzemplo	ĉef'ekzempl'o
ĉefelemento	ĉef'element'o
ĉefenirejo	ĉef'en'ir'ej'o
ĉefepiskopa	ĉef'episkop'a
ĉefepiskopo	ĉef'episkop'o
ĉefepiskopoj	ĉef'episkop'o'j
ĉefepiskopon	ĉef'episkop'o'n
ĉefepiskopejo	ĉef'episkop'ej'o
ĉefepiskopujo	ĉef'episkop'uj'o
ĉefestro	ĉef'estr'o
ĉefestraro	ĉef'estr'ar'o
ĉeffako	ĉef'fak'o
ĉeffaktoro	ĉef'faktor'o
ĉeffaktoroj	ĉef'faktor'o'j
ĉeffiguro	ĉef'figur'o
ĉeffiguroj	ĉef'figur'o'j
ĉefflua	ĉef'flu'a
ĉeffluo	ĉef'flu'o
ĉeffokuso	ĉef'fokus'o
ĉeffonto	ĉef'font'o
ĉeffontoj	ĉef'font'o'j
ĉeffonton	ĉef'font'o'n
ĉeffrazo	ĉef'fraz'o
ĉeffrazoj	ĉef'fraz'o'j
ĉeffunkcio	ĉef'funkci'o
ĉefgrandurbo	ĉef'grand'urb'o
ĉefgvidanto	ĉef'gvid'ant'o
ĉefgvidantoj	ĉef'gvid'ant'o'j
ĉefideo	ĉef'ide'o
ĉefino	ĉef'in'o
ĉefinĝeniero	ĉef'inĝenier'o
ĉefinstruisto	ĉef'instru'ist'o
ĉefinsulo	ĉef'insul'o
ĉefita	ĉef'it'a
ĉefjuĝisto	ĉef'juĝ'ist'o
ĉefkampuso	ĉef'kampus'o
ĉefkandidatoj	ĉef'kandidat'o'j
ĉefkantisto	ĉef'kant'ist'o
ĉefkialo	ĉef'kial'o
ĉefkialoj	ĉef'kial'o'j
ĉefkomando	ĉef'komand'o
ĉefkomandanto	ĉef'komand'ant'o
ĉefkomponento	ĉef'kompon'ant'o
ĉefkomponentoj	ĉef'kompon'ant'o'j
ĉefkomunikiloj	ĉef'komunik'il'o'j
ĉefkonduktilo	ĉef'kondukt'il'o
ĉefkonduktiloj	ĉef'kondukt'il'o'j
ĉefkonstruaĵo	ĉef'konstru'aĵ'o
ĉefkuiristo	ĉef'kuir'ist'o
ĉefkunveno	ĉef'kun'ven'o
ĉefkuracisto	ĉef'kurac'ist'o
ĉeflando	ĉef'land'o
ĉeflingvo	ĉef'lingv'o
ĉeflinio	ĉef'lini'o
ĉeflitero	ĉef'liter'o
ĉefloko	ĉef'lok'o
ĉefmalavantaĝo	ĉef'mal'avantaĝ'o
ĉefmanaĝero	ĉef'manaĝer'o
ĉefmanĝo	ĉef'manĝ'o
ĉefmanĝon	ĉef'manĝ'o'n
ĉefmanĝaĵo	ĉef'manĝ'aĵ'o
ĉefmemoro	ĉef'memor'o
ĉefministra	ĉef'ministr'a
ĉefministro	ĉef'ministr'o
ĉefministroj	ĉef'ministr'o'j
ĉefministrojn	ĉef'ministr'o'j'n
ĉefministron	ĉef'ministr'o'n
ĉefministrejo	ĉef'ministr'ej'o
ĉefministrino	ĉef'ministr'in'o
ĉefmotoro	ĉef'motor'o
ĉefnavo	ĉef'nav'o
ĉefoficejo	ĉef'ofic'ej'o
ĉefoficisto	ĉef'ofic'ist'o
ĉefoficistoj	ĉef'ofic'ist'o'j
ĉefoficiston	ĉef'ofic'ist'o'n
ĉefoficulo	ĉef'ofic'ul'o
ĉeforgano	ĉef'organ'o
ĉefornamaĵo	ĉef'ornam'aĵ'o
ĉefpaĝo	ĉef'paĝ'o
ĉefparto	ĉef'part'o
ĉefpartoj	ĉef'part'o'j
ĉefparton	ĉef'part'o'n
ĉefpastro	ĉef'pastr'o
ĉefpastroj	ĉef'pastr'o'j
ĉefpastrino	ĉef'pastr'in'o
ĉefplaco	ĉef'plac'o
ĉefplado	ĉef'plad'o
ĉefpolicisto	ĉef'polic'ist'o
ĉefpolicistoj	ĉef'polic'ist'o'j
ĉefpordo	ĉef'pord'o
ĉefpordego	ĉef'pord'eg'o
ĉefpreĝejo	ĉef'preĝ'ej'o
ĉefpremion	ĉef'premi'o'n
ĉefprezidanto	ĉef'prezid'ant'o
ĉefprincipo	ĉef'princip'o
ĉefprincipoj	ĉef'princip'o'j
ĉefprincipojn	ĉef'princip'o'j'n
ĉefprioritato	ĉef'prioritat'o
ĉefproblemo	ĉef'problem'o
ĉefpropozicio	ĉef'propozici'o
ĉefpropozicioj	ĉef'propozici'o'j
ĉefpunkto	ĉef'punkt'o
ĉefpunktoj	ĉef'punkt'o'j
ĉefpunktojn	ĉef'punkt'o'j'n
ĉefrakonto	ĉef'rakont'o
ĉefranga	ĉef'rang'a
ĉefredaktisto	ĉef'redakt'ist'o
ĉefredaktoro	ĉef'redaktor'o
ĉefrespondeca	ĉef'respond'ec'a
ĉefrimedoj	ĉef'rimed'o'j
ĉefrola	ĉef'rol'a
ĉefrolas	ĉef'rol'as
ĉefroli	ĉef'rol'i
ĉefrolis	ĉef'rol'is
ĉefrolo	ĉef'rol'o
ĉefrolon	ĉef'rol'o'n
ĉefrolanto	ĉef'rol'ant'o
ĉefroligis	ĉef'rol'ig'is
ĉefrolulo	ĉef'rol'ul'o
ĉefroluloj	ĉef'rol'ul'o'j
ĉefrolulon	ĉef'rol'ul'o'n
ĉefrolulino	ĉef'rol'ul'in'o
ĉefservisto	ĉef'serv'ist'o
ĉefsidejis	ĉef'sid'ej'is
ĉefsidejo	ĉef'sid'ej'o
ĉefsidejon	ĉef'sid'ej'o'n
ĉefsidejita	ĉef'sid'ej'it'a
ĉefsidejitaj	ĉef'sid'ej'it'a'j
ĉefŝoseo	ĉef'ŝose'o
ĉefŝoseoj	ĉef'ŝose'o'j
ĉefstabejo	ĉef'stab'ej'o
ĉefstacidomo	ĉef'staci'dom'o
ĉefstrato	ĉef'strat'o
ĉefstratoj	ĉef'strat'o'j
ĉeftabulo	ĉef'tabul'o
ĉeftasko	ĉef'task'o
ĉefteksto	ĉef'tekst'o
ĉeftemo	ĉef'tem'o
ĉeftemoj	ĉef'tem'o'j
ĉeftemojn	ĉef'tem'o'j'n
ĉeftemon	ĉef'tem'o'n
ĉeftendenca	ĉef'tendenc'a
ĉeftendencaj	ĉef'tendenc'a'j
ĉeftendenco	ĉef'tendenc'o
ĉeftendencon	ĉef'tendenc'o'n
ĉeftera	ĉef'ter'a
ĉefteraj	ĉef'ter'a'j
ĉeftero	ĉef'ter'o
ĉeftipoj	ĉef'tip'o'j
ĉeftipojn	ĉef'tip'o'j'n
ĉeftrajto	ĉef'trajt'o
ĉeftrajtoj	ĉef'trajt'o'j
ĉeftrejnisto	ĉef'trejn'ist'o
ĉeftrupo	ĉef'trup'o
ĉefturo	ĉef'tur'o
ĉefulo	ĉef'ul'o
ĉefurba	ĉef'urb'a
ĉefurbo	ĉef'urb'o
ĉefurboj	ĉef'urb'o'j
ĉefurbojn	ĉef'urb'o'j'n
ĉefurbon	ĉef'urb'o'n
ĉefurbestro	ĉef'urb'estr'o
ĉefuzo	ĉef'uz'o
ĉefverbo	ĉef'verb'o
ĉefverboj	ĉef'verb'o'j
ĉefverbon	ĉef'verb'o'n
ĉefverko	ĉef'verk'o
ĉefverkoj	ĉef'verk'o'j
ĉefverkojn	ĉef'verk'o'j'n
ĉefverkon	ĉef'verk'o'n
ĉefvojo	ĉef'voj'o
ĉefvojoj	ĉef'voj'o'j
ĉefvojon	ĉef'voj'o'n
ĉefvorto	ĉef'vort'o
ĉefvorton	ĉef'vort'o'n
ĉefzorgo	ĉef'zorg'o
ĉeha	ĉeĥ'a
ĉeĥa	ĉeĥ'a
ĉeĥaj	ĉeĥ'a'j
ĉeĥajn	ĉeĥ'a'j'n
ĉeĥan	ĉeĥ'a'n
ĉeĥe	ĉeĥ'e
ĉeĥo	ĉeĥ'o
ĉeĥoj	ĉeĥ'o'j
ĉeĥio	ĉeĥ'i'o
ĉeĥlingva	ĉeĥ'lingv'a
ĉeĥoslovaka	ĉeĥ'o'slovak'a
ĉeĥoslovakaj	ĉeĥ'o'slovak'a'j
ĉeĥoslovakio	ĉeĥ'o'slovak'i'o
ĉeĥoslovakion	ĉeĥ'o'slovak'i'o'n
ĉeĥoslovakujo	ĉeĥ'o'slovak'uj'o
ĉeĥujo	ĉeĥ'uj'o
ĉeko	ĉek'o
ĉekoj	ĉek'o'j
ĉekojn	ĉek'o'j'n
ĉekon	ĉek'o'n
ĉela	ĉel'a
ĉelaj	ĉel'a'j
ĉelajn	ĉel'a'j'n
ĉelan	ĉel'a'n
ĉelo	ĉel'o
ĉeloj	ĉel'o'j
ĉelojn	ĉel'o'j'n
ĉelon	ĉel'o'n
ĉelaro	ĉel'ar'o
ĉelbiologio	ĉel'biologi'o
ĉelciklo	ĉel'cikl'o
ĉeldividiĝo	ĉel'divid'iĝ'o
ĉelkerno	ĉel'kern'o
ĉelkorpo	ĉel'korp'o
ĉelkulturo	ĉel'kultur'o
ĉelmembrano	ĉel'membran'o
ĉelmembranoj	ĉel'membran'o'j
ĉelmembranon	ĉel'membran'o'n
ĉelmorto	ĉel'mort'o
ĉelmorton	ĉel'mort'o'n
ĉelmuroj	ĉel'mur'o'j
ĉelskeleto	ĉel'skelet'o
ĉelsurfaco	ĉel'surfac'o
ĉelterapio	ĉel'terapi'o
ĉeltipo	ĉel'tip'o
ĉeltipoj	ĉel'tip'o'j
ĉeltipojn	ĉel'tip'o'j'n
ĉelunuo	ĉel'unu'o
ĉemizo	ĉemiz'o
ĉemizoj	ĉemiz'o'j
ĉemizojn	ĉemiz'o'j'n
ĉemizon	ĉemiz'o'n
ĉena	ĉen'a
ĉenan	ĉen'a'n
ĉene	ĉen'e
ĉenis	ĉen'is
ĉeno	ĉen'o
ĉenoj	ĉen'o'j
ĉenojn	ĉen'o'j'n
ĉenon	ĉen'o'n
ĉenero	ĉen'er'o
ĉeneroj	ĉen'er'o'j
ĉenerojn	ĉen'er'o'j'n
ĉeneto	ĉen'et'o
ĉeneton	ĉen'et'o'n
ĉenita	ĉen'it'a
ĉenitaj	ĉen'it'a'j
ĉenreakcio	ĉen'reakci'o
ĉenreakcion	ĉen'reakci'o'n
ĉenstablo	ĉen'stabl'o
ĉenajo	ĉenaj'o
ĉeriza	ĉeriz'a
ĉerizaj	ĉeriz'a'j
ĉerizan	ĉeriz'a'n
ĉerizo	ĉeriz'o
ĉerizoj	ĉeriz'o'j
ĉerizojn	ĉeriz'o'j'n
ĉerizon	ĉeriz'o'n
ĉerizarbo	ĉeriz'arb'o
ĉerizarboj	ĉeriz'arb'o'j
ĉerizarbojn	ĉeriz'arb'o'j'n
ĉerizujo	ĉeriz'uj'o
ĉerizujoj	ĉeriz'uj'o'j
ĉerko	ĉerk'o
ĉerkoj	ĉerk'o'j
ĉerkojn	ĉerk'o'j'n
ĉerkon	ĉerk'o'n
ĉerkejoj	ĉerk'ej'o'j
ĉerkisto	ĉerk'ist'o
ĉerokea	ĉerok'a
ĉeroko	ĉerok'o
ĉerokoj	ĉerok'o'j
ĉerpas	ĉerp'as
ĉerpi	ĉerp'i
ĉerpis	ĉerp'is
ĉerpos	ĉerp'os
ĉerpu	ĉerp'u
ĉerpante	ĉerp'ant'e
ĉerpilo	ĉerp'il'o
ĉerpita	ĉerp'it'a
ĉerpitaj	ĉerp'it'a'j
ĉesas	ĉes'as
ĉesi	ĉes'i
ĉesis	ĉes'is
ĉeso	ĉes'o
ĉesos	ĉes'os
ĉesu	ĉes'u
ĉesus	ĉes'us
ĉesado	ĉes'ad'o
ĉesanta	ĉes'ant'a
ĉesante	ĉes'ant'e
ĉesigas	ĉes'ig'as
ĉesigi	ĉes'ig'i
ĉesigis	ĉes'ig'is
ĉesigo	ĉes'ig'o
ĉesigoj	ĉes'ig'o'j
ĉesigon	ĉes'ig'o'n
ĉesigos	ĉes'ig'os
ĉesigu	ĉes'ig'u
ĉesigus	ĉes'ig'us
ĉesigado	ĉes'ig'ad'o
ĉesigante	ĉes'ig'ant'e
ĉesigita	ĉes'ig'it'a
ĉesigitaj	ĉes'ig'it'a'j
ĉesiĝis	ĉes'iĝ'is
ĉesinta	ĉes'int'a
ĉesinte	ĉes'int'e
ĉevala	ĉeval'a
ĉevalaj	ĉeval'a'j
ĉevalan	ĉeval'a'n
ĉevale	ĉeval'e
ĉevalo	ĉeval'o
ĉevaloj	ĉeval'o'j
ĉevalojn	ĉeval'o'j'n
ĉevalon	ĉeval'o'n
ĉevalaĉo	ĉeval'aĉ'o
ĉevalaĵo	ĉeval'aĵ'o
ĉevalaĵon	ĉeval'aĵ'o'n
ĉevalaro	ĉeval'ar'o
ĉevalĉaro	ĉeval'ĉar'o
ĉevaldorso	ĉeval'dors'o
ĉevalejo	ĉeval'ej'o
ĉevalejoj	ĉeval'ej'o'j
ĉevaleto	ĉeval'et'o
ĉevaleton	ĉeval'et'o'n
ĉevalido	ĉeval'id'o
ĉevalidoj	ĉeval'id'o'j
ĉevalino	ĉeval'in'o
ĉevalinoj	ĉeval'in'o'j
ĉevalinojn	ĉeval'in'o'j'n
ĉevalinon	ĉeval'in'o'n
ĉevalistoj	ĉeval'ist'o'j
ĉevalkonkurso	ĉeval'konkurs'o
ĉevalrajdado	ĉeval'rajd'ad'o
ĉevalvetkuro	ĉeval'vet'kur'o
ĉi	ĉi
ĉia	ĉi'a
ĉiaj	ĉi'a'j
ĉiajn	ĉi'a'j'n
ĉian	ĉi'a'n
ĉio	ĉi'o
ĉion	ĉi'o'n
ĉitie	ĉi'tie
ĉitio	ĉi'tio
ĉitiu	ĉi'tiu
ĉiakaze	ĉi'a'kaz'e
ĉiakoste	ĉi'a'kost'e
ĉiamaniere	ĉi'a'manier'e
ĉiaokaze	ĉi'a'okaz'e
ĉiapreze	ĉi'a'prez'e
ĉiaspeca	ĉi'a'spec'a
ĉiaspecaj	ĉi'a'spec'a'j
ĉiaspecajn	ĉi'a'spec'a'j'n
ĉiantaŭaj	ĉi'antaŭ'a'j
ĉiantaŭe	ĉi'antaŭ'e
ĉiapude	ĉi'apud'e
ĉiaŭtune	ĉi'aŭtun'e
ĉicele	ĉi'cel'e
ĉiĉirkaŭe	ĉi'ĉirkaŭ'e
ĉiene	ĉi'en'e
ĉiepoke	ĉi'epok'e
ĉiflanka	ĉi'flank'a
ĉiflanke	ĉi'flank'e
ĉifoja	ĉi'foj'a
ĉifojan	ĉi'foj'a'n
ĉifoje	ĉi'foj'e
ĉihore	ĉi'hor'e
ĉijara	ĉi'jar'a
ĉijaraj	ĉi'jar'a'j
ĉijaran	ĉi'jar'a'n
ĉijare	ĉi'jar'e
ĉikampe	ĉi'kamp'e
ĉikaze	ĉi'kaz'e
ĉikomponaĵo	ĉi'kompon'aĵ'o
ĉikoncerne	ĉi'koncern'e
ĉikuntekste	ĉi'kun'tekst'e
ĉilande	ĉi'land'e
ĉilasta	ĉi'last'a
ĉilastaj	ĉi'last'a'j
ĉilastajn	ĉi'last'a'j'n
ĉilastan	ĉi'last'a'n
ĉiloke	ĉi'lok'e
ĉimaniere	ĉi'manier'e
ĉimatena	ĉi'maten'a
ĉimatene	ĉi'maten'e
ĉimetodo	ĉi'metod'o
ĉimomente	ĉi'moment'e
ĉimonate	ĉi'monat'e
ĉimonda	ĉi'mond'a
ĉinokte	ĉi'nokt'e
ĉioĉi	ĉi'o'ĉi
ĉioampleksa	ĉi'o'ampleks'a
ĉiokaze	ĉi'o'kaz'e
ĉiomanĝantaj	ĉi'o'manĝ'ant'a'j
ĉionpovaj	ĉi'o'n'pov'a'j
ĉiopotenca	ĉi'o'potenc'a
ĉiopova	ĉi'o'pov'a
ĉiopovaj	ĉi'o'pov'a'j
ĉiopovan	ĉi'o'pov'a'n
ĉiopovo	ĉi'o'pov'o
ĉiopovon	ĉi'o'pov'o'n
ĉiopoveco	ĉi'o'pov'ec'o
ĉioscia	ĉi'o'sci'a
ĉiosciaj	ĉi'o'sci'a'j
ĉiovendejo	ĉi'o'vend'ej'o
ĉiovora	ĉi'o'vor'a
ĉipaĝe	ĉi'paĝ'e
ĉipere	ĉi'per'e
ĉiposte	ĉi'post'e
ĉiposttagmeze	ĉi'post'tag'mez'e
ĉiprintempe	ĉi'printemp'e
ĉiproksime	ĉi'proksim'e
ĉipunkte	ĉi'punkt'e
ĉireakcio	ĉi'reakci'o
ĉirilata	ĉi'rilat'a
ĉirilataj	ĉi'rilat'a'j
ĉirilatan	ĉi'rilat'a'n
ĉirilate	ĉi'rilat'e
ĉisemajne	ĉi'semajn'e
ĉisemajnfine	ĉi'semajn'fin'e
ĉisemajnofine	ĉi'semajn'o'fin'e
ĉisence	ĉi'senc'e
ĉisomere	ĉi'somer'e
ĉisuba	ĉi'sub'a
ĉisubaj	ĉi'sub'a'j
ĉisuban	ĉi'sub'a'n
ĉisube	ĉi'sub'e
ĉisubstanco	ĉi'substanc'o
ĉisupra	ĉi'supr'a
ĉisupraj	ĉi'supr'a'j
ĉisuprajn	ĉi'supr'a'j'n
ĉisupran	ĉi'supr'a'n
ĉisupre	ĉi'supr'e
ĉitage	ĉi'tag'e
ĉitema	ĉi'tem'a
ĉiteme	ĉi'tem'e
ĉitempe	ĉi'temp'e
ĉitiea	ĉi'tie'a
ĉitieaj	ĉi'tie'a'j
ĉitien	ĉi'tie'n
ĉition	ĉi'tio'n
ĉitiuj	ĉi'tiu'j
ĉitiujn	ĉi'tiu'jn
ĉitiun	ĉi'tiu'n
ĉivespera	ĉi'vesper'a
ĉivespere	ĉi'vesper'e
ĉivintre	ĉi'vintr'e
ĉial	ĉial
ĉiam	ĉiam
ĉiama	ĉiam'a
ĉiamaj	ĉiam'a'j
ĉiaman	ĉiam'a'n
ĉiame	ĉiam'e
ĉiamdaŭra	ĉiam'daŭr'a
ĉiamverda	ĉiam'verd'a
ĉiamverdaj	ĉiam'verd'a'j
ĉiĉeronis	ĉiĉeron'is
ĉiĉerono	ĉiĉeron'o
ĉiĉeronoj	ĉiĉeron'o'j
ĉiĉeronon	ĉiĉeron'o'n
ĉiĉeronado	ĉiĉeron'ad'o
ĉiĉio	ĉiĉi'o
ĉie	ĉie
ĉiea	ĉie'a
ĉieaj	ĉie'a'j
ĉieajn	ĉie'a'j'n
ĉiean	ĉie'a'n
ĉiee	ĉie'e
ĉien	ĉie'n
ĉieeco	ĉie'ec'o
ĉiel	ĉiel
ĉiela	ĉiel'a
ĉielaj	ĉiel'a'j
ĉielajn	ĉiel'a'j'n
ĉielan	ĉiel'a'n
ĉiele	ĉiel'e
ĉielen	ĉiel'e'n
ĉielo	ĉiel'o
ĉieloj	ĉiel'o'j
ĉielojn	ĉiel'o'j'n
ĉielon	ĉiel'o'n
ĉielarka	ĉiel'ark'a
ĉielarko	ĉiel'ark'o
ĉielarkoj	ĉiel'ark'o'j
ĉielarkon	ĉiel'ark'o'n
ĉielblua	ĉiel'blu'a
ĉieleniro	ĉiel'e'n'ir'o
ĉielenpreno	ĉiel'e'n'pren'o
ĉielenprenita	ĉiel'e'n'pren'it'a
ĉielhoko	ĉiel'hok'o
ĉieliro	ĉiel'ir'o
ĉieliron	ĉiel'ir'o'n
ĉielplonĝistoj	ĉiel'plonĝ'ist'o'j
ĉielskrapanto	ĉiel'skrap'ant'o
ĉielskrapantoj	ĉiel'skrap'ant'o'j
ĉies	ĉies
ĉiesa	ĉies'a
ĉiesaĵo	ĉies'aĵ'o
ĉiesulino	ĉies'ul'in'o
ĉifis	ĉif'is
ĉifita	ĉif'it'a
ĉifitaj	ĉif'it'a'j
ĉifrado	ĉif'rad'o
ĉifalo	ĉifal'o
ĉifona	ĉifon'a
ĉifonaj	ĉifon'a'j
ĉifone	ĉifon'e
ĉifono	ĉifon'o
ĉifonoj	ĉifon'o'j
ĉifonojn	ĉifon'o'j'n
ĉifonon	ĉifon'o'n
ĉifoneroj	ĉifon'er'o'j
ĉifonerojn	ĉifon'er'o'j'n
ĉifonkudraĵo	ĉifon'kudr'aĵ'o
ĉifonulo	ĉifon'ul'o
ĉifra	ĉifr'a
ĉifras	ĉifr'as
ĉifri	ĉifr'i
ĉifris	ĉifr'is
ĉifro	ĉifr'o
ĉifroj	ĉifr'o'j
ĉifron	ĉifr'o'n
ĉifradon	ĉifr'ad'o'n
ĉifranta	ĉifr'ant'a
ĉifrantaj	ĉifr'ant'a'j
ĉifrante	ĉifr'ant'e
ĉifrita	ĉifr'it'a
ĉifritaj	ĉifr'it'a'j
ĉifritajn	ĉifr'it'a'j'n
ĉifritan	ĉifr'it'a'n
ĉikaga	ĉikag'a
ĉikago	ĉikag'o
ĉikagon	ĉikag'o'n
ĉikagasunatempoj	ĉikag'a'suna'temp'o'j
ĉikanas	ĉikan'as
ĉikani	ĉikan'i
ĉikanis	ĉikan'is
ĉikano	ĉikan'o
ĉikanoj	ĉikan'o'j
ĉikanon	ĉikan'o'n
ĉikanado	ĉikan'ad'o
ĉikanadon	ĉikan'ad'o'n
ĉikananto	ĉikan'ant'o
ĉikanantoj	ĉikan'ant'o'j
ĉikanema	ĉikan'em'a
ĉikanita	ĉikan'it'a
ĉikanitaj	ĉikan'it'a'j
ĉilia	ĉili'a
ĉiliaj	ĉili'a'j
ĉilio	ĉili'o
ĉilion	ĉili'o'n
ĉiliano	ĉili'an'o
ĉimpanzo	ĉimpanz'o
ĉimpanzoj	ĉimpanz'o'j
ĉimpanzojn	ĉimpanz'o'j'n
ĉina	ĉin'a
ĉinaj	ĉin'a'j
ĉinajn	ĉin'a'j'n
ĉinan	ĉin'a'n
ĉine	ĉin'e
ĉino	ĉin'o
ĉinoj	ĉin'o'j
ĉinojn	ĉin'o'j'n
ĉinon	ĉin'o'n
ĉindevena	ĉin'de'ven'a
ĉindevenaj	ĉin'de'ven'a'j
ĉindevenuloj	ĉin'de'ven'ul'o'j
ĉinia	ĉin'i'a
ĉiniaj	ĉin'i'a'j
ĉinio	ĉin'i'o
ĉinion	ĉin'i'o'n
ĉinino	ĉin'in'o
ĉinjapana	ĉin'japan'a
ĉinkapitalaj	ĉin'kapital'a'j
ĉinlingva	ĉin'lingv'a
ĉinlingvaj	ĉin'lingv'a'j
ĉinlingvan	ĉin'lingv'a'n
ĉinlingve	ĉin'lingv'e
ĉinmedicina	ĉin'medicin'a
ĉinstila	ĉin'stil'a
ĉinstilaj	ĉin'stil'a'j
ĉinstilajn	ĉin'stil'a'j'n
ĉinujo	ĉin'uj'o
ĉinujon	ĉin'uj'o'n
ĉinuka	ĉinuk'a
ĉinukhelikoptero	ĉinuk'helikopter'o
ĉiom	ĉiom
ĉioma	ĉiom'a
ĉipsoj	ĉips'o'j
ĉiroj	ĉir'o'j
ĉirkaŭ	ĉirkaŭ
ĉirkaŭa	ĉirkaŭ'a
ĉirkaŭaj	ĉirkaŭ'a'j
ĉirkaŭajn	ĉirkaŭ'a'j'n
ĉirkaŭan	ĉirkaŭ'a'n
ĉirkaŭas	ĉirkaŭ'as
ĉirkaŭe	ĉirkaŭ'e
ĉirkaŭen	ĉirkaŭ'e'n
ĉirkaŭi	ĉirkaŭ'i
ĉirkaŭis	ĉirkaŭ'is
ĉirkaŭo	ĉirkaŭ'o
ĉirkaŭoj	ĉirkaŭ'o'j
ĉirkaŭon	ĉirkaŭ'o'n
ĉirkaŭado	ĉirkaŭ'ad'o
ĉirkaŭaĵo	ĉirkaŭ'aĵ'o
ĉirkaŭaĵoj	ĉirkaŭ'aĵ'o'j
ĉirkaŭaĵojn	ĉirkaŭ'aĵ'o'j'n
ĉirkaŭaĵon	ĉirkaŭ'aĵ'o'n
ĉirkaŭanta	ĉirkaŭ'ant'a
ĉirkaŭantaj	ĉirkaŭ'ant'a'j
ĉirkaŭantajn	ĉirkaŭ'ant'a'j'n
ĉirkaŭantan	ĉirkaŭ'ant'a'n
ĉirkaŭante	ĉirkaŭ'ant'e
ĉirkaŭantoj	ĉirkaŭ'ant'o'j
ĉirkaŭata	ĉirkaŭ'at'a
ĉirkaŭataj	ĉirkaŭ'at'a'j
ĉirkaŭate	ĉirkaŭ'at'e
ĉirkaŭbarado	ĉirkaŭ'bar'ad'o
ĉirkaŭbarilo	ĉirkaŭ'bar'il'o
ĉirkaŭbarilon	ĉirkaŭ'bar'il'o'n
ĉirkaŭbarita	ĉirkaŭ'bar'it'a
ĉirkaŭbrakas	ĉirkaŭ'brak'as
ĉirkaŭbraki	ĉirkaŭ'brak'i
ĉirkaŭbrakis	ĉirkaŭ'brak'is
ĉirkaŭbrako	ĉirkaŭ'brak'o
ĉirkaŭbrakumis	ĉirkaŭ'brak'um'is
ĉirkaŭejo	ĉirkaŭ'ej'o
ĉirkaŭflugis	ĉirkaŭ'flug'is
ĉirkaŭfosaĵo	ĉirkaŭ'fos'aĵ'o
ĉirkaŭigas	ĉirkaŭ'ig'as
ĉirkaŭigi	ĉirkaŭ'ig'i
ĉirkaŭigis	ĉirkaŭ'ig'is
ĉirkaŭigo	ĉirkaŭ'ig'o
ĉirkaŭiganta	ĉirkaŭ'ig'ant'a
ĉirkaŭigita	ĉirkaŭ'ig'it'a
ĉirkaŭiĝas	ĉirkaŭ'iĝ'as
ĉirkaŭiras	ĉirkaŭ'ir'as
ĉirkaŭiri	ĉirkaŭ'ir'i
ĉirkaŭiris	ĉirkaŭ'ir'is
ĉirkaŭiro	ĉirkaŭ'ir'o
ĉirkaŭirante	ĉirkaŭ'ir'ant'e
ĉirkaŭirejo	ĉirkaŭ'ir'ej'o
ĉirkaŭirinte	ĉirkaŭ'ir'int'e
ĉirkaŭita	ĉirkaŭ'it'a
ĉirkaŭitaj	ĉirkaŭ'it'a'j
ĉirkaŭitajn	ĉirkaŭ'it'a'j'n
ĉirkaŭitan	ĉirkaŭ'it'a'n
ĉirkaŭite	ĉirkaŭ'it'e
ĉirkaŭkalkuloj	ĉirkaŭ'kalkul'o'j
ĉirkaŭkaptis	ĉirkaŭ'kapt'is
ĉirkaŭkuris	ĉirkaŭ'kur'is
ĉirkaŭmonda	ĉirkaŭ'mond'a
ĉirkaŭmuro	ĉirkaŭ'mur'o
ĉirkaŭokula	ĉirkaŭ'okul'a
ĉirkaŭokule	ĉirkaŭ'okul'e
ĉirkaŭokulo	ĉirkaŭ'okul'o
ĉirkaŭpaŝas	ĉirkaŭ'paŝ'as
ĉirkaŭpaŝi	ĉirkaŭ'paŝ'i
ĉirkaŭpaŝis	ĉirkaŭ'paŝ'is
ĉirkaŭpaŝado	ĉirkaŭ'paŝ'ad'o
ĉirkaŭpaŝante	ĉirkaŭ'paŝ'ant'e
ĉirkaŭpolusa	ĉirkaŭ'polus'a
ĉirkaŭpremis	ĉirkaŭ'prem'is
ĉirkaŭprenas	ĉirkaŭ'pren'as
ĉirkaŭpreni	ĉirkaŭ'pren'i
ĉirkaŭprenis	ĉirkaŭ'pren'is
ĉirkaŭpreninte	ĉirkaŭ'pren'int'e
ĉirkaŭpromeni	ĉirkaŭ'promen'i
ĉirkaŭpromenis	ĉirkaŭ'promen'is
ĉirkaŭrigardas	ĉirkaŭ'rigard'as
ĉirkaŭrigardi	ĉirkaŭ'rigard'i
ĉirkaŭrigardis	ĉirkaŭ'rigard'is
ĉirkaŭrigardu	ĉirkaŭ'rigard'u
ĉirkaŭrigardadis	ĉirkaŭ'rigard'ad'is
ĉirkaŭrigardante	ĉirkaŭ'rigard'ant'e
ĉirkaŭrigardinte	ĉirkaŭ'rigard'int'e
ĉirkaŭskribita	ĉirkaŭ'skrib'it'a
ĉirkaŭstaris	ĉirkaŭ'star'is
ĉirkaŭteksto	ĉirkaŭ'tekst'o
ĉirkaŭurbo	ĉirkaŭ'urb'o
ĉirkaŭvagas	ĉirkaŭ'vag'as
ĉirkaŭvojo	ĉirkaŭ'voj'o
ĉirkaŭvojon	ĉirkaŭ'voj'o'n
ĉirkaŭvolvas	ĉirkaŭ'volv'as
ĉirkaŭvolvis	ĉirkaŭ'volv'is
ĉirkaŭvolvita	ĉirkaŭ'volv'it'a
ĉirpas	ĉirp'as
ĉirpado	ĉirp'ad'o
ĉirpetas	ĉirp'et'as
ĉiu	ĉiu
ĉiuj	ĉiu'j
ĉiujn	ĉiu'jn
ĉiun	ĉiu'n
ĉiuaĝaj	ĉiu'aĝ'a'j
ĉiudimanĉe	ĉiu'dimanĉ'e
ĉiudirekte	ĉiu'direkt'e
ĉiudirekten	ĉiu'direkt'e'n
ĉiuflanka	ĉiu'flank'a
ĉiuflankaj	ĉiu'flank'a'j
ĉiuflankajn	ĉiu'flank'a'j'n
ĉiuflankan	ĉiu'flank'a'n
ĉiuflanke	ĉiu'flank'e
ĉiuflanken	ĉiu'flank'e'n
ĉiuflankeco	ĉiu'flank'ec'o
ĉiuflankecon	ĉiu'flank'ec'o'n
ĉiufoje	ĉiu'foj'e
ĉiuhore	ĉiu'hor'e
ĉiujara	ĉiu'jar'a
ĉiujaraj	ĉiu'jar'a'j
ĉiujarajn	ĉiu'jar'a'j'n
ĉiujaran	ĉiu'jar'a'n
ĉiujare	ĉiu'jar'e
ĉiuĵaŭde	ĉiu'ĵaŭd'e
ĉiukaze	ĉiu'kaz'e
ĉiulandaj	ĉiu'land'a'j
ĉiulande	ĉiu'land'e
ĉiuloke	ĉiu'lok'e
ĉiulunde	ĉiu'lund'e
ĉiumaniere	ĉiu'manier'e
ĉiumatene	ĉiu'maten'e
ĉiumerkrede	ĉiu'merkred'e
ĉiuminute	ĉiu'minut'e
ĉiumomente	ĉiu'moment'e
ĉiumonata	ĉiu'monat'a
ĉiumonataj	ĉiu'monat'a'j
ĉiumonatajn	ĉiu'monat'a'j'n
ĉiumonatan	ĉiu'monat'a'n
ĉiumonate	ĉiu'monat'e
ĉiunokte	ĉiu'nokt'e
ĉiuokaze	ĉiu'okaz'e
ĉiupaŝe	ĉiu'paŝ'e
ĉiuprintempe	ĉiu'printemp'e
ĉiurilate	ĉiu'rilat'e
ĉiurimede	ĉiu'rimed'e
ĉiusabate	ĉiu'sabat'e
ĉiusekunde	ĉiu'sekund'e
ĉiusemajna	ĉiu'semajn'a
ĉiusemajnaj	ĉiu'semajn'a'j
ĉiusemajnan	ĉiu'semajn'a'n
ĉiusemajne	ĉiu'semajn'e
ĉiusezone	ĉiu'sezon'e
ĉiusomere	ĉiu'somer'e
ĉiuspeca	ĉiu'spec'a
ĉiuspecaj	ĉiu'spec'a'j
ĉiuspecajn	ĉiu'spec'a'j'n
ĉiuspecan	ĉiu'spec'a'n
ĉiutaga	ĉiu'tag'a
ĉiutagaj	ĉiu'tag'a'j
ĉiutagajn	ĉiu'tag'a'j'n
ĉiutagan	ĉiu'tag'a'n
ĉiutage	ĉiu'tag'e
ĉiutago	ĉiu'tag'o
ĉiutagaĵo	ĉiu'tag'aĵ'o
ĉiutagaĵoj	ĉiu'tag'aĵ'o'j
ĉiutageco	ĉiu'tag'ec'o
ĉiutempe	ĉiu'temp'e
ĉiuvendrede	ĉiu'vendred'e
ĉiuvespere	ĉiu'vesper'e
ĉiuvintre	ĉiu'vintr'e
ĉizas	ĉiz'as
ĉizi	ĉiz'i
ĉizis	ĉiz'is
ĉizado	ĉiz'ad'o
ĉizadoj	ĉiz'ad'o'j
ĉizilo	ĉiz'il'o
ĉiziloj	ĉiz'il'o'j
ĉizita	ĉiz'it'a
ĉizitaj	ĉiz'it'a'j
ĉizitajn	ĉiz'it'a'j'n
ĉizitan	ĉiz'it'a'n
ĉokolada	ĉokolad'a
ĉokoladaj	ĉokolad'a'j
ĉokoladajn	ĉokolad'a'j'n
ĉokoladan	ĉokolad'a'n
ĉokolado	ĉokolad'o
ĉokoladoj	ĉokolad'o'j
ĉokoladon	ĉokolad'o'n
ĉokoladejo	ĉokolad'ej'o
ĉu	ĉu
ĉudemandoj	ĉu'demand'o'j
ĉukĉa	ĉukĉ'a
ĉukĉoj	ĉukĉ'o'j
ĉuvaŝa	ĉuvaŝ'a
ĉuvaŝio	ĉuvaŝ'i'o