ĝajna	ĝajn'a
ĝajnaj	ĝajn'a'j
ĝajnan	ĝajn'a'n
ĝajnoj	ĝajn'o'j
ĝajnisma	ĝajn'ism'a
ĝajnismaj	ĝajn'ism'a'j
ĝajnismo	ĝajn'ism'o
ĝajnismon	ĝajn'ism'o'n
ĝajnistoj	ĝajn'ist'o'j
ĝakarta	ĝakart'a
ĝakarto	ĝakart'o
ĝangala	ĝangal'a
ĝangalaj	ĝangal'a'j
ĝangalajn	ĝangal'a'j'n
ĝangale	ĝangal'e
ĝangalo	ĝangal'o
ĝangaloj	ĝangal'o'j
ĝangalojn	ĝangal'o'j'n
ĝangalon	ĝangal'o'n
ĝangalanoj	ĝangal'an'o'j
ĝangalopolis	ĝangal'o'pol'is
ĝangalostilo	ĝangal'o'stil'o
ĝangalvestitaj	ĝangal'vest'it'a'j
ĝardena	ĝarden'a
ĝardenaj	ĝarden'a'j
ĝardenajn	ĝarden'a'j'n
ĝardenan	ĝarden'a'n
ĝardenas	ĝarden'as
ĝardene	ĝarden'e
ĝardeni	ĝarden'i
ĝardenis	ĝarden'is
ĝardeno	ĝarden'o
ĝardenoj	ĝarden'o'j
ĝardenojn	ĝarden'o'j'n
ĝardenon	ĝarden'o'n
ĝardenadaj	ĝarden'ad'a'j
ĝardenado	ĝarden'ad'o
ĝardenadon	ĝarden'ad'o'n
ĝardenarto	ĝarden'art'o
ĝardenarton	ĝarden'art'o'n
ĝardenbarilo	ĝarden'bar'il'o
ĝardenbedoj	ĝarden'bed'o'j
ĝardendezajno	ĝarden'dezajn'o
ĝardendezajnoj	ĝarden'dezajn'o'j
ĝardendizajno	ĝarden'dizajn'o
ĝardendizajnisto	ĝarden'dizajn'ist'o
ĝardendizajnistoj	ĝarden'dizajn'ist'o'j
ĝardendomo	ĝarden'dom'o
ĝardendomoj	ĝarden'dom'o'j
ĝardendometo	ĝarden'dom'et'o
ĝardenekspozicio	ĝarden'ekspozici'o
ĝardeneto	ĝarden'et'o
ĝardenetoj	ĝarden'et'o'j
ĝardeneton	ĝarden'et'o'n
ĝardenfazeolo	ĝarden'fazeol'o
ĝardenfesto	ĝarden'fest'o
ĝardenfestoj	ĝarden'fest'o'j
ĝardenfloroj	ĝarden'flor'o'j
ĝardenformo	ĝarden'form'o
ĝardenigo	ĝarden'ig'o
ĝardeniloj	ĝarden'il'o'j
ĝardenista	ĝarden'ist'a
ĝardenisto	ĝarden'ist'o
ĝardenistoj	ĝarden'ist'o'j
ĝardenistojn	ĝarden'ist'o'j'n
ĝardeniston	ĝarden'ist'o'n
ĝardenistejo	ĝarden'ist'ej'o
ĝardenistiko	ĝarden'ist'ik'o
ĝardenistino	ĝarden'ist'in'o
ĝardenkameno	ĝarden'kamen'o
ĝardenkonstruaĵoj	ĝarden'konstru'aĵ'o'j
ĝardenkreado	ĝarden'kre'ad'o
ĝardenkreantoj	ĝarden'kre'ant'o'j
ĝardenkrizantemo	ĝarden'krizantem'o
ĝardenkukurbo	ĝarden'kukurb'o
ĝardenkultivado	ĝarden'kultiv'ad'o
ĝardenkulturo	ĝarden'kultur'o
ĝardenkulturon	ĝarden'kultur'o'n
ĝardenkulturejo	ĝarden'kultur'ej'o
ĝardenlaboro	ĝarden'labor'o
ĝardenlaboron	ĝarden'labor'o'n
ĝardenobariloj	ĝarden'o'bar'il'o'j
ĝardenosciencaj	ĝarden'o'scienc'a'j
ĝardenpadoj	ĝarden'pad'o'j
ĝardenpavilonoj	ĝarden'pavilon'o'j
ĝardenplacon	ĝarden'plac'o'n
ĝardenplanto	ĝarden'plant'o
ĝardenplantoj	ĝarden'plant'o'j
ĝardenplantojn	ĝarden'plant'o'j'n
ĝardenpordo	ĝarden'pord'o
ĝardenpordeton	ĝarden'pord'et'o'n
ĝardenpotoj	ĝarden'pot'o'j
ĝardenrozoj	ĝarden'roz'o'j
ĝardensalono	ĝarden'salon'o
ĝardenspaco	ĝarden'spac'o
ĝardentekniko	ĝarden'teknik'o
ĝardentero	ĝarden'ter'o
ĝardenteron	ĝarden'ter'o'n
ĝardentondiloj	ĝarden'tond'il'o'j
ĝardenuma	ĝarden'um'a
ĝardenumas	ĝarden'um'as
ĝardenumi	ĝarden'um'i
ĝardenumo	ĝarden'um'o
ĝardenumado	ĝarden'um'ad'o
ĝardenurba	ĝarden'urb'a
ĝardenurbo	ĝarden'urb'o
ĝardenurboj	ĝarden'urb'o'j
ĝazbando	ĝaz'band'o
ĝazbandoj	ĝaz'band'o'j
ĝazbandon	ĝaz'band'o'n
ĝema	ĝem'a
ĝemas	ĝem'as
ĝeme	ĝem'e
ĝemi	ĝem'i
ĝemis	ĝem'is
ĝemo	ĝem'o
ĝemoj	ĝem'o'j
ĝemojn	ĝem'o'j'n
ĝemon	ĝem'o'n
ĝemos	ĝem'os
ĝemu	ĝem'u
ĝemus	ĝem'us
ĝemadas	ĝem'ad'as
ĝemadi	ĝem'ad'i
ĝemadis	ĝem'ad'is
ĝemado	ĝem'ad'o
ĝemadoj	ĝem'ad'o'j
ĝemadojn	ĝem'ad'o'j'n
ĝemadon	ĝem'ad'o'n
ĝemanta	ĝem'ant'a
ĝemantaj	ĝem'ant'a'j
ĝemantan	ĝem'ant'a'n
ĝemante	ĝem'ant'e
ĝemdiru	ĝem'dir'u
ĝemegis	ĝem'eg'is
ĝemegoj	ĝem'eg'o'j
ĝemegojn	ĝem'eg'o'j'n
ĝemegado	ĝem'eg'ad'o
ĝemegantan	ĝem'eg'ant'a'n
ĝemetas	ĝem'et'as
ĝemeti	ĝem'et'i
ĝemetis	ĝem'et'is
ĝemeto	ĝem'et'o
ĝemetoj	ĝem'et'o'j
ĝemetadon	ĝem'et'ad'o'n
ĝemetante	ĝem'et'ant'e
ĝemkriis	ĝem'kri'is
ĝemkrioj	ĝem'kri'o'j
ĝemploris	ĝem'plor'is
ĝemspiris	ĝem'spir'is
ĝemspirante	ĝem'spir'ant'e
ĝemela	ĝemel'a
ĝemelaj	ĝemel'a'j
ĝemelajn	ĝemel'a'j'n
ĝemelan	ĝemel'a'n
ĝemele	ĝemel'e
ĝemeli	ĝemel'i
ĝemelis	ĝemel'is
ĝemelo	ĝemel'o
ĝemeloj	ĝemel'o'j
ĝemelojn	ĝemel'o'j'n
ĝemelon	ĝemel'o'n
ĝemeleco	ĝemel'ec'o
ĝemelfiloj	ĝemel'fil'o'j
ĝemelfirmao	ĝemel'firma'o
ĝemelfrato	ĝemel'frat'o
ĝemelfratoj	ĝemel'frat'o'j
ĝemelfraton	ĝemel'frat'o'n
ĝemelfratinon	ĝemel'frat'in'o'n
ĝemeligon	ĝemel'ig'o'n
ĝemeligita	ĝemel'ig'it'a
ĝemeliĝi	ĝemel'iĝ'i
ĝemeliĝis	ĝemel'iĝ'is
ĝemeliĝo	ĝemel'iĝ'o
ĝemeliĝoj	ĝemel'iĝ'o'j
ĝemelino	ĝemel'in'o
ĝemelinoj	ĝemel'in'o'j
ĝemelinfanoj	ĝemel'infan'o'j
ĝemelita	ĝemel'it'a
ĝemelitaj	ĝemel'it'a'j
ĝemelkolonoj	ĝemel'kolon'o'j
ĝemelkonsiletestraroj	ĝemel'konsil'et'estr'ar'o'j
ĝemelparoj	ĝemel'par'o'j
ĝemelturo	ĝemel'tur'o
ĝemeluloj	ĝemel'ul'o'j
ĝemelurba	ĝemel'urb'a
ĝemelurbaj	ĝemel'urb'a'j
ĝemelurbo	ĝemel'urb'o
ĝemelurboj	ĝemel'urb'o'j
ĝemelurbojn	ĝemel'urb'o'j'n
ĝena	ĝen'a
ĝenaj	ĝen'a'j
ĝenajn	ĝen'a'j'n
ĝenan	ĝen'a'n
ĝenas	ĝen'as
ĝene	ĝen'e
ĝeni	ĝen'i
ĝenis	ĝen'is
ĝeno	ĝen'o
ĝenoj	ĝen'o'j
ĝenojn	ĝen'o'j'n
ĝenon	ĝen'o'n
ĝenos	ĝen'os
ĝenu	ĝen'u
ĝenus	ĝen'us
ĝenadas	ĝen'ad'as
ĝenadi	ĝen'ad'i
ĝenadis	ĝen'ad'is
ĝenado	ĝen'ad'o
ĝenadon	ĝen'ad'o'n
ĝenaditaj	ĝen'ad'it'a'j
ĝenaĵo	ĝen'aĵ'o
ĝenaĵoj	ĝen'aĵ'o'j
ĝenaĵojn	ĝen'aĵ'o'j'n
ĝenaĵon	ĝen'aĵ'o'n
ĝenaĵliberan	ĝen'aĵ'liber'a'n
ĝenanta	ĝen'ant'a
ĝenantaj	ĝen'ant'a'j
ĝenantajn	ĝen'ant'a'j'n
ĝenantan	ĝen'ant'a'n
ĝenante	ĝen'ant'e
ĝenanto	ĝen'ant'o
ĝenantojn	ĝen'ant'o'j'n
ĝenata	ĝen'at'a
ĝenataj	ĝen'at'a'j
ĝenatajn	ĝen'at'a'j'n
ĝenatan	ĝen'at'a'n
ĝenate	ĝen'at'e
ĝenateco	ĝen'at'ec'o
ĝenatecon	ĝen'at'ec'o'n
ĝeneco	ĝen'ec'o
ĝenega	ĝen'eg'a
ĝenegis	ĝen'eg'is
ĝenelsendado	ĝen'el'send'ad'o
ĝenema	ĝen'em'a
ĝenemo	ĝen'em'o
ĝenetas	ĝen'et'as
ĝeniga	ĝen'ig'a
ĝenigo	ĝen'ig'o
ĝeniĝa	ĝen'iĝ'a
ĝeniĝas	ĝen'iĝ'as
ĝeniĝi	ĝen'iĝ'i
ĝeniĝis	ĝen'iĝ'is
ĝeniĝo	ĝen'iĝ'o
ĝeniĝon	ĝen'iĝ'o'n
ĝeniĝu	ĝen'iĝ'u
ĝeniĝante	ĝen'iĝ'ant'e
ĝeninta	ĝen'int'a
ĝenita	ĝen'it'a
ĝenitaj	ĝen'it'a'j
ĝenitajn	ĝen'it'a'j'n
ĝenitan	ĝen'it'a'n
ĝenite	ĝen'it'e
ĝeniteco	ĝen'it'ec'o
ĝenlumo	ĝen'lum'o
ĝenodistanco	ĝen'o'distanc'o
ĝenpafado	ĝen'paf'ad'o
ĝenulo	ĝen'ul'o
ĝenuloj	ĝen'ul'o'j
ĝenulojn	ĝen'ul'o'j'n
ĝenulon	ĝen'ul'o'n
ĝendarma	ĝendarm'a
ĝendarmaj	ĝendarm'a'j
ĝendarmo	ĝendarm'o
ĝendarmoj	ĝendarm'o'j
ĝendarmojn	ĝendarm'o'j'n
ĝendarmon	ĝendarm'o'n
ĝendarmaro	ĝendarm'ar'o
ĝendarmaron	ĝendarm'ar'o'n
ĝendarmejo	ĝendarm'ej'o
ĝenerala	ĝeneral'a
ĝenelaraj	ĝeneral'a'j
ĝeneralaj	ĝeneral'a'j
ĝeneralajn	ĝeneral'a'j'n
ĝeneralan	ĝeneral'a'n
ĝenralan	ĝeneral'a'n
ĝeneralas	ĝeneral'as
ĝenerake	ĝeneral'e
ĝenerale	ĝeneral'e
ĝenerele	ĝeneral'e
ĝeneralo	ĝeneral'o
ĝeneralaĵo	ĝeneral'aĵ'o
ĝeneralaĵoj	ĝeneral'aĵ'o'j
ĝeneralaĵojn	ĝeneral'aĵ'o'j'n
ĝeneralaspekte	ĝeneral'aspekt'e
ĝeneralbaso	ĝeneral'bas'o
ĝeneralcela	ĝeneral'cel'a
ĝeneralcelaj	ĝeneral'cel'a'j
ĝeneraldire	ĝeneral'dir'e
ĝeneraldirite	ĝeneral'dir'it'e
ĝeneraldirektoro	ĝeneral'direktor'o
ĝeneraleco	ĝeneral'ec'o
ĝeneralecoj	ĝeneral'ec'o'j
ĝeneralecon	ĝeneral'ec'o'n
ĝeneralgubernatora	ĝeneral'gubernator'a
ĝeneralgubernatoro	ĝeneral'gubernator'o
ĝeneralgubernatoroj	ĝeneral'gubernator'o'j
ĝeneralgubernatoron	ĝeneral'gubernator'o'n
ĝeneraliga	ĝeneral'ig'a
ĝeneraligaj	ĝeneral'ig'a'j
ĝeneraligajn	ĝeneral'ig'a'j'n
ĝeneraligas	ĝeneral'ig'as
ĝeneralige	ĝeneral'ig'e
ĝeneraligi	ĝeneral'ig'i
ĝeneraligis	ĝeneral'ig'is
ĝeneraligo	ĝeneral'ig'o
ĝeneraligoj	ĝeneral'ig'o'j
ĝeneraligojn	ĝeneral'ig'o'j'n
ĝeneraligon	ĝeneral'ig'o'n
ĝeneraligos	ĝeneral'ig'os
ĝeneraligu	ĝeneral'ig'u
ĝeneraligado	ĝeneral'ig'ad'o
ĝeneraliganta	ĝeneral'ig'ant'a
ĝeneraligante	ĝeneral'ig'ant'e
ĝeneraligataj	ĝeneral'ig'at'a'j
ĝeneraligebla	ĝeneral'ig'ebl'a
ĝeneraligeblaj	ĝeneral'ig'ebl'a'j
ĝeneraligeblas	ĝeneral'ig'ebl'as
ĝeneraligeblo	ĝeneral'ig'ebl'o
ĝeneraligita	ĝeneral'ig'it'a
ĝeneraligitaj	ĝeneral'ig'it'a'j
ĝeneraligitajn	ĝeneral'ig'it'a'j'n
ĝeneraligitan	ĝeneral'ig'it'a'n
ĝeneraligite	ĝeneral'ig'it'e
ĝeneraliĝas	ĝeneral'iĝ'as
ĝeneraliĝi	ĝeneral'iĝ'i
ĝeneraliĝis	ĝeneral'iĝ'is
ĝeneraliĝo	ĝeneral'iĝ'o
ĝeneralinteresa	ĝeneral'interes'a
ĝeneralinteresaj	ĝeneral'interes'a'j
ĝeneralinteresajn	ĝeneral'interes'a'j'n
ĝeneralista	ĝeneral'ist'a
ĝeneralistaj	ĝeneral'ist'a'j
ĝeneralisto	ĝeneral'ist'o
ĝeneralistoj	ĝeneral'ist'o'j
ĝeneralistojn	ĝeneral'ist'o'j'n
ĝeneralistopredantoj	ĝeneral'ist'o'pred'ant'o'j
ĝeneraljura	ĝeneral'jur'a
ĝeneraljuraj	ĝeneral'jur'a'j
ĝeneraljurajn	ĝeneral'jur'a'j'n
ĝeneraljuran	ĝeneral'jur'a'n
ĝeneralkleriga	ĝeneral'kler'ig'a
ĝeneralkliniko	ĝeneral'klinik'o
ĝeneralkonsenta	ĝeneral'konsent'a
ĝeneralkonsento	ĝeneral'konsent'o
ĝeneralkonsentoj	ĝeneral'konsent'o'j
ĝenerallingva	ĝeneral'lingv'a
ĝeneralpaŭzo	ĝeneral'paŭz'o
ĝeneralpermeso	ĝeneral'permes'o
ĝeneralpermeson	ĝeneral'permes'o'n
ĝeneralpolitika	ĝeneral'politik'a
ĝeneralrelativeca	ĝeneral'relativ'ec'a
ĝeneralriparon	ĝeneral'ripar'o'n
ĝeneralsence	ĝeneral'senc'e
ĝeneralsignifan	ĝeneral'signif'a'n
ĝeneralŝtatoj	ĝeneral'ŝtat'o'j
ĝeneralula	ĝeneral'ul'a
ĝeneraluzebla	ĝeneral'uz'ebl'a
ĝeneraluzeblaj	ĝeneral'uz'ebl'a'j
ĝeneraluzeblajn	ĝeneral'uz'ebl'a'j'n
ĝeneraluzeblan	ĝeneral'uz'ebl'a'n
ĝeneva	ĝenev'a
ĝenevaj	ĝenev'a'j
ĝenevajn	ĝenev'a'j'n
ĝenevan	ĝenev'a'n
ĝenevo	ĝenev'o
ĝenevon	ĝenev'o'n
ĝenevano	ĝenev'an'o
ĝenio	ĝeni'o
ĝenioj	ĝeni'o'j
ĝenova	ĝenov'a
ĝenovaj	ĝenov'a'j
ĝenovan	ĝenov'a'n
ĝenovo	ĝenov'o
ĝenovon	ĝenov'o'n
ĝenovano	ĝenov'an'o
ĝenovanoj	ĝenov'an'o'j
ĝenovanon	ĝenov'an'o'n
ĝenra	ĝenr'a
ĝenraj	ĝenr'a'j
ĝenrajn	ĝenr'a'j'n
ĝenran	ĝenr'a'n
ĝenro	ĝenr'o
ĝenroj	ĝenr'o'j
ĝenrojn	ĝenr'o'j'n
ĝenron	ĝenr'o'n
ĝenrisma	ĝenr'ism'a
ĝenrismaj	ĝenr'ism'a'j
ĝenrismo	ĝenr'ism'o
ĝenrofikcio	ĝenr'o'fikci'o
ĝenrofilmoj	ĝenr'o'film'o'j
ĝenrokonvencioj	ĝenr'o'konvenci'o'j
ĝenronomo	ĝenr'o'nom'o
ĝenropentraĵo	ĝenr'o'pentr'aĵ'o
ĝenropentraĵoj	ĝenr'o'pentr'aĵ'o'j
ĝenropentristo	ĝenr'o'pentr'ist'o
ĝenroscenoj	ĝenr'o'scen'o'j
ĝenroteorio	ĝenr'o'teori'o
ĝenroverkoj	ĝenr'o'verk'o'j
ĝentila	ĝentil'a
ĝentilaj	ĝentil'a'j
ĝentilajn	ĝentil'a'j'n
ĝentilan	ĝentil'a'n
ĝentilas	ĝentil'as
ĝentile	ĝentil'e
ĝentili	ĝentil'i
ĝentilis	ĝentil'is
ĝentilo	ĝentil'o
ĝentilon	ĝentil'o'n
ĝentilu	ĝentil'u
ĝentilaĵo	ĝentil'aĵ'o
ĝentilaĵoj	ĝentil'aĵ'o'j
ĝentilaĵojn	ĝentil'aĵ'o'j'n
ĝentilaĵon	ĝentil'aĵ'o'n
ĝentileca	ĝentil'ec'a
ĝentilecaj	ĝentil'ec'a'j
ĝentileco	ĝentil'ec'o
ĝentilecon	ĝentil'ec'o'n
ĝentilecnomon	ĝentil'ec'nom'o'n
ĝentilecoreguloj	ĝentil'ec'o'regul'o'j
ĝentilega	ĝentil'eg'a
ĝentilema	ĝentil'em'a
ĝentilhomo	ĝentil'hom'o
ĝentilhomoj	ĝentil'hom'o'j
ĝentilmaniera	ĝentil'manier'a
ĝentilula	ĝentil'ul'a
ĝentilulaj	ĝentil'ul'a'j
ĝentilulo	ĝentil'ul'o
ĝentiluloj	ĝentil'ul'o'j
ĝentilulon	ĝentil'ul'o'n
ĝentlemana	ĝentleman'a
ĝentlemanajn	ĝentleman'a'j'n
ĝentlemano	ĝentleman'o
ĝentlemanoj	ĝentleman'o'j
ĝentlemanon	ĝentleman'o'n
ĝentlemanino	ĝentleman'in'o
ĝerma	ĝerm'a
ĝermaj	ĝerm'a'j
ĝerman	ĝerm'a'n
ĝermas	ĝerm'as
ĝerme	ĝerm'e
ĝermi	ĝerm'i
ĝermis	ĝerm'is
ĝermo	ĝerm'o
ĝermoj	ĝerm'o'j
ĝermojn	ĝerm'o'j'n
ĝermon	ĝerm'o'n
ĝermos	ĝerm'os
ĝermu	ĝerm'u
ĝermado	ĝerm'ad'o
ĝermadon	ĝerm'ad'o'n
ĝermaĵojn	ĝerm'aĵ'o'j'n
ĝermanta	ĝerm'ant'a
ĝermantaj	ĝerm'ant'a'j
ĝermantajn	ĝerm'ant'a'j'n
ĝermantan	ĝerm'ant'a'n
ĝermantoj	ĝerm'ant'o'j
ĝermĉeloj	ĝerm'ĉel'o'j
ĝermece	ĝerm'ec'e
ĝermejo	ĝerm'ej'o
ĝermeto	ĝerm'et'o
ĝermetoj	ĝerm'et'o'j
ĝermeton	ĝerm'et'o'n
ĝermfoliojn	ĝerm'foli'o'j'n
ĝermiga	ĝerm'ig'a
ĝermigis	ĝerm'ig'is
ĝermita	ĝerm'it'a
ĝermkapablaj	ĝerm'kapabl'a'j
ĝermlinia	ĝerm'lini'a
ĝermlinio	ĝerm'lini'o
ĝermliniinĝenieristiko	ĝerm'lini'inĝenier'ist'ik'o
ĝermliniomodifo	ĝerm'lini'o'modif'o
ĝermolinio	ĝerm'o'lini'o
ĝermolisto	ĝerm'o'list'o
ĝermplanto	ĝerm'plant'o
ĝermplantoj	ĝerm'plant'o'j
ĝermplasmoteorio	ĝerm'plasm'o'teori'o
ĝermtavolo	ĝerm'tavol'o
ĝermtavoloj	ĝerm'tavol'o'j
ĝermteorio	ĝerm'teori'o
ĝermana	ĝerman'a
ĝermanaj	ĝerman'a'j
ĝermanajn	ĝerman'a'j'n
ĝermanan	ĝerman'a'n
ĝermanoj	ĝerman'o'j
ĝermanojn	ĝerman'o'j'n
ĝermandevena	ĝerman'de'ven'a
ĝermandevenaj	ĝerman'de'ven'a'j
ĝermaneca	ĝerman'ec'a
ĝermanio	ĝerman'i'o
ĝermanianoj	ĝerman'i'an'o'j
ĝermanida	ĝerman'id'a
ĝermanidaj	ĝerman'id'a'j
ĝermanidoj	ĝerman'id'o'j
ĝermanismoj	ĝerman'ism'o'j
ĝermanlando	ĝerman'land'o
ĝermanlingva	ĝerman'lingv'a
ĝermanlingvaj	ĝerman'lingv'a'j
ĝermocida	ĝermocid'a
ĝeto	ĝet'o
ĝeteoj	ĝet'o'j
ĝetoj	ĝet'o'j
ĝeton	ĝet'o'n
ĝi	ĝi
ĝia	ĝi'a
ĝiaj	ĝi'a'j
ĝiajn	ĝi'a'j'n
ĝian	ĝi'a'n
ĝie	ĝi'e
ĝin	ĝi'n
ĝialoken	ĝi'a'lok'e'n
ĝiatempaj	ĝi'a'temp'a'j
ĝiatempe	ĝi'a'temp'e
ĝiavice	ĝi'a'vic'e
ĝiismo	ĝi'ism'o
ĝipunkte	ĝi'punkt'e
ĝiba	ĝib'a
ĝibaj	ĝib'a'j
ĝiban	ĝib'a'n
ĝibis	ĝib'is
ĝibo	ĝib'o
ĝiboj	ĝib'o'j
ĝibojn	ĝib'o'j'n
ĝibon	ĝib'o'n
ĝibaĵo	ĝib'aĵ'o
ĝibdorsa	ĝib'dors'a
ĝibeta	ĝib'et'a
ĝibeto	ĝib'et'o
ĝibetiĝis	ĝib'et'iĝ'is
ĝibetiĝante	ĝib'et'iĝ'ant'e
ĝibetiĝinta	ĝib'et'iĝ'int'a
ĝibetiĝinte	ĝib'et'iĝ'int'e
ĝibigas	ĝib'ig'as
ĝibigis	ĝib'ig'is
ĝibigita	ĝib'ig'it'a
ĝibiĝi	ĝib'iĝ'i
ĝibiĝis	ĝib'iĝ'is
ĝibiĝinta	ĝib'iĝ'int'a
ĝibiĝinte	ĝib'iĝ'int'e
ĝibnaza	ĝib'naz'a
ĝibnazan	ĝib'naz'a'n
ĝibodelfeno	ĝib'o'delfen'o
ĝibodelfenoj	ĝib'o'delfen'o'j
ĝibulo	ĝib'ul'o
ĝibuloj	ĝib'ul'o'j
ĝibulon	ĝib'ul'o'n
ĝibraltara	ĝibraltar'a
ĝibraltaraj	ĝibraltar'a'j
ĝibraltaro	ĝibraltar'o
ĝibraltaron	ĝibraltar'o'n
ĝibraltaranoj	ĝibraltar'an'o'j
ĝibutia	ĝibuti'a
ĝibutio	ĝibuti'o
ĝigo	ĝig'o
ĝigoj	ĝig'o'j
ĝigojn	ĝig'o'j'n
ĝigolo	ĝigol'o
ĝihado	ĝihad'o
ĝihadoj	ĝihad'o'j
ĝihadon	ĝihad'o'n
ĝihadistoj	ĝihad'ist'o'j
ĝihadmovadoj	ĝihad'mov'ad'o'j
ĝilinio	ĝilini'o
ĝina	ĝin'a
ĝino	ĝin'o
ĝinoj	ĝin'o'j
ĝinojn	ĝin'o'j'n
ĝinon	ĝin'o'n
ĝinano	ĝin'an'o
ĝinregno	ĝin'regn'o
ĝingisĥano	ĝingis'ĥan'o
ĝinĝisĥano	ĝingis'ĥan'o
ĝinzo	ĝinz'o
ĝinzoj	ĝinz'o'j
ĝinzojn	ĝinz'o'j'n
ĝinzon	ĝinz'o'n
ĝinzoŝtofo	ĝinz'o'ŝtof'o
ĝira	ĝir'a
ĝiras	ĝir'as
ĝiri	ĝir'i
ĝiris	ĝir'is
ĝiro	ĝir'o
ĝiroj	ĝir'o'j
ĝirojn	ĝir'o'j'n
ĝiron	ĝir'o'n
ĝiros	ĝir'os
ĝiru	ĝir'u
ĝirante	ĝir'ant'e
ĝirejo	ĝir'ej'o
ĝirejoj	ĝir'ej'o'j
ĝirejojn	ĝir'ej'o'j'n
ĝirita	ĝir'it'a
ĝirkonta	ĝir'kont'a
ĝirokonto	ĝir'o'kont'o
ĝirokostoj	ĝir'o'kost'o'j
ĝirafaj	ĝiraf'a'j
ĝirafo	ĝiraf'o
ĝirafoj	ĝiraf'o'j
ĝirafojn	ĝiraf'o'j'n
ĝirafon	ĝiraf'o'n
ĝirondo	ĝirond'o
ĝis	ĝis
ĝisa	ĝis'a
ĝisas	ĝis'as
ĝisde	ĝis'de
ĝise	ĝis'e
ĝisi	ĝis'i
ĝisis	ĝis'is
ĝisnun	ĝis'nun
ĝistiam	ĝis'tiam
ĝisante	ĝis'ant'e
ĝisatendas	ĝis'atend'as
ĝisatendi	ĝis'atend'i
ĝisatendis	ĝis'atend'is
ĝisatendos	ĝis'atend'os
ĝisatendu	ĝis'atend'u
ĝisatendinte	ĝis'atend'int'e
ĝisatingis	ĝis'ating'is
ĝisatingos	ĝis'ating'os
ĝisbaza	ĝis'baz'a
ĝisĉiaman	ĝis'ĉiam'a'n
ĝisĉiele	ĝis'ĉiel'e
ĝiscindre	ĝis'cindr'e
ĝisdata	ĝis'dat'a
ĝisdataj	ĝis'dat'a'j
ĝisdatajn	ĝis'dat'a'j'n
ĝisdatan	ĝis'dat'a'n
ĝisdate	ĝis'dat'e
ĝisdati	ĝis'dat'i
ĝisdatiga	ĝis'dat'ig'a
ĝisdatigaj	ĝis'dat'ig'a'j
ĝisdatigas	ĝis'dat'ig'as
ĝisdatigi	ĝis'dat'ig'i
ĝisdatigis	ĝis'dat'ig'is
ĝisdatigo	ĝis'dat'ig'o
ĝisdatigoj	ĝis'dat'ig'o'j
ĝisdatigojn	ĝis'dat'ig'o'j'n
ĝisdatigon	ĝis'dat'ig'o'n
ĝisdatigos	ĝis'dat'ig'os
ĝisdatigu	ĝis'dat'ig'u
ĝisdatigus	ĝis'dat'ig'us
ĝisdatigado	ĝis'dat'ig'ad'o
ĝisdatigadoj	ĝis'dat'ig'ad'o'j
ĝisdatigadon	ĝis'dat'ig'ad'o'n
ĝisdatigaĵoj	ĝis'dat'ig'aĵ'o'j
ĝisdatigaĵojn	ĝis'dat'ig'aĵ'o'j'n
ĝisdatiganta	ĝis'dat'ig'ant'a
ĝisdatigantaj	ĝis'dat'ig'ant'a'j
ĝisdatigantan	ĝis'dat'ig'ant'a'n
ĝisdatigante	ĝis'dat'ig'ant'e
ĝisdatiganto	ĝis'dat'ig'ant'o
ĝisdatigata	ĝis'dat'ig'at'a
ĝisdatigataj	ĝis'dat'ig'at'a'j
ĝisdatigebla	ĝis'dat'ig'ebl'a
ĝisdatigeblaj	ĝis'dat'ig'ebl'a'j
ĝisdatigeblan	ĝis'dat'ig'ebl'a'n
ĝisdatigeblo	ĝis'dat'ig'ebl'o
ĝisdatigenda	ĝis'dat'ig'end'a
ĝisdatigita	ĝis'dat'ig'it'a
ĝisdatigitaj	ĝis'dat'ig'it'a'j
ĝisdatigitajn	ĝis'dat'ig'it'a'j'n
ĝisdatigitan	ĝis'dat'ig'it'a'n
ĝisdatigite	ĝis'dat'ig'it'e
ĝisdatigotan	ĝis'dat'ig'ot'a'n
ĝisdatiĝas	ĝis'dat'iĝ'as
ĝisdatiĝi	ĝis'dat'iĝ'i
ĝisdatiĝis	ĝis'dat'iĝ'is
ĝisdente	ĝis'dent'e
ĝisdetala	ĝis'detal'a
ĝisdetale	ĝis'detal'e
ĝisdolore	ĝis'dolor'e
ĝisekde	ĝis'ek'd'e
ĝisekstreme	ĝis'ekstrem'e
ĝiseterne	ĝis'etern'e
ĝisfine	ĝis'fin'e
ĝisfinecon	ĝis'fin'ec'o'n
ĝisfrazo	ĝis'fraz'o
ĝisfreneze	ĝis'frenez'e
ĝisfunda	ĝis'fund'a
ĝisfundaj	ĝis'fund'a'j
ĝisfundan	ĝis'fund'a'n
ĝisfunde	ĝis'fund'e
ĝisfunden	ĝis'fund'e'n
ĝisgenua	ĝis'genu'a
ĝisgenuaj	ĝis'genu'a'j
ĝisgenuajn	ĝis'genu'a'j'n
ĝisgenuan	ĝis'genu'a'n
ĝisgenue	ĝis'genu'e
ĝisgorĝe	ĝis'gorĝ'e
ĝisgrimpis	ĝis'grimp'is
ĝisgrunde	ĝis'grund'e
ĝishaŭte	ĝis'haŭt'e
ĝishejme	ĝis'hejm'e
ĝishonte	ĝis'hont'e
ĝishore	ĝis'hor'e
ĝishorizonte	ĝis'horizont'e
ĝisiri	ĝis'ir'i
ĝisiris	ĝis'ir'is
ĝisiros	ĝis'ir'os
ĝiskerne	ĝis'kern'e
ĝiskole	ĝis'kol'e
ĝiskore	ĝis'kor'e
ĝiskreve	ĝis'krev'e
ĝiskubute	ĝis'kubut'e
ĝiskuris	ĝis'kur'is
ĝislace	ĝis'lac'e
ĝislarme	ĝis'larm'e
ĝislaste	ĝis'last'e
ĝislimas	ĝis'lim'as
ĝislime	ĝis'lim'e
ĝislimi	ĝis'lim'i
ĝislimita	ĝis'limit'a
ĝisludis	ĝis'lud'is
ĝismalfrue	ĝis'mal'fru'e
ĝismaleole	ĝis'maleol'e
ĝismatene	ĝis'maten'e
ĝismatura	ĝis'matur'a
ĝismedola	ĝis'medol'a
ĝismedolan	ĝis'medol'a'n
ĝismedole	ĝis'medol'e
ĝismorta	ĝis'mort'a
ĝismortaj	ĝis'mort'a'j
ĝismortan	ĝis'mort'a'n
ĝismorte	ĝis'mort'e
ĝismortokondukaj	ĝis'mort'o'konduk'a'j
ĝisnaŭze	ĝis'naŭz'e
ĝisnigre	ĝis'nigr'e
ĝisnuda	ĝis'nud'a
ĝisnude	ĝis'nud'e
ĝisnuna	ĝis'nun'a
ĝisnunaj	ĝis'nun'a'j
ĝisnunajn	ĝis'nun'a'j'n
ĝisnunan	ĝis'nun'a'n
ĝisnune	ĝis'nun'e
ĝisorele	ĝis'orel'e
ĝisosta	ĝis'ost'a
ĝisostaj	ĝis'ost'a'j
ĝisostajn	ĝis'ost'a'j'n
ĝisostan	ĝis'ost'a'n
ĝisoste	ĝis'ost'e
ĝispiede	ĝis'pied'e
ĝispojne	ĝis'pojn'e
ĝisprofunde	ĝis'profund'e
ĝispunkte	ĝis'punkt'e
ĝisradika	ĝis'radik'a
ĝisradikajn	ĝis'radik'a'j'n
ĝisradikan	ĝis'radik'a'n
ĝisradike	ĝis'radik'e
ĝisrande	ĝis'rand'e
ĝisrevidis	ĝis're'vid'is
ĝisrevido	ĝis're'vid'o
ĝisrevidon	ĝis'rev'id'o'n
ĝisridinde	ĝis'rid'ind'e
ĝissange	ĝis'sang'e
ĝissata	ĝis'sat'a
ĝissate	ĝis'sat'e
ĝisŝaŭme	ĝis'ŝaŭm'e
ĝisstreko	ĝis'strek'o
ĝisstrekon	ĝis'strek'o'n
ĝisŝultre	ĝis'ŝultr'e
ĝissupre	ĝis'supr'e
ĝistalia	ĝis'tali'a
ĝistalie	ĝis'tali'e
ĝistede	ĝis'ted'e
ĝistiama	ĝis'tiam'a
ĝistiamaj	ĝis'tiam'a'j
ĝistiamajn	ĝis'tiam'a'j'n
ĝistiaman	ĝis'tiam'a'n
ĝistiame	ĝis'tiam'e
ĝistomban	ĝis'tomb'a'n
ĝisveni	ĝis'ven'i
ĝisvenis	ĝis'ven'is
ĝisvespera	ĝis'vesper'a
ĝisveturis	ĝis'vetur'is
ĝisvivas	ĝis'viv'as
ĝisvivi	ĝis'viv'i
ĝivivi	ĝis'viv'i
ĝisvivis	ĝis'viv'is
ĝisvivos	ĝis'viv'os
ĝisvivus	ĝis'viv'us
ĝisvivado	ĝis'viv'ad'o
ĝisvome	ĝis'vom'e
ĝisvomige	ĝis'vom'ig'e
ĝisvorte	ĝis'vort'e
ĝiszone	ĝis'zon'e
ĝoja	ĝoj'a
ĝojaj	ĝoj'a'j
ĝojajn	ĝoj'a'j'n
ĝojan	ĝoj'a'n
ĝojas	ĝoj'as
ĝoje	ĝoj'e
ĝoji	ĝoj'i
ĝojis	ĝoj'is
ĝojo	ĝoj'o
ĝojoj	ĝoj'o'j
ĝojojn	ĝoj'o'j'n
ĝojon	ĝoj'o'n
ĝojos	ĝoj'os
ĝoju	ĝoj'u
ĝojus	ĝoj'us
ĝojadas	ĝoj'ad'as
ĝojadis	ĝoj'ad'is
ĝojado	ĝoj'ad'o
ĝojadon	ĝoj'ad'o'n
ĝojalarma	ĝoj'alarm'a
ĝojanta	ĝoj'ant'a
ĝojantaj	ĝoj'ant'a'j
ĝojante	ĝoj'ant'e
ĝojatendas	ĝoj'atend'as
ĝojatendis	ĝoj'atend'is
ĝojatendos	ĝoj'atend'os
ĝojeco	ĝoj'ec'o
ĝojecon	ĝoj'ec'o'n
ĝojega	ĝoj'eg'a
ĝojegaj	ĝoj'eg'a'j
ĝojegas	ĝoj'eg'as
ĝojege	ĝoj'eg'e
ĝojegi	ĝoj'eg'i
ĝojegis	ĝoj'eg'is
ĝojego	ĝoj'eg'o
ĝojegon	ĝoj'eg'o'n
ĝojegos	ĝoj'eg'os
ĝojegu	ĝoj'eg'u
ĝojegante	ĝoj'eg'ant'e
ĝojegigas	ĝoj'eg'ig'as
ĝojegigis	ĝoj'eg'ig'is
ĝojegiĝis	ĝoj'eg'iĝ'is
ĝojema	ĝoj'em'a
ĝojeme	ĝoj'em'e
ĝojfajro	ĝoj'fajr'o
ĝojfajroj	ĝoj'fajr'o'j
ĝojfajrojn	ĝoj'fajr'o'j'n
ĝojfajron	ĝoj'fajr'o'n
ĝojfesto	ĝoj'fest'o
ĝojfonto	ĝoj'font'o
ĝojfuŝanto	ĝoj'fuŝ'ant'o
ĝojiga	ĝoj'ig'a
ĝojigaj	ĝoj'ig'a'j
ĝojigajn	ĝoj'ig'a'j'n
ĝojigan	ĝoj'ig'a'n
ĝojigas	ĝoj'ig'as
ĝojige	ĝoj'ig'e
ĝojigi	ĝoj'ig'i
ĝojigis	ĝoj'ig'is
ĝojigo	ĝoj'ig'o
ĝojigos	ĝoj'ig'os
ĝojigu	ĝoj'ig'u
ĝojigus	ĝoj'ig'us
ĝojigadis	ĝoj'ig'ad'is
ĝojiganta	ĝoj'ig'ant'a
ĝojigante	ĝoj'ig'ant'e
ĝojiganto	ĝoj'ig'ant'o
ĝojigita	ĝoj'ig'it'a
ĝojigitaj	ĝoj'ig'it'a'j
ĝojigite	ĝoj'ig'it'e
ĝojiĝas	ĝoj'iĝ'as
ĝojiĝis	ĝoj'iĝ'is
ĝojiĝos	ĝoj'iĝ'os
ĝojinda	ĝoj'ind'a
ĝojinde	ĝoj'ind'e
ĝojkantoj	ĝoj'kant'o'j
ĝojknabinoj	ĝoj'knab'in'o'j
ĝojkore	ĝoj'kor'e
ĝojkrias	ĝoj'kri'as
ĝojkrii	ĝoj'kri'i
ĝojkriis	ĝoj'kri'is
ĝojkrio	ĝoj'kri'o
ĝojkrioj	ĝoj'kri'o'j
ĝojkrion	ĝoj'kri'o'n
ĝojkriu	ĝoj'kri'u
ĝojkriado	ĝoj'kri'ad'o
ĝojkriadon	ĝoj'kri'ad'o'n
ĝojkriante	ĝoj'kri'ant'e
ĝojmotivo	ĝoj'motiv'o
ĝojokrioj	ĝoj'o'kri'o'j
ĝojoplena	ĝoj'o'plen'a
ĝojoplenaj	ĝoj'o'plen'a'j
ĝojoplenan	ĝoj'o'plen'a'n
ĝojoplene	ĝoj'o'plen'e
ĝojplena	ĝoj'plen'a
ĝojplenaj	ĝoj'plen'a'j
ĝojplenan	ĝoj'plen'a'n
ĝojplene	ĝoj'plen'e
ĝojsurprizo	ĝoj'surpriz'o
ĝojsurprizita	ĝoj'surpriz'it'a
ĝua	ĝu'a
ĝuaj	ĝu'a'j
ĝuajn	ĝu'a'j'n
ĝuan	ĝu'a'n
ĝuas	ĝu'as
ĝue	ĝu'e
ĝui	ĝu'i
ĝuis	ĝu'is
ĝuo	ĝu'o
ĝuoj	ĝu'o'j
ĝuojn	ĝu'o'j'n
ĝuon	ĝu'o'n
ĝuos	ĝu'os
ĝuu	ĝu'u
ĝuus	ĝu'us
ĝuadas	ĝu'ad'as
ĝuadi	ĝu'ad'i
ĝuadis	ĝu'ad'is
ĝuado	ĝu'ad'o
ĝuadoj	ĝu'ad'o'j
ĝuadon	ĝu'ad'o'n
ĝuamo	ĝu'am'o
ĝuanta	ĝu'ant'a
ĝuantaj	ĝu'ant'a'j
ĝuantan	ĝu'ant'a'n
ĝuante	ĝu'ant'e
ĝuanto	ĝu'ant'o
ĝuantoj	ĝu'ant'o'j
ĝuanton	ĝu'ant'o'n
ĝuata	ĝu'at'a
ĝuataj	ĝu'at'a'j
ĝuebla	ĝu'ebl'a
ĝueblaj	ĝu'ebl'a'j
ĝueblas	ĝu'ebl'as
ĝueblis	ĝu'ebl'is
ĝueblecon	ĝu'ebl'ec'o'n
ĝuegas	ĝu'eg'as
ĝuegi	ĝu'eg'i
ĝuegis	ĝu'eg'is
ĝuego	ĝu'eg'o
ĝuema	ĝu'em'a
ĝuemo	ĝu'em'o
ĝuemuloj	ĝu'em'ul'o'j
ĝuiga	ĝu'ig'a
ĝuigaj	ĝu'ig'a'j
ĝuigan	ĝu'ig'a'n
ĝuigas	ĝu'ig'as
ĝuige	ĝu'ig'e
ĝuigi	ĝu'ig'i
ĝuigis	ĝu'ig'is
ĝuigo	ĝu'ig'o
ĝuigus	ĝu'ig'us
ĝuiĝas	ĝu'iĝ'as
ĝuinda	ĝu'ind'a
ĝuindaj	ĝu'ind'a'j
ĝuindan	ĝu'ind'a'n
ĝuindas	ĝu'ind'as
ĝuinde	ĝu'ind'e
ĝuinta	ĝu'int'a
ĝuintaj	ĝu'int'a'j
ĝuinte	ĝu'int'e
ĝuintus	ĝu'int'us
ĝuita	ĝu'it'a
ĝuitaj	ĝu'it'a'j
ĝuitajn	ĝu'it'a'j'n
ĝuitan	ĝu'it'a'n
ĝuoplena	ĝu'o'plen'a
ĝuotaj	ĝu'ot'a'j
ĝuplena	ĝu'plen'a
ĝuplenaj	ĝu'plen'a'j
ĝusta	ĝust'a
ĝustaj	ĝust'a'j
ĝustajn	ĝust'a'j'n
ĝustan	ĝust'a'n
ĝustas	ĝust'as
ĝuste	ĝust'e
ĝusti	ĝust'i
ĝustis	ĝust'is
ĝusto	ĝust'o
ĝuston	ĝust'o'n
ĝustus	ĝust'us
ĝustadimensia	ĝust'a'dimensi'a
ĝustadimensiaj	ĝust'a'dimensi'a'j
ĝustadire	ĝust'a'dir'e
ĝustadirekten	ĝust'a'direkt'e'n
ĝustaforme	ĝust'a'form'e
ĝustagranda	ĝust'a'grand'a
ĝustaloka	ĝust'a'lok'a
ĝustaloke	ĝust'a'lok'e
ĝustamaniere	ĝust'a'manier'e
ĝustamezure	ĝust'a'mezur'e
ĝustasezone	ĝust'a'sezon'e
ĝustatempa	ĝust'a'temp'a
ĝustatempaj	ĝust'a'temp'a'j
ĝustatempajn	ĝust'a'temp'a'j'n
ĝustatempan	ĝust'a'temp'a'n
ĝustatempas	ĝust'a'temp'as
ĝustatempe	ĝust'a'temp'e
ĝustatempis	ĝust'a'temp'is
ĝustatempeco	ĝust'a'temp'ec'o
ĝustatempecon	ĝust'a'temp'ec'o'n
ĝustadate	ĝust'ad'at'e
ĝustagas	ĝust'ag'as
ĝustaĵon	ĝust'aĵ'o'n
ĝustedire	ĝust'e'dir'e
ĝustetempigitan	ĝust'e'temp'ig'it'a'n
ĝusteco	ĝust'ec'o
ĝustecon	ĝust'ec'o'n
ĝustiga	ĝust'ig'a
ĝustigas	ĝust'ig'as
ĝustigi	ĝust'ig'i
ĝustigis	ĝust'ig'is
ĝustigo	ĝust'ig'o
ĝustigoj	ĝust'ig'o'j
ĝustigojn	ĝust'ig'o'j'n
ĝustigon	ĝust'ig'o'n
ĝustigos	ĝust'ig'os
ĝustigu	ĝust'ig'u
ĝustigus	ĝust'ig'us
ĝustigado	ĝust'ig'ad'o
ĝustigantaj	ĝust'ig'ant'a'j
ĝustigante	ĝust'ig'ant'e
ĝustigbrulvundoj	ĝust'ig'brul'vund'o'j
ĝustigeblaj	ĝust'ig'ebl'a'j
ĝustigita	ĝust'ig'it'a
ĝustigitaj	ĝust'ig'it'a'j
ĝustigitajn	ĝust'ig'it'a'j'n
ĝustigitan	ĝust'ig'it'a'n
ĝustigmetodoj	ĝust'ig'metod'o'j
ĝustignivelo	ĝust'ig'nivel'o
ĝustigofaktoroj	ĝust'ig'o'faktor'o'j
ĝustigofaktoron	ĝust'ig'o'faktor'o'n
ĝustmaniere	ĝust'manier'e