ŝablona	ŝablon'a
ŝablonaj	ŝablon'a'j
ŝablono	ŝablon'o
ŝablonoj	ŝablon'o'j
ŝablonojn	ŝablon'o'j'n
ŝablonon	ŝablon'o'n
ŝablonmesaĝon	ŝablon'mesaĝ'o'n
ŝafa	ŝaf'a
ŝafaj	ŝaf'a'j
ŝafi	ŝaf'i
ŝafo	ŝaf'o
ŝafoj	ŝaf'o'j
ŝafojn	ŝaf'o'j'n
ŝafon	ŝaf'o'n
ŝafaĵo	ŝaf'aĵ'o
ŝafaĵoj	ŝaf'aĵ'o'j
ŝafaĵon	ŝaf'aĵ'o'n
ŝafaro	ŝaf'ar'o
ŝafaron	ŝaf'ar'o'n
ŝafbredado	ŝaf'bred'ad'o
ŝafejo	ŝaf'ej'o
ŝaffelo	ŝaf'fel'o
ŝaffelon	ŝaf'fel'o'n
ŝafido	ŝaf'id'o
ŝafidoj	ŝaf'id'o'j
ŝafidojn	ŝaf'id'o'j'n
ŝafidon	ŝaf'id'o'n
ŝafidaĵo	ŝaf'id'aĵ'o
ŝafino	ŝaf'in'o
ŝafinoj	ŝaf'in'o'j
ŝafinojn	ŝaf'in'o'j'n
ŝafinon	ŝaf'in'o'n
ŝafisto	ŝaf'ist'o
ŝafistoj	ŝaf'ist'o'j
ŝafto	ŝaft'o
ŝaftoj	ŝaft'o'j
ŝaftojn	ŝaft'o'j'n
ŝafton	ŝaft'o'n
ŝaftrado	ŝaft'rad'o
ŝaho	ŝah'o
ŝajna	ŝajn'a
ŝajnaj	ŝajn'a'j
ŝajnajn	ŝajn'a'j'n
ŝajnan	ŝajn'a'n
ŝajnas	ŝajn'as
ŝajne	ŝajn'e
ŝajni	ŝajn'i
ŝajnis	ŝajn'is
ŝajno	ŝajn'o
ŝajnoj	ŝajn'o'j
ŝajnon	ŝajn'o'n
ŝajnos	ŝajn'os
ŝajnu	ŝajn'u
ŝajnus	ŝajn'us
ŝajnaĵoj	ŝajn'aĵ'o'j
ŝajnanta	ŝajn'ant'a
ŝajnantaj	ŝajn'ant'a'j
ŝajnante	ŝajn'ant'e
ŝajniga	ŝajn'ig'a
ŝajnigaj	ŝajn'ig'a'j
ŝajnigajn	ŝajn'ig'a'j'n
ŝajnigas	ŝajn'ig'as
ŝajnige	ŝajn'ig'e
ŝajnigi	ŝajn'ig'i
ŝajnigis	ŝajn'ig'is
ŝajnigo	ŝajn'ig'o
ŝajnigos	ŝajn'ig'os
ŝajnigu	ŝajn'ig'u
ŝajnigus	ŝajn'ig'us
ŝajnigado	ŝajn'ig'ad'o
ŝajniganta	ŝajn'ig'ant'a
ŝajnigante	ŝajn'ig'ant'e
ŝajnigita	ŝajn'ig'it'a
ŝajnigitaj	ŝajn'ig'it'a'j
ŝaka	ŝak'a
ŝakaj	ŝak'a'j
ŝako	ŝak'o
ŝakojn	ŝak'o'j'n
ŝakon	ŝak'o'n
ŝakisto	ŝak'ist'o
ŝakistoj	ŝak'ist'o'j
ŝakluda	ŝak'lud'a
ŝakludi	ŝak'lud'i
ŝakludo	ŝak'lud'o
ŝakludon	ŝak'lud'o'n
ŝakludado	ŝak'lud'ad'o
ŝakludanto	ŝak'lud'ant'o
ŝakludantoj	ŝak'lud'ant'o'j
ŝakpecoj	ŝak'pec'o'j
ŝaktabulo	ŝak'tabul'o
ŝakalo	ŝakal'o
ŝakaloj	ŝakal'o'j
ŝakamo	ŝakam'o
ŝakjamunio	ŝakjamuni'o
ŝakrado	ŝakr'ad'o
ŝakristoj	ŝakr'ist'o'j
ŝakti	ŝakt'i
ŝakto	ŝakt'o
ŝaktoj	ŝakt'o'j
ŝakton	ŝakt'o'n
ŝaktotransporto	ŝakt'o'trans'port'o
ŝalo	ŝal'o
ŝaloj	ŝal'o'j
ŝalon	ŝal'o'n
ŝalmo	ŝalm'o
ŝaltas	ŝalt'as
ŝalti	ŝalt'i
ŝaltis	ŝalt'is
ŝaltos	ŝalt'os
ŝaltu	ŝalt'u
ŝaltado	ŝalt'ad'o
ŝaltante	ŝalt'ant'e
ŝaltiĝis	ŝalt'iĝ'is
ŝaltilo	ŝalt'il'o
ŝaltiloj	ŝalt'il'o'j
ŝaltilojn	ŝalt'il'o'j'n
ŝaltilon	ŝalt'il'o'n
ŝaltinte	ŝalt'int'e
ŝaltita	ŝalt'it'a
ŝaltitaj	ŝalt'it'a'j
ŝalupo	ŝalup'o
ŝamana	ŝaman'a
ŝamano	ŝaman'o
ŝamanoj	ŝaman'o'j
ŝamanismo	ŝaman'ism'o
ŝampuo	ŝampu'o
ŝampuoj	ŝampu'o'j
ŝampuon	ŝampu'o'n
ŝanco	ŝanc'o
ŝancoj	ŝanc'o'j
ŝancojn	ŝanc'o'j'n
ŝancon	ŝanc'o'n
ŝancatendo	ŝanc'atend'o
ŝancelas	ŝancel'as
ŝanceli	ŝancel'i
ŝancelis	ŝancel'is
ŝanceliĝa	ŝancel'iĝ'a
ŝanceliĝas	ŝancel'iĝ'as
ŝanceliĝe	ŝancel'iĝ'e
ŝanceliĝi	ŝancel'iĝ'i
ŝanceliĝis	ŝancel'iĝ'is
ŝanceliĝo	ŝancel'iĝ'o
ŝanceliĝanta	ŝancel'iĝ'ant'a
ŝanceliĝantaj	ŝancel'iĝ'ant'a'j
ŝanceliĝante	ŝancel'iĝ'ant'e
ŝanceliĝema	ŝancel'iĝ'em'a
ŝancelinsekto	ŝancel'insekt'o
ŝancelita	ŝancel'it'a
ŝanĝa	ŝanĝ'a
ŝanĝaj	ŝanĝ'a'j
ŝanĝan	ŝanĝ'a'n
ŝanĝas	ŝanĝ'as
ŝanĝe	ŝanĝ'e
ŝanĝi	ŝanĝ'i
ŝanĝis	ŝanĝ'is
ŝanĝo	ŝanĝ'o
ŝanĝoj	ŝanĝ'o'j
ŝanĝojn	ŝanĝ'o'j'n
ŝanĝon	ŝanĝ'o'n
ŝanĝos	ŝanĝ'os
ŝanĝu	ŝanĝ'u
ŝanĝus	ŝanĝ'us
ŝanĝadis	ŝanĝ'ad'is
ŝanĝado	ŝanĝ'ad'o
ŝanĝadon	ŝanĝ'ad'o'n
ŝanĝanta	ŝanĝ'ant'a
ŝanĝantaj	ŝanĝ'ant'a'j
ŝanĝantan	ŝanĝ'ant'a'n
ŝanĝante	ŝanĝ'ant'e
ŝanĝata	ŝanĝ'at'a
ŝanĝataj	ŝanĝ'at'a'j
ŝanĝebla	ŝanĝ'ebl'a
ŝanĝeblaj	ŝanĝ'ebl'a'j
ŝanĝeblas	ŝanĝ'ebl'as
ŝanĝebleco	ŝanĝ'ebl'ec'o
ŝanĝeblecon	ŝanĝ'ebl'ec'o'n
ŝanĝema	ŝanĝ'em'a
ŝanĝenda	ŝanĝ'end'a
ŝanĝigi	ŝanĝ'ig'i
ŝanĝigis	ŝanĝ'ig'is
ŝanĝigo	ŝanĝ'ig'o
ŝanĝiĝas	ŝanĝ'iĝ'as
ŝanĝiĝi	ŝanĝ'iĝ'i
ŝanĝiĝis	ŝanĝ'iĝ'is
ŝanĝiĝo	ŝanĝ'iĝ'o
ŝanĝiĝoj	ŝanĝ'iĝ'o'j
ŝanĝiĝojn	ŝanĝ'iĝ'o'j'n
ŝanĝiĝon	ŝanĝ'iĝ'o'n
ŝanĝiĝos	ŝanĝ'iĝ'os
ŝanĝiĝu	ŝanĝ'iĝ'u
ŝanĝiĝus	ŝanĝ'iĝ'us
ŝanĝiĝadis	ŝanĝ'iĝ'ad'is
ŝanĝiĝado	ŝanĝ'iĝ'ad'o
ŝanĝiĝadon	ŝanĝ'iĝ'ad'o'n
ŝanĝiĝanta	ŝanĝ'iĝ'ant'a
ŝanĝiĝantaj	ŝanĝ'iĝ'ant'a'j
ŝanĝiĝantajn	ŝanĝ'iĝ'ant'a'j'n
ŝanĝiĝantan	ŝanĝ'iĝ'ant'a'n
ŝanĝiĝante	ŝanĝ'iĝ'ant'e
ŝanĝiĝema	ŝanĝ'iĝ'em'a
ŝanĝiĝemaj	ŝanĝ'iĝ'em'a'j
ŝanĝiĝeman	ŝanĝ'iĝ'em'a'n
ŝanĝiĝinta	ŝanĝ'iĝ'int'a
ŝanĝinta	ŝanĝ'int'a
ŝanĝinte	ŝanĝ'int'e
ŝanĝita	ŝanĝ'it'a
ŝanĝitaj	ŝanĝ'it'a'j
ŝanĝitajn	ŝanĝ'it'a'j'n
ŝanĝitan	ŝanĝ'it'a'n
ŝanĝite	ŝanĝ'it'e
ŝanĝmonon	ŝanĝ'mon'o'n
ŝanhaja	ŝanhaj'a
ŝanhajaj	ŝanhaj'a'j
ŝanhajan	ŝanhaj'a'n
ŝanhajo	ŝanhaj'o
ŝanhajon	ŝanhaj'o'n
ŝanhajanoj	ŝanhaj'an'o'j
ŝarga	ŝarg'a
ŝargaj	ŝarg'a'j
ŝargas	ŝarg'as
ŝargi	ŝarg'i
ŝargis	ŝarg'is
ŝargo	ŝarg'o
ŝargoj	ŝarg'o'j
ŝargojn	ŝarg'o'j'n
ŝargon	ŝarg'o'n
ŝargado	ŝarg'ad'o
ŝarganta	ŝarg'ant'a
ŝargantan	ŝarg'ant'a'n
ŝargante	ŝarg'ant'e
ŝargeblaj	ŝarg'ebl'a'j
ŝargilo	ŝarg'il'o
ŝargiloj	ŝarg'il'o'j
ŝargilon	ŝarg'il'o'n
ŝargita	ŝarg'it'a
ŝargitaj	ŝarg'it'a'j
ŝargitan	ŝarg'it'a'n
ŝargite	ŝarg'it'e
ŝargkuplita	ŝarg'kupl'it'a
ŝarĝa	ŝarĝ'a
ŝarĝaj	ŝarĝ'a'j
ŝarĝas	ŝarĝ'as
ŝarĝi	ŝarĝ'i
ŝarĝis	ŝarĝ'is
ŝarĝo	ŝarĝ'o
ŝarĝoj	ŝarĝ'o'j
ŝarĝojn	ŝarĝ'o'j'n
ŝarĝon	ŝarĝ'o'n
ŝarĝos	ŝarĝ'os
ŝarĝu	ŝarĝ'u
ŝarĝado	ŝarĝ'ad'o
ŝarĝadon	ŝarĝ'ad'o'n
ŝarĝanta	ŝarĝ'ant'a
ŝarĝante	ŝarĝ'ant'e
ŝarĝaŭto	ŝarĝ'aŭt'o
ŝarĝaŭtoj	ŝarĝ'aŭt'o'j
ŝarĝaŭtojn	ŝarĝ'aŭt'o'j'n
ŝarĝaŭton	ŝarĝ'aŭt'o'n
ŝarĝita	ŝarĝ'it'a
ŝarĝitaj	ŝarĝ'it'a'j
ŝarĝitajn	ŝarĝ'it'a'j'n
ŝarĝitan	ŝarĝ'it'a'n
ŝarĝite	ŝarĝ'it'e
ŝarko	ŝark'o
ŝarkoj	ŝark'o'j
ŝarkojn	ŝark'o'j'n
ŝarkon	ŝark'o'n
ŝatas	ŝat'as
ŝate	ŝat'e
ŝati	ŝat'i
ŝatis	ŝat'is
ŝato	ŝat'o
ŝatoj	ŝat'o'j
ŝatojn	ŝat'o'j'n
ŝaton	ŝat'o'n
ŝatos	ŝat'os
ŝatu	ŝat'u
ŝatus	ŝat'us
ŝatado	ŝat'ad'o
ŝatanta	ŝat'ant'a
ŝatantaj	ŝat'ant'a'j
ŝatante	ŝat'ant'e
ŝatanto	ŝat'ant'o
ŝatantoj	ŝat'ant'o'j
ŝatantojn	ŝat'ant'o'j'n
ŝatata	ŝat'at'a
ŝatataj	ŝat'at'a'j
ŝatatajn	ŝat'at'a'j'n
ŝatatan	ŝat'at'a'n
ŝatatas	ŝat'at'as
ŝatateco	ŝat'at'ec'o
ŝatatecon	ŝat'at'ec'o'n
ŝategas	ŝat'eg'as
ŝategis	ŝat'eg'is
ŝategos	ŝat'eg'os
ŝategus	ŝat'eg'us
ŝatinda	ŝat'ind'a
ŝatindaj	ŝat'ind'a'j
ŝatinta	ŝat'int'a
ŝatintus	ŝat'int'us
ŝatita	ŝat'it'a
ŝatokupo	ŝat'okup'o
ŝatokupoj	ŝat'okup'o'j
ŝatokupojn	ŝat'okup'o'j'n
ŝatokupon	ŝat'okup'o'n
ŝaŭma	ŝaŭm'a
ŝaŭmaj	ŝaŭm'a'j
ŝaŭmas	ŝaŭm'as
ŝaŭmo	ŝaŭm'o
ŝaŭmoj	ŝaŭm'o'j
ŝaŭmon	ŝaŭm'o'n
ŝaŭmanta	ŝaŭm'ant'a
ŝaŭmvino	ŝaŭm'vin'o
ŝedo	ŝed'o
ŝedoj	ŝed'o'j
ŝejko	ŝejk'o
ŝejkoj	ŝejk'o'j
ŝekspira	ŝekspir'a
ŝekspiro	ŝekspir'o
ŝekspiron	ŝekspir'o'n
ŝela	ŝel'a
ŝelo	ŝel'o
ŝeloj	ŝel'o'j
ŝelojn	ŝel'o'j'n
ŝelon	ŝel'o'n
ŝelkojn	ŝelk'o'j'n
ŝengena	ŝengen'a
ŝenoprazo	ŝenopraz'o
ŝerca	ŝerc'a
ŝercaj	ŝerc'a'j
ŝercan	ŝerc'a'n
ŝercas	ŝerc'as
ŝerce	ŝerc'e
ŝerci	ŝerc'i
ŝercis	ŝerc'is
ŝerco	ŝerc'o
ŝercoj	ŝerc'o'j
ŝercojn	ŝerc'o'j'n
ŝercon	ŝerc'o'n
ŝercu	ŝerc'u
ŝercado	ŝerc'ad'o
ŝercante	ŝerc'ant'e
ŝercema	ŝerc'em'a
ŝercemo	ŝerc'em'o
ŝercemulo	ŝerc'em'ul'o
ŝerculo	ŝerc'ul'o
ŝi	ŝi
ŝia	ŝi'a
ŝiaj	ŝi'a'j
ŝiajn	ŝi'a'j'n
ŝian	ŝi'a'n
ŝin	ŝi'n
ŝiahejmen	ŝi'a'hejm'e'n
ŝijaisma	ŝijaism'a
ŝijaismaj	ŝijaism'a'j
ŝijaismo	ŝijaism'o
ŝijaistoj	ŝijaist'o'j
ŝika	ŝik'a
ŝikaj	ŝik'a'j
ŝikajn	ŝik'a'j'n
ŝikan	ŝik'a'n
ŝike	ŝik'e
ŝikeco	ŝik'ec'o
ŝilo	ŝil'o
ŝildaj	ŝild'a'j
ŝildo	ŝild'o
ŝildoj	ŝild'o'j
ŝildojn	ŝild'o'j'n
ŝildon	ŝild'o'n
ŝildeto	ŝild'et'o
ŝildmuro	ŝild'mur'o
ŝilingo	ŝiling'o
ŝilingoj	ŝiling'o'j
ŝilingojn	ŝiling'o'j'n
ŝilingon	ŝiling'o'n
ŝima	ŝim'a
ŝimo	ŝim'o
ŝimoj	ŝim'o'j
ŝimojn	ŝim'o'j'n
ŝimon	ŝim'o'n
ŝindo	ŝind'o
ŝindoj	ŝind'o'j
ŝinko	ŝink'o
ŝinkoj	ŝink'o'j
ŝinkon	ŝink'o'n
ŝinkanseno	ŝinkansen'o
ŝintoo	ŝinto'o
ŝintoismo	ŝinto'ism'o
ŝipa	ŝip'a
ŝipaj	ŝip'a'j
ŝipan	ŝip'a'n
ŝipe	ŝip'e
ŝipo	ŝip'o
ŝipoj	ŝip'o'j
ŝipojn	ŝip'o'j'n
ŝipon	ŝip'o'n
ŝipado	ŝip'ad'o
ŝipano	ŝip'an'o
ŝipanoj	ŝip'an'o'j
ŝipanojn	ŝip'an'o'j'n
ŝipanaro	ŝip'an'ar'o
ŝipanaron	ŝip'an'ar'o'n
ŝiparo	ŝip'ar'o
ŝiparoj	ŝip'ar'o'j
ŝiparon	ŝip'ar'o'n
ŝipartrupoj	ŝip'ar'trup'o'j
ŝipego	ŝip'eg'o
ŝipestro	ŝip'estr'o
ŝipestroj	ŝip'estr'o'j
ŝipestron	ŝip'estr'o'n
ŝipeto	ŝip'et'o
ŝipetoj	ŝip'et'o'j
ŝipeton	ŝip'et'o'n
ŝipfarejo	ŝip'far'ej'o
ŝipisto	ŝip'ist'o
ŝipistoj	ŝip'ist'o'j
ŝipitineroj	ŝip'itiner'o'j
ŝipkonstruado	ŝip'konstru'ad'o
ŝipkonstruejo	ŝip'konstru'ej'o
ŝipkonstruejoj	ŝip'konstru'ej'o'j
ŝipkorpo	ŝip'korp'o
ŝiprando	ŝip'rand'o
ŝiprandon	ŝip'rand'o'n
ŝipruino	ŝip'ruin'o
ŝipveturado	ŝip'vetur'ad'o
ŝiras	ŝir'as
ŝire	ŝir'e
ŝiri	ŝir'i
ŝiris	ŝir'is
ŝiro	ŝir'o
ŝiros	ŝir'os
ŝiru	ŝir'u
ŝirado	ŝir'ad'o
ŝirante	ŝir'ant'e
ŝireto	ŝir'et'o
ŝiriĝas	ŝir'iĝ'as
ŝiriĝis	ŝir'iĝ'is
ŝiriĝinta	ŝir'iĝ'int'a
ŝiriĝintaj	ŝir'iĝ'int'a'j
ŝirita	ŝir'it'a
ŝiritaj	ŝir'it'a'j
ŝiritan	ŝir'it'a'n
ŝirazo	ŝiraz'o
ŝirma	ŝirm'a
ŝirmaj	ŝirm'a'j
ŝirman	ŝirm'a'n
ŝirmas	ŝirm'as
ŝirme	ŝirm'e
ŝirmi	ŝirm'i
ŝirmis	ŝirm'is
ŝirmo	ŝirm'o
ŝirmon	ŝirm'o'n
ŝirmos	ŝirm'os
ŝirmu	ŝirm'u
ŝirmado	ŝirm'ad'o
ŝirmadon	ŝirm'ad'o'n
ŝirmanta	ŝirm'ant'a
ŝirmante	ŝirm'ant'e
ŝirmata	ŝirm'at'a
ŝirmataj	ŝirm'at'a'j
ŝirmejo	ŝirm'ej'o
ŝirmejoj	ŝirm'ej'o'j
ŝirmejojn	ŝirm'ej'o'j'n
ŝirmejon	ŝirm'ej'o'n
ŝirmilo	ŝirm'il'o
ŝirmiloj	ŝirm'il'o'j
ŝirmilon	ŝirm'il'o'n
ŝirmita	ŝirm'it'a
ŝirmitaj	ŝirm'it'a'j
ŝirmveston	ŝirm'vest'o'n
ŝivao	ŝiva'o
ŝlemo	ŝlem'o
ŝlima	ŝlim'a
ŝlimo	ŝlim'o
ŝlimon	ŝlim'o'n
ŝlimeca	ŝlim'ec'a
ŝlimecaj	ŝlim'ec'a'j
ŝlosas	ŝlos'as
ŝlosi	ŝlos'i
ŝlosis	ŝlos'is
ŝlosu	ŝlos'u
ŝlosado	ŝlos'ad'o
ŝlosante	ŝlos'ant'e
ŝlosila	ŝlos'il'a
ŝlosilaj	ŝlos'il'a'j
ŝlosilajn	ŝlos'il'a'j'n
ŝlosilan	ŝlos'il'a'n
ŝlosile	ŝlos'il'e
ŝlosilo	ŝlos'il'o
ŝlosiloj	ŝlos'il'o'j
ŝlosilojn	ŝlos'il'o'j'n
ŝlosilon	ŝlos'il'o'n
ŝlosilvorto	ŝlos'il'vort'o
ŝlosilvortoj	ŝlos'il'vort'o'j
ŝlosilvortojn	ŝlos'il'vort'o'j'n
ŝlosinte	ŝlos'int'e
ŝlosita	ŝlos'it'a
ŝlositaj	ŝlos'it'a'j
ŝlositan	ŝlos'it'a'n
ŝlosoŝtono	ŝlos'o'ŝton'o
ŝminkas	ŝmink'as
ŝminkis	ŝmink'is
ŝminko	ŝmink'o
ŝminkon	ŝmink'o'n
ŝminkado	ŝmink'ad'o
ŝminkita	ŝmink'it'a
ŝmiras	ŝmir'as
ŝmiri	ŝmir'i
ŝmiris	ŝmir'is
ŝmiru	ŝmir'u
ŝmirado	ŝmir'ad'o
ŝmiraĵo	ŝmir'aĵ'o
ŝmiraĵon	ŝmir'aĵ'o'n
ŝmirita	ŝmir'it'a
ŝmiritaj	ŝmir'it'a'j
ŝnuro	ŝnur'o
ŝnuroj	ŝnur'o'j
ŝnurojn	ŝnur'o'j'n
ŝnuron	ŝnur'o'n
ŝnurego	ŝnur'eg'o
ŝnuregoj	ŝnur'eg'o'j
ŝnuregojn	ŝnur'eg'o'j'n
ŝnuregon	ŝnur'eg'o'n
ŝnureto	ŝnur'et'o
ŝnuretoj	ŝnur'et'o'j
ŝnuretojn	ŝnur'et'o'j'n
ŝnureton	ŝnur'et'o'n
ŝofora	ŝofor'a
ŝoforas	ŝofor'as
ŝofori	ŝofor'i
ŝoforis	ŝofor'is
ŝoforo	ŝofor'o
ŝoforoj	ŝofor'o'j
ŝoforojn	ŝofor'o'j'n
ŝoforon	ŝofor'o'n
ŝoforos	ŝofor'os
ŝoforu	ŝofor'u
ŝoforado	ŝofor'ad'o
ŝoforpermesilon	ŝofor'permes'il'o'n
ŝoguno	ŝogun'o
ŝoka	ŝok'a
ŝokaj	ŝok'a'j
ŝokan	ŝok'a'n
ŝokas	ŝok'as
ŝoke	ŝok'e
ŝoki	ŝok'i
ŝokis	ŝok'is
ŝoko	ŝok'o
ŝokoj	ŝok'o'j
ŝokojn	ŝok'o'j'n
ŝokon	ŝok'o'n
ŝokiĝas	ŝok'iĝ'as
ŝokiĝis	ŝok'iĝ'is
ŝokita	ŝok'it'a
ŝokitaj	ŝok'it'a'j
ŝokite	ŝok'it'e
ŝokondo	ŝok'ond'o
ŝokondoj	ŝok'ond'o'j
ŝosas	ŝos'as
ŝoso	ŝos'o
ŝosoj	ŝos'o'j
ŝosojn	ŝos'o'j'n
ŝosea	ŝose'a
ŝoseo	ŝose'o
ŝoseoj	ŝose'o'j
ŝoseojn	ŝose'o'j'n
ŝoseon	ŝose'o'n
ŝoto	ŝot'o
ŝovas	ŝov'as
ŝovi	ŝov'i
ŝovis	ŝov'is
ŝovo	ŝov'o
ŝovon	ŝov'o'n
ŝovu	ŝov'u
ŝovante	ŝov'ant'e
ŝoviĝas	ŝov'iĝ'as
ŝoviĝis	ŝov'iĝ'is
ŝoviĝo	ŝov'iĝ'o
ŝoviĝon	ŝov'iĝ'o'n
ŝovinte	ŝov'int'e
ŝovita	ŝov'it'a
ŝoveli	ŝovel'i
ŝovelis	ŝovel'is
ŝovelilo	ŝovel'il'o
ŝoveliloj	ŝovel'il'o'j
ŝovelilojn	ŝovel'il'o'j'n
ŝovelilon	ŝovel'il'o'n
ŝovinisma	ŝovinism'a
ŝovinismo	ŝovinism'o
ŝovinismon	ŝovinism'o'n
ŝovinisto	ŝovinist'o
ŝparas	ŝpar'as
ŝpari	ŝpar'i
ŝparis	ŝpar'is
ŝparo	ŝpar'o
ŝparoj	ŝpar'o'j
ŝparojn	ŝpar'o'j'n
ŝparon	ŝpar'o'n
ŝparos	ŝpar'os
ŝparu	ŝpar'u
ŝparus	ŝpar'us
ŝparado	ŝpar'ad'o
ŝparadoj	ŝpar'ad'o'j
ŝparadojn	ŝpar'ad'o'j'n
ŝparadon	ŝpar'ad'o'n
ŝparaĵoj	ŝpar'aĵ'o'j
ŝparaĵojn	ŝpar'aĵ'o'j'n
ŝparante	ŝpar'ant'e
ŝparema	ŝpar'em'a
ŝparemaj	ŝpar'em'a'j
ŝpareme	ŝpar'em'e
ŝparemo	ŝpar'em'o
ŝparigas	ŝpar'ig'as
ŝparita	ŝpar'it'a
ŝparitaj	ŝpar'it'a'j
ŝparitan	ŝpar'it'a'n
ŝparkaso	ŝpar'kas'o
ŝparmono	ŝpar'mon'o
ŝparmonon	ŝpar'mon'o'n
ŝparporciigo	ŝpar'porci'ig'o
ŝpato	ŝpat'o
ŝpinas	ŝpin'as
ŝpini	ŝpin'i
ŝpinis	ŝpin'is
ŝpinado	ŝpin'ad'o
ŝpinita	ŝpin'it'a
ŝpinrado	ŝpin'rad'o
ŝprucas	ŝpruc'as
ŝpruci	ŝpruc'i
ŝprucis	ŝpruc'is
ŝpruco	ŝpruc'o
ŝprucoj	ŝpruc'o'j
ŝprucado	ŝpruc'ad'o
ŝprucaĵo	ŝpruc'aĵ'o
ŝprucanta	ŝpruc'ant'a
ŝprucante	ŝpruc'ant'e
ŝprucetado	ŝpruc'et'ad'o
ŝprucfontoj	ŝpruc'font'o'j
ŝprucigas	ŝpruc'ig'as
ŝprucigi	ŝpruc'ig'i
ŝprucigis	ŝpruc'ig'is
ŝprucigado	ŝpruc'ig'ad'o
ŝprucita	ŝpruc'it'a
ŝprucitaj	ŝpruc'it'a'j
ŝramanoj	ŝraman'o'j
ŝranko	ŝrank'o
ŝrankoj	ŝrank'o'j
ŝrankojn	ŝrank'o'j'n
ŝrankon	ŝrank'o'n
ŝranketo	ŝrank'et'o
ŝranketon	ŝrank'et'o'n
ŝrapnelo	ŝrapnel'o
ŝraŭbo	ŝraŭb'o
ŝraŭboj	ŝraŭb'o'j
ŝraŭbojn	ŝraŭb'o'j'n
ŝraŭbon	ŝraŭb'o'n
ŝraŭbaĵo	ŝraŭb'aĵ'o
ŝraŭbilo	ŝraŭb'il'o
ŝraŭbilon	ŝraŭb'il'o'n
ŝriko	ŝrik'o
ŝrumpa	ŝrump'a
ŝrumpas	ŝrump'as
ŝrumpi	ŝrump'i
ŝrumpis	ŝrump'is
ŝrumpos	ŝrump'os
ŝrumpado	ŝrump'ad'o
ŝrumpadon	ŝrump'ad'o'n
ŝrumpiĝo	ŝrump'iĝ'o
ŝrumpinta	ŝrump'int'a
ŝrumpintaj	ŝrump'int'a'j
ŝtala	ŝtal'a
ŝtalaj	ŝtal'a'j
ŝtalajn	ŝtal'a'j'n
ŝtalan	ŝtal'a'n
ŝtalo	ŝtal'o
ŝtaloj	ŝtal'o'j
ŝtalon	ŝtal'o'n
ŝtalbetono	ŝtal'beton'o
ŝtalindustrio	ŝtal'industri'o
ŝtalproduktado	ŝtal'produkt'ad'o
ŝtata	ŝtat'a
ŝtataj	ŝtat'a'j
ŝtatajn	ŝtat'a'j'n
ŝtatan	ŝtat'a'n
ŝtate	ŝtat'e
ŝtato	ŝtat'o
ŝtatoj	ŝtat'o'j
ŝtatojn	ŝtat'o'j'n
ŝtaton	ŝtat'o'n
ŝtatadministrado	ŝtat'administr'ad'o
ŝtataferoj	ŝtat'afer'o'j
ŝtatagentejoj	ŝtat'agent'ej'o'j
ŝtatakuzanto	ŝtat'akuz'ant'o
ŝtatano	ŝtat'an'o
ŝtatanoj	ŝtat'an'o'j
ŝtatanojn	ŝtat'an'o'j'n
ŝtatanon	ŝtat'an'o'n
ŝtataneco	ŝtat'an'ec'o
ŝtatanecon	ŝtat'an'ec'o'n
ŝtateco	ŝtat'ec'o
ŝtatekonomio	ŝtat'ekonomi'o
ŝtatenmiksiĝo	ŝtat'en'miks'iĝ'o
ŝtatestro	ŝtat'estr'o
ŝtatestroj	ŝtat'estr'o'j
ŝtatestrojn	ŝtat'estr'o'j'n
ŝtatestron	ŝtat'estr'o'n
ŝtateto	ŝtat'et'o
ŝtatetoj	ŝtat'et'o'j
ŝtatformo	ŝtat'form'o
ŝtatgvidantoj	ŝtat'gvid'ant'o'j
ŝtatigo	ŝtat'ig'o
ŝtatigon	ŝtat'ig'o'n
ŝtatiĝo	ŝtat'iĝ'o
ŝtatiĝon	ŝtat'iĝ'o'n
ŝtatisto	ŝtat'ist'o
ŝtatistoj	ŝtat'ist'o'j
ŝtatistarto	ŝtat'ist'art'o
ŝtatkapitalismo	ŝtat'kapital'ism'o
ŝtatkomisiono	ŝtat'komision'o
ŝtatkomunuma	ŝtat'komun'um'a
ŝtatkomunumaj	ŝtat'komun'um'a'j
ŝtatkomunumo	ŝtat'komun'um'o
ŝtatkontrolo	ŝtat'kontrol'o
ŝtatkontrolita	ŝtat'kontrol'it'a
ŝtatkontrolitaj	ŝtat'kontrol'it'a'j
ŝtatleĝo	ŝtat'leĝ'o
ŝtatleĝoj	ŝtat'leĝ'o'j
ŝtatlernejoj	ŝtat'lern'ej'o'j
ŝtatlimo	ŝtat'lim'o
ŝtatlimoj	ŝtat'lim'o'j
ŝtatmaŝino	ŝtat'maŝin'o
ŝtatministro	ŝtat'ministr'o
ŝtatnaciismo	ŝtat'naci'ism'o
ŝtatnivela	ŝtat'nivel'a
ŝtatnivelaj	ŝtat'nivel'a'j
ŝtatnivelo	ŝtat'nivel'o
ŝtatomembro	ŝtat'o'membr'o
ŝtatofico	ŝtat'ofic'o
ŝtatoficisto	ŝtat'ofic'ist'o
ŝtatoficistoj	ŝtat'ofic'ist'o'j
ŝtatoficistojn	ŝtat'ofic'ist'o'j'n
ŝtatoficistaro	ŝtat'ofic'ist'ar'o
ŝtatojmembroj	ŝtat'oj'membr'o'j
ŝtatojsekcio	ŝtat'oj'sekci'o
ŝtatorganoj	ŝtat'organ'o'j
ŝtatperfido	ŝtat'perfid'o
ŝtatpotenco	ŝtat'potenc'o
ŝtatprezidanto	ŝtat'prezid'ant'o
ŝtatrenverso	ŝtat'renvers'o
ŝtatsekretario	ŝtat'sekretari'o
ŝtatsekretariejo	ŝtat'sekretari'ej'o
ŝtatsekureco	ŝtat'sekur'ec'o
ŝtatservo	ŝtat'serv'o
ŝtatservoj	ŝtat'serv'o'j
ŝtatservon	ŝtat'serv'o'n
ŝtatspaco	ŝtat'spac'o
ŝtatsubvenciita	ŝtat'subvenci'it'a
ŝtela	ŝtel'a
ŝtelas	ŝtel'as
ŝtele	ŝtel'e
ŝteli	ŝtel'i
ŝtelis	ŝtel'is
ŝtelo	ŝtel'o
ŝteloj	ŝtel'o'j
ŝtelojn	ŝtel'o'j'n
ŝtelon	ŝtel'o'n
ŝtelos	ŝtel'os
ŝtelu	ŝtel'u
ŝtelus	ŝtel'us
ŝtelado	ŝtel'ad'o
ŝteladon	ŝtel'ad'o'n
ŝtelanta	ŝtel'ant'a
ŝtelante	ŝtel'ant'e
ŝtelĉasado	ŝtel'ĉas'ad'o
ŝtelĉasistoj	ŝtel'ĉas'ist'o'j
ŝteliĝis	ŝtel'iĝ'is
ŝtelinta	ŝtel'int'a
ŝtelinto	ŝtel'int'o
ŝtelinton	ŝtel'int'o'n
ŝteliras	ŝtel'ir'as
ŝteliri	ŝtel'ir'i
ŝteliris	ŝtel'ir'is
ŝtelista	ŝtel'ist'a
ŝtelisto	ŝtel'ist'o
ŝtelistoj	ŝtel'ist'o'j
ŝtelistojn	ŝtel'ist'o'j'n
ŝteliston	ŝtel'ist'o'n
ŝtelita	ŝtel'it'a
ŝtelitaj	ŝtel'it'a'j
ŝtelitajn	ŝtel'it'a'j'n
ŝtelitan	ŝtel'it'a'n
ŝtelitis	ŝtel'it'is
ŝteltruko	ŝtel'truk'o
ŝterno	ŝtern'o
ŝternoj	ŝtern'o'j
ŝtipo	ŝtip'o
ŝtipoj	ŝtip'o'j
ŝtipojn	ŝtip'o'j'n
ŝtipon	ŝtip'o'n
ŝtiparo	ŝtip'ar'o
ŝtofa	ŝtof'a
ŝtofo	ŝtof'o
ŝtofoj	ŝtof'o'j
ŝtofojn	ŝtof'o'j'n
ŝtofon	ŝtof'o'n
ŝtona	ŝton'a
ŝtonaj	ŝton'a'j
ŝtonajn	ŝton'a'j'n
ŝtonan	ŝton'a'n
ŝtone	ŝton'e
ŝtono	ŝton'o
ŝtonoj	ŝton'o'j
ŝtonojn	ŝton'o'j'n
ŝtonon	ŝton'o'n
ŝtonaĵo	ŝton'aĵ'o
ŝtonaĵoj	ŝton'aĵ'o'j
ŝtonaro	ŝton'ar'o
ŝtonblokoj	ŝton'blok'o'j
ŝtoncirkloj	ŝton'cirkl'o'j
ŝtoneca	ŝton'ec'a
ŝtonego	ŝton'eg'o
ŝtonegoj	ŝton'eg'o'j
ŝtonegon	ŝton'eg'o'n
ŝtonepoka	ŝton'epok'a
ŝtonepoko	ŝton'epok'o
ŝtoneroj	ŝton'er'o'j
ŝtoneto	ŝton'et'o
ŝtonetoj	ŝton'et'o'j
ŝtonetojn	ŝton'et'o'j'n
ŝtoneton	ŝton'et'o'n
ŝtonigita	ŝton'ig'it'a
ŝtoniĝis	ŝton'iĝ'is
ŝtoniĝo	ŝton'iĝ'o
ŝtoniĝinta	ŝton'iĝ'int'a
ŝtoniĝintaj	ŝton'iĝ'int'a'j
ŝtonkarbo	ŝton'karb'o
ŝtonkavernaro	ŝton'kavern'ar'o
ŝtonminejo	ŝton'min'ej'o
ŝtonminejoj	ŝton'min'ej'o'j
ŝtonmuroj	ŝton'mur'o'j
ŝtonoza	ŝton'oz'a
ŝtonpecoj	ŝton'pec'o'j
ŝtonplatoj	ŝton'plat'o'j
ŝtonroko	ŝton'rok'o
ŝtontajlistoj	ŝton'tajl'ist'o'j
ŝtonumado	ŝton'um'ad'o
ŝtopas	ŝtop'as
ŝtopi	ŝtop'i
ŝtopis	ŝtop'is
ŝtopado	ŝtop'ad'o
ŝtopante	ŝtop'ant'e
ŝtopiĝis	ŝtop'iĝ'is
ŝtopiĝo	ŝtop'iĝ'o
ŝtopiĝinta	ŝtop'iĝ'int'a
ŝtopiĝintaj	ŝtop'iĝ'int'a'j
ŝtopilo	ŝtop'il'o
ŝtopiloj	ŝtop'il'o'j
ŝtopilojn	ŝtop'il'o'j'n
ŝtopilon	ŝtop'il'o'n
ŝtopilingo	ŝtop'il'ing'o
ŝtopita	ŝtop'it'a
ŝtopitaj	ŝtop'it'a'j
ŝtorma	ŝtorm'a
ŝtormaj	ŝtorm'a'j
ŝtorman	ŝtorm'a'n
ŝtormo	ŝtorm'o
ŝtormoj	ŝtorm'o'j
ŝtormojn	ŝtorm'o'j'n
ŝtormon	ŝtorm'o'n
ŝtormego	ŝtorm'eg'o
ŝtrumpa	ŝtrump'a
ŝtrumpo	ŝtrump'o
ŝtrumpoj	ŝtrump'o'j
ŝtrumpojn	ŝtrump'o'j'n
ŝtrumpon	ŝtrump'o'n
ŝtrumpeto	ŝtrump'et'o
ŝtrumpetoj	ŝtrump'et'o'j
ŝtrumpetojn	ŝtrump'et'o'j'n
ŝtupo	ŝtup'o
ŝtupoj	ŝtup'o'j
ŝtupojn	ŝtup'o'j'n
ŝtupon	ŝtup'o'n
ŝtupara	ŝtup'ar'a
ŝtupare	ŝtup'ar'e
ŝtuparo	ŝtup'ar'o
ŝtuparoj	ŝtup'ar'o'j
ŝtuparojn	ŝtup'ar'o'j'n
ŝtuparon	ŝtup'ar'o'n
ŝtuparejo	ŝtup'ar'ej'o
ŝtuparejoj	ŝtup'ar'ej'o'j
ŝtupareto	ŝtup'ar'et'o
ŝtupareton	ŝtup'ar'et'o'n
ŝtupego	ŝtup'eg'o
ŝtupegoj	ŝtup'eg'o'j
ŝtupetaro	ŝtup'et'ar'o
ŝtupetaroj	ŝtup'et'ar'o'j
ŝtupetarojn	ŝtup'et'ar'o'j'n
ŝtupetaron	ŝtup'et'ar'o'n
ŝua	ŝu'a
ŝuo	ŝu'o
ŝuoj	ŝu'o'j
ŝuojn	ŝu'o'j'n
ŝuon	ŝu'o'n
ŝufarado	ŝu'far'ad'o
ŝufaristo	ŝu'far'ist'o
ŝuisto	ŝu'ist'o
ŝuistoj	ŝu'ist'o'j
ŝulaĉojn	ŝu'laĉ'o'j'n
ŝuparon	ŝu'par'o'n
ŝulda	ŝuld'a
ŝuldas	ŝuld'as
ŝuldi	ŝuld'i
ŝuldis	ŝuld'is
ŝuldo	ŝuld'o
ŝuldoj	ŝuld'o'j
ŝuldojn	ŝuld'o'j'n
ŝuldon	ŝuld'o'n
ŝuldanto	ŝuld'ant'o
ŝuldantoj	ŝuld'ant'o'j
ŝuldata	ŝuld'at'a
ŝuldataj	ŝuld'at'a'j
ŝuldiĝas	ŝuld'iĝ'as
ŝuldiĝi	ŝuld'iĝ'i
ŝuldiĝis	ŝuld'iĝ'is
ŝuldita	ŝuld'it'a
ŝulditaj	ŝuld'it'a'j
ŝuldmonoj	ŝuld'mon'o'j
ŝuldoŝarĝo	ŝuld'o'ŝarĝ'o
ŝultro	ŝultr'o
ŝultroj	ŝultr'o'j
ŝultrojn	ŝultr'o'j'n
ŝultron	ŝultr'o'n
ŝutas	ŝut'as
ŝuti	ŝut'i
ŝutis	ŝut'is
ŝutiĝis	ŝut'iĝ'is
ŝutroj	ŝutr'o'j
ŝutrojn	ŝutr'o'j'n
ŝveba	ŝveb'a
ŝvebaj	ŝveb'a'j
ŝveban	ŝveb'a'n
ŝvebas	ŝveb'as
ŝvebe	ŝveb'e
ŝvebi	ŝveb'i
ŝvebis	ŝveb'is
ŝvebado	ŝveb'ad'o
ŝvebanta	ŝveb'ant'a
ŝvebantaj	ŝveb'ant'a'j
ŝvebantan	ŝveb'ant'a'n
ŝvebante	ŝveb'ant'e
ŝvebŝipo	ŝveb'ŝip'o
ŝvela	ŝvel'a
ŝvelaj	ŝvel'a'j
ŝvelas	ŝvel'as
ŝveli	ŝvel'i
ŝvelis	ŝvel'is
ŝvelo	ŝvel'o
ŝvelado	ŝvel'ad'o
ŝvelaĵo	ŝvel'aĵ'o
ŝvelaĵoj	ŝvel'aĵ'o'j
ŝvelaĵon	ŝvel'aĵ'o'n
ŝvelanta	ŝvel'ant'a
ŝveligas	ŝvel'ig'as
ŝveligi	ŝvel'ig'i
ŝveligis	ŝvel'ig'is
ŝveligante	ŝvel'ig'ant'e
ŝveligita	ŝvel'ig'it'a
ŝveliĝas	ŝvel'iĝ'as
ŝveliĝi	ŝvel'iĝ'i
ŝveliĝis	ŝvel'iĝ'is
ŝveliĝo	ŝvel'iĝ'o
ŝveliĝon	ŝvel'iĝ'o'n
ŝvelinta	ŝvel'int'a
ŝvelintaj	ŝvel'int'a'j
ŝvelintajn	ŝvel'int'a'j'n
ŝvelintan	ŝvel'int'a'n
ŝvita	ŝvit'a
ŝvitas	ŝvit'as
ŝvite	ŝvit'e
ŝviti	ŝvit'i
ŝvitis	ŝvit'is
ŝvito	ŝvit'o
ŝviton	ŝvit'o'n
ŝvitado	ŝvit'ad'o
ŝvitadon	ŝvit'ad'o'n
ŝvitanta	ŝvit'ant'a
ŝvitante	ŝvit'ant'e
ŝvitegis	ŝvit'eg'is
ŝvitglandoj	ŝvit'gland'o'j
ŝvitgutoj	ŝvit'gut'o'j
ŝvitiga	ŝvit'ig'a